fund_id,transaction_date,firm_id,transaction_type,transaction_amount,cumulative_contribution,cumulative_distribution,net_cashflow
3,2021-12-31,152327,Value,0,-10010451,17137892,7127441
9,2020-03-31,741,Value,0,-9140000,16080000,6940000
9,2020-06-30,741,Value,0,-9140000,16080000,6940000
9,2020-09-30,741,Value,0,-9140000,16080000,6940000
9,2020-12-31,741,Value,0,-9140000,16080000,6940000
9,2021-03-31,741,Value,0,-9140000,16080000,6940000
9,2021-06-30,741,Value,0,-9140000,16080000,6940000
9,2021-12-31,741,Value,0,-9140000,16080000,6940000
11,2020-03-31,650,Value,0,-10000000,15676000,5676000
11,2020-06-30,650,Value,0,-10000000,15676000,5676000
11,2020-09-30,650,Value,0,-10000000,15676000,5676000
11,2020-12-31,650,Value,0,-10000000,15676000,5676000
11,2021-03-31,650,Value,0,-10000000,15676000,5676000
11,2021-06-30,650,Value,0,-10000000,15676000,5676000
11,2021-09-30,650,Value,0,-10000000,15676000,5676000
11,2021-12-31,650,Value,0,-10000000,15676000,5676000
14,2021-12-31,4,Value,0,-9747067,24181784,14434717
15,2020-02-29,4,Value,0,-9674336,14187489,4513153
15,2020-05-31,4,Value,0,-9674336,14187489,4513153
15,2020-07-16,4,Distribution,0,-9674336,14187489,4513153
15,2020-08-31,4,Value,0,-9674336,14187489,4513153
15,2020-11-30,4,Value,0,-9674336,14187489,4513153
15,2021-02-28,4,Value,0,-9674336,14187489,4513153
15,2021-05-31,4,Value,0,-9674336,14187489,4513153
15,2021-08-31,4,Value,0,-9674336,14187489,4513153
15,2021-10-16,4,Capital Call,0,-9674336,14187489,4513153
15,2021-10-16,4,Distribution,0,-9674336,14187489,4513153
15,2021-12-31,4,Value,0,-9674336,14187489,4513153
16,2021-12-31,4,Value,0,-8840614,18684730,9844116
27,2020-02-15,7,Distribution,118353,-9695000,16622261,6927261
27,2020-03-31,7,Value,0,-9695000,16622261,6927261
27,2021-12-31,7,Value,0,-9695000,16622261,6927261
28,2020-02-15,7,Distribution,1986,-9930000,17046831,7116831
28,2020-03-31,7,Value,219450,-9930000,17046831,7116831
28,2020-05-16,7,Distribution,5958,-9930000,17052789,7122789
28,2020-06-30,7,Value,223420,-9930000,17052789,7122789
28,2020-08-15,7,Distribution,-5958,-9930000,17046831,7116831
28,2020-09-30,7,Value,206540,-9930000,17046831,7116831
39,2020-03-31,12,Value,0,-9820000,11459939,1639939
39,2020-06-30,12,Value,0,-9820000,11459939,1639939
39,2020-09-30,12,Value,0,-9820000,11459939,1639939
39,2020-12-31,12,Value,0,-9820000,11459939,1639939
39,2021-03-31,12,Value,0,-9820000,11459939,1639939
39,2021-06-30,12,Value,0,-9820000,11459939,1639939
39,2021-09-30,12,Value,0,-9820000,11459939,1639939
39,2021-12-31,12,Value,0,-9820000,11459939,1639939
40,2020-03-31,12,Value,0,-8410003,5357172,-3052831
40,2020-06-30,12,Value,0,-8410003,5357172,-3052831
40,2020-09-30,12,Value,0,-8410003,5357172,-3052831
40,2020-12-31,12,Value,0,-8410003,5357172,-3052831
40,2021-03-31,12,Value,0,-8410003,5357172,-3052831
40,2021-06-30,12,Value,0,-8410003,5357172,-3052831
40,2021-09-30,12,Value,0,-8410003,5357172,-3052831
40,2021-12-31,12,Value,0,-8410003,5357172,-3052831
41,2020-03-31,12,Capital Call,30303,-9924243,22025544,12101301
41,2020-03-31,12,Distribution,19911,-9924243,22045455,12121212
41,2020-09-30,12,Value,0,-9924243,22045455,12121212
41,2021-12-31,12,Value,0,-9924243,22045455,12121212
45,2020-03-31,14,Value,877830,-10000000,12403731,2403731
45,2020-06-30,14,Value,803690,-10000000,12403731,2403731
45,2020-09-30,14,Value,806630,-10000000,12403731,2403731
45,2020-11-15,14,Distribution,412436,-10000000,12816167,2816167
45,2020-12-31,14,Value,403440,-10000000,12816167,2816167
45,2021-03-31,14,Value,429150,-10000000,12816167,2816167
45,2021-06-30,14,Value,416740,-10000000,12816167,2816167
45,2021-09-30,14,Value,418860,-10000000,12816167,2816167
52,2020-03-31,14,Value,0,-10021600,80880006,70858406
52,2020-06-30,14,Value,0,-10021600,80880006,70858406
52,2020-09-30,14,Value,0,-10021600,80880006,70858406
52,2020-12-31,14,Value,0,-10021600,80880006,70858406
52,2021-03-31,14,Value,0,-10021600,80880006,70858406
52,2021-06-30,14,Value,0,-10021600,80880006,70858406
52,2021-09-30,14,Value,0,-10021600,80880006,70858406
52,2021-12-31,14,Value,0,-10021600,80880006,70858406
54,2020-03-31,14,Value,0,-10000000,196200117,186200117
54,2020-06-30,14,Value,0,-10000000,196200117,186200117
54,2020-09-30,14,Value,0,-10000000,196200117,186200117
54,2020-12-31,14,Value,0,-10000000,196200117,186200117
54,2021-03-31,14,Value,0,-10000000,196200117,186200117
54,2021-06-30,14,Value,0,-10000000,196200117,186200117
54,2021-09-30,14,Value,0,-10000000,196200117,186200117
54,2021-12-31,14,Value,0,-10000000,196200117,186200117
55,2020-06-30,14,Value,389690,-10000000,3630816,-6369184
55,2021-06-30,14,Value,378590,-10000000,3630816,-6369184
56,2020-06-30,14,Value,6209850,-7949991,30961475,23011484
58,2020-06-30,14,Value,0,-8032704,11603967,3571263
58,2021-12-31,14,Value,0,-8032704,11603967,3571263
67,2020-02-15,18,Distribution,102950,-10000000,12966445,2966445
67,2020-03-31,18,Value,1356840,-10000000,12966445,2966445
67,2020-06-30,18,Value,1522120,-10000000,12966445,2966445
67,2020-09-30,18,Value,1673800,-10000000,12966445,2966445
67,2020-11-15,18,Distribution,1420021,-10000000,14386466,4386466
67,2020-12-31,18,Value,368980,-10000000,14386466,4386466
67,2021-03-31,18,Value,368910,-10000000,14386466,4386466
67,2021-05-16,18,Capital Call,201,-9999799,14386466,4386667
67,2021-05-16,18,Distribution,-290,-9999799,14386176,4386377
67,2021-06-30,18,Value,367410,-9999799,14386176,4386377
67,2021-09-30,18,Value,311880,-9999799,14386176,4386377
68,2020-02-15,18,Capital Call,298,-9520079,15056347,5536268
68,2020-02-15,18,Distribution,-472,-9520079,15055875,5535796
68,2020-03-31,18,Value,679760,-9520079,15055875,5535796
68,2020-06-30,18,Value,743790,-9520079,15055875,5535796
68,2020-09-30,18,Value,791850,-9520079,15055875,5535796
68,2020-12-31,18,Value,860890,-9520079,15055875,5535796
68,2021-02-14,18,Distribution,205325,-9520079,15261200,5741121
68,2021-03-31,18,Value,629180,-9520079,15261200,5741121
68,2021-05-16,18,Capital Call,78,-9520001,15261200,5741199
68,2021-05-16,18,Distribution,-124,-9520001,15261076,5741075
68,2021-06-30,18,Value,708130,-9520001,15261076,5741075
68,2021-09-30,18,Value,508360,-9520001,15261076,5741075
75,2020-02-15,21,Distribution,13179,-10000000,4631566,-5368434
75,2020-03-31,21,Value,10,-10000000,4631566,-5368434
75,2021-03-31,21,Value,0,-10000000,4631566,-5368434
75,2021-06-30,21,Value,0,-10000000,4631566,-5368434
75,2021-09-30,21,Value,0,-10000000,4631566,-5368434
75,2021-12-31,21,Value,0,-10000000,4631566,-5368434
76,2020-01-15,21,Capital Call,0,-10000962,10881126,880164
76,2020-01-15,21,Distribution,0,-10000962,10881126,880164
76,2020-02-29,21,Value,616260,-10000962,10881126,880164
76,2020-04-15,21,Capital Call,0,-10000962,10881126,880164
76,2020-04-15,21,Distribution,0,-10000962,10881126,880164
76,2020-05-31,21,Value,455330,-10000962,10881126,880164
76,2020-08-31,21,Value,435790,-10000962,10881126,880164
76,2020-11-30,21,Value,435790,-10000962,10881126,880164
76,2021-01-14,21,Distribution,114840,-10000962,10995966,995004
76,2021-02-28,21,Value,320950,-10000962,10995966,995004
76,2021-04-15,21,Distribution,0,-10000962,10995966,995004
76,2021-05-31,21,Value,420640,-10000962,10995966,995004
76,2021-08-31,21,Value,420420,-10000962,10995966,995004
76,2021-10-16,21,Capital Call,0,-10000962,10995966,995004
76,2021-10-16,21,Distribution,0,-10000962,10995966,995004
76,2021-11-30,21,Value,420710,-10000962,10995966,995004
86,2021-12-31,23,Value,0,-8696902,24764638,16067736
93,2021-12-31,718,Value,0,-10000000,37556093,27556093
117,2020-03-31,28,Value,0,-8185000,19408271,11223271
117,2020-06-30,28,Value,0,-8185000,19408271,11223271
117,2020-09-30,28,Value,0,-8185000,19408271,11223271
117,2020-12-31,28,Value,0,-8185000,19408271,11223271
117,2021-03-31,28,Value,0,-8185000,19408271,11223271
117,2021-06-30,28,Value,0,-8185000,19408271,11223271
117,2021-09-30,28,Value,0,-8185000,19408271,11223271
117,2021-12-31,28,Value,0,-8185000,19408271,11223271
128,2020-03-31,32,Value,0,-8506667,16038095,7531428
128,2020-06-30,32,Value,0,-8506667,16038095,7531428
128,2020-09-30,32,Value,0,-8506667,16038095,7531428
128,2020-12-31,32,Value,0,-8506667,16038095,7531428
128,2021-03-31,32,Value,0,-8506667,16038095,7531428
128,2021-06-30,32,Value,0,-8506667,16038095,7531428
128,2021-09-30,32,Value,0,-8506667,16038095,7531428
128,2021-12-31,32,Value,0,-8506667,16038095,7531428
130,2021-12-31,34,Value,0,-10000000,2029244,-7970756
131,2020-03-31,34,Value,50280,-10000000,6246189,-3753811
131,2020-06-30,34,Value,60150,-10000000,6246189,-3753811
131,2020-09-30,34,Value,121930,-10000000,6246189,-3753811
131,2020-12-31,34,Value,137820,-10000000,6246189,-3753811
131,2021-03-31,34,Value,188590,-10000000,6246189,-3753811
131,2021-06-30,34,Value,188370,-10000000,6246189,-3753811
133,2020-03-31,36,Value,0,-9418644,3047220,-6371424
133,2020-06-30,36,Value,0,-9418644,3047220,-6371424
133,2020-09-30,36,Value,0,-9418644,3047220,-6371424
133,2020-12-31,36,Value,0,-9418644,3047220,-6371424
133,2021-03-31,36,Value,0,-9418644,3047220,-6371424
133,2021-06-30,36,Value,0,-9418644,3047220,-6371424
133,2021-09-30,36,Value,0,-9418644,3047220,-6371424
133,2021-12-31,36,Value,0,-9418644,3047220,-6371424
136,2020-03-31,40,Value,0,-10000000,14987296,4987296
136,2020-06-30,40,Value,0,-10000000,14987296,4987296
136,2020-09-30,40,Value,0,-10000000,14987296,4987296
136,2020-12-31,40,Value,0,-10000000,14987296,4987296
136,2021-03-31,40,Value,0,-10000000,14987296,4987296
136,2021-06-30,40,Value,0,-10000000,14987296,4987296
136,2021-09-30,40,Value,0,-10000000,14987296,4987296
136,2021-12-31,40,Value,0,-10000000,14987296,4987296
137,2021-12-31,40,Value,0,-9841353,9485637,-355716
138,2020-09-30,40,Value,0,-10000000,20110001,10110001
138,2020-12-31,40,Value,0,-10000000,20110001,10110001
138,2021-03-31,40,Value,0,-10000000,20110001,10110001
138,2021-06-30,40,Value,0,-10000000,20110001,10110001
138,2021-09-30,40,Value,0,-10000000,20110001,10110001
138,2021-12-31,40,Value,0,-10000000,20110001,10110001
139,2020-03-31,40,Value,0,-10000000,7051001,-2948999
139,2020-06-30,40,Value,0,-10000000,7051001,-2948999
139,2020-09-30,40,Value,0,-10000000,7051001,-2948999
139,2020-12-31,40,Value,0,-10000000,7051001,-2948999
139,2021-03-31,40,Value,0,-10000000,7051001,-2948999
139,2021-06-30,40,Value,0,-10000000,7051001,-2948999
139,2021-09-30,40,Value,0,-10000000,7051001,-2948999
139,2021-12-31,40,Value,0,-10000000,7051001,-2948999
140,2021-12-31,40,Value,0,-10000000,11400000,1400000
142,2020-02-15,39,Distribution,43000,-9500000,7356000,-2144000
142,2020-03-31,39,Value,267000,-9500000,7356000,-2144000
142,2020-06-30,39,Value,266000,-9500000,7356000,-2144000
142,2020-09-30,39,Value,445000,-9500000,7356000,-2144000
142,2020-11-15,39,Distribution,175000,-9500000,7531000,-1969000
142,2020-12-31,39,Value,324000,-9500000,7531000,-1969000
142,2021-03-31,39,Value,323000,-9500000,7531000,-1969000
142,2021-06-30,39,Value,431000,-9500000,7531000,-1969000
142,2021-12-31,39,Value,0,-9500000,7531000,-1969000
143,2020-03-31,39,Value,0,-10000000,12390000,2390000
143,2020-06-30,39,Value,0,-10000000,12390000,2390000
143,2020-09-30,39,Value,0,-10000000,12390000,2390000
143,2020-12-31,39,Value,0,-10000000,12390000,2390000
143,2021-03-31,39,Value,0,-10000000,12390000,2390000
143,2021-06-30,39,Value,0,-10000000,12390000,2390000
143,2021-09-30,39,Value,0,-10000000,12390000,2390000
143,2021-12-31,39,Value,0,-10000000,12390000,2390000
144,2020-03-31,39,Value,0,-10000000,9466000,-534000
144,2020-06-30,39,Value,0,-10000000,9466000,-534000
144,2020-09-30,39,Value,0,-10000000,9466000,-534000
144,2020-12-31,39,Value,0,-10000000,9466000,-534000
144,2021-03-31,39,Value,0,-10000000,9466000,-534000
144,2021-06-30,39,Value,0,-10000000,9466000,-534000
144,2021-09-30,39,Value,0,-10000000,9466000,-534000
144,2021-12-31,39,Value,0,-10000000,9466000,-534000
145,2021-12-31,39,Value,0,-10000000,6951021,-3048979
150,2020-03-31,9177,Value,2780,-10000000,24167946,14167946
150,2020-06-30,9177,Value,1400,-10000000,24167946,14167946
150,2020-09-30,9177,Value,970,-10000000,24167946,14167946
150,2020-12-31,9177,Value,20,-10000000,24167946,14167946
150,2021-03-31,9177,Value,0,-10000000,24167946,14167946
150,2021-09-30,9177,Value,0,-10000000,24167946,14167946
150,2021-12-31,9177,Value,0,-10000000,24167946,14167946
154,2020-03-31,42,Value,0,-10650438,17540756,6890318
154,2020-06-30,42,Value,0,-10650438,17540756,6890318
154,2020-09-30,42,Value,0,-10650438,17540756,6890318
154,2020-12-31,42,Value,0,-10650438,17540756,6890318
154,2021-03-31,42,Value,0,-10650438,17540756,6890318
154,2021-06-30,42,Value,0,-10650438,17540756,6890318
154,2021-09-30,42,Value,0,-10650438,17540756,6890318
154,2021-12-31,42,Value,0,-10650438,17540756,6890318
158,2020-02-29,44,Value,0,-9724314,18069904,8345590
158,2020-05-31,44,Value,0,-9724314,18069904,8345590
158,2020-08-31,44,Value,0,-9724314,18069904,8345590
158,2020-11-30,44,Value,0,-9724314,18069904,8345590
158,2021-02-28,44,Value,0,-9724314,18069904,8345590
158,2021-05-31,44,Value,0,-9724314,18069904,8345590
158,2021-08-31,44,Value,0,-9724314,18069904,8345590
158,2021-10-16,44,Capital Call,0,-9724314,18069904,8345590
158,2021-10-16,44,Distribution,0,-9724314,18069904,8345590
158,2021-12-31,44,Value,0,-9724314,18069904,8345590
159,2020-03-31,45,Value,0,-10000736,25517917,15517181
159,2020-06-30,45,Value,0,-10000736,25517917,15517181
159,2020-09-30,45,Value,0,-10000736,25517917,15517181
159,2020-12-31,45,Value,0,-10000736,25517917,15517181
159,2021-03-31,45,Value,0,-10000736,25517917,15517181
159,2021-06-30,45,Value,0,-10000736,25517917,15517181
159,2021-09-30,45,Value,0,-10000736,25517917,15517181
159,2021-12-31,45,Value,0,-10000736,25517917,15517181
160,2020-01-15,45,Capital Call,0,-10002422,26120785,16118363
160,2020-01-15,45,Distribution,0,-10002422,26120785,16118363
160,2020-02-29,45,Value,11950,-10002422,26120785,16118363
160,2020-04-15,45,Capital Call,0,-10002422,26120785,16118363
160,2020-04-15,45,Distribution,0,-10002422,26120785,16118363
160,2020-05-31,45,Value,11310,-10002422,26120785,16118363
160,2020-08-31,45,Value,16440,-10002422,26120785,16118363
160,2020-11-30,45,Value,15790,-10002422,26120785,16118363
160,2021-02-28,45,Value,15790,-10002422,26120785,16118363
160,2021-05-31,45,Value,14000,-10002422,26120785,16118363
160,2021-08-31,45,Value,13940,-10002422,26120785,16118363
160,2021-10-16,45,Capital Call,0,-10002422,26120785,16118363
160,2021-10-16,45,Distribution,0,-10002422,26120785,16118363
160,2021-12-31,45,Value,0,-10002422,26120785,16118363
163,2020-03-31,49,Value,0,-10000000,27869001,17869001
163,2020-06-30,49,Value,0,-10000000,27869001,17869001
163,2020-09-30,49,Value,0,-10000000,27869001,17869001
163,2020-12-31,49,Value,0,-10000000,27869001,17869001
163,2021-03-31,49,Value,0,-10000000,27869001,17869001
163,2021-06-30,49,Value,0,-10000000,27869001,17869001
163,2021-09-30,49,Value,0,-10000000,27869001,17869001
163,2021-12-31,49,Value,0,-10000000,27869001,17869001
166,2021-12-31,51673,Value,0,-8816894,20120311,11303417
167,2020-03-31,49,Value,0,-10556605,14218492,3661887
167,2020-06-30,49,Value,0,-10556605,14218492,3661887
167,2020-09-30,49,Value,0,-10556605,14218492,3661887
167,2020-12-31,49,Value,0,-10556605,14218492,3661887
167,2021-12-31,49,Value,0,-10556605,14218492,3661887
169,2020-03-31,49,Value,0,-10298318,21664263,11365945
169,2020-06-30,49,Value,0,-10298318,21664263,11365945
169,2020-09-30,49,Value,0,-10298318,21664263,11365945
169,2020-12-31,49,Value,0,-10298318,21664263,11365945
169,2021-03-31,49,Value,0,-10298318,21664263,11365945
169,2021-06-30,49,Value,0,-10298318,21664263,11365945
169,2021-12-31,49,Value,0,-10298318,21664263,11365945
174,2020-03-31,49,Value,0,-10000000,6923000,-3077000
174,2020-06-30,49,Value,0,-10000000,6923000,-3077000
174,2020-09-30,49,Value,0,-10000000,6923000,-3077000
174,2020-12-31,49,Value,0,-10000000,6923000,-3077000
174,2021-03-31,49,Value,0,-10000000,6923000,-3077000
174,2021-06-30,49,Value,0,-10000000,6923000,-3077000
174,2021-09-30,49,Value,0,-10000000,6923000,-3077000
174,2021-12-31,49,Value,0,-10000000,6923000,-3077000
177,2020-03-31,51673,Value,0,-10000000,17400000,7400000
177,2020-06-30,51673,Value,0,-10000000,17400000,7400000
177,2020-09-30,51673,Value,0,-10000000,17400000,7400000
177,2020-12-31,51673,Value,0,-10000000,17400000,7400000
177,2021-03-31,51673,Value,0,-10000000,17400000,7400000
177,2021-06-30,51673,Value,0,-10000000,17400000,7400000
177,2021-09-30,51673,Value,0,-10000000,17400000,7400000
177,2021-12-31,51673,Value,0,-10000000,17400000,7400000
182,2020-03-31,49,Value,0,-10000000,23200000,13200000
182,2020-06-30,49,Value,0,-10000000,23200000,13200000
182,2020-09-30,49,Value,0,-10000000,23200000,13200000
182,2020-12-31,49,Value,0,-10000000,23200000,13200000
182,2021-03-31,49,Value,0,-10000000,23200000,13200000
182,2021-06-30,49,Value,0,-10000000,23200000,13200000
182,2021-09-30,49,Value,0,-10000000,23200000,13200000
182,2021-12-31,49,Value,0,-10000000,23200000,13200000
190,2020-03-31,50,Value,0,-10000000,52510000,42510000
190,2020-06-30,50,Value,0,-10000000,52510000,42510000
190,2020-09-30,50,Value,0,-10000000,52510000,42510000
190,2020-12-31,50,Value,0,-10000000,52510000,42510000
190,2021-03-31,50,Value,0,-10000000,52510000,42510000
190,2021-06-30,50,Value,0,-10000000,52510000,42510000
190,2021-09-30,50,Value,0,-10000000,52510000,42510000
190,2021-12-31,50,Value,0,-10000000,52510000,42510000
192,2020-03-31,50,Value,0,-9999999,3800000,-6199999
192,2020-06-30,50,Value,0,-9999999,3800000,-6199999
192,2020-09-30,50,Value,0,-9999999,3800000,-6199999
192,2020-12-31,50,Value,0,-9999999,3800000,-6199999
192,2021-03-31,50,Value,0,-9999999,3800000,-6199999
192,2021-06-30,50,Value,0,-9999999,3800000,-6199999
192,2021-09-30,50,Value,0,-9999999,3800000,-6199999
192,2021-12-31,50,Value,0,-9999999,3800000,-6199999
194,2020-03-31,6733,Value,11180,-10272355,16952599,6680244
194,2020-06-30,6733,Value,10700,-10272355,16952599,6680244
194,2020-09-30,6733,Value,10170,-10272355,16952599,6680244
194,2020-12-31,6733,Value,6690,-10272355,16952599,6680244
194,2021-03-31,6733,Value,4170,-10272355,16952599,6680244
194,2021-06-30,6733,Value,3390,-10272355,16952599,6680244
194,2021-12-31,6733,Value,0,-10272355,16952599,6680244
195,2020-03-31,6733,Value,86140,-15586017,30748183,15162166
195,2020-06-30,6733,Value,86070,-15586017,30748183,15162166
195,2020-09-30,6733,Value,86210,-15586017,30748183,15162166
195,2020-12-31,6733,Value,85720,-15586017,30748183,15162166
195,2021-03-31,6733,Value,85940,-15586017,30748183,15162166
195,2021-06-30,6733,Value,85710,-15586017,30748183,15162166
203,2021-12-31,52,Value,0,-10000000,1133580,-8866420
205,2020-03-31,54,Value,25830,-12003110,17890256,5887146
205,2020-06-30,54,Value,82310,-12003110,17890256,5887146
205,2020-09-30,54,Value,23620,-12003110,17890256,5887146
205,2020-12-31,54,Value,20070,-12003110,17890256,5887146
205,2021-03-31,54,Value,103990,-12003110,17890256,5887146
205,2021-06-30,54,Value,81020,-12003110,17890256,5887146
207,2020-03-31,58,Value,0,-10625883,11650218,1024335
207,2020-06-30,58,Value,0,-10625883,11650218,1024335
207,2020-09-30,58,Value,0,-10625883,11650218,1024335
207,2020-12-31,58,Value,0,-10625883,11650218,1024335
207,2021-03-31,58,Value,0,-10625883,11650218,1024335
207,2021-06-30,58,Value,0,-10625883,11650218,1024335
207,2021-09-30,58,Value,0,-10625883,11650218,1024335
207,2021-12-31,58,Value,0,-10625883,11650218,1024335
209,2021-12-31,60,Value,0,-10769716,19081676,8311960
210,2020-03-31,62,Value,0,-10689848,6413909,-4275939
210,2020-06-30,62,Value,0,-10689848,6413909,-4275939
210,2020-09-30,62,Value,0,-10689848,6413909,-4275939
210,2020-12-31,62,Value,0,-10689848,6413909,-4275939
210,2021-03-31,62,Value,0,-10689848,6413909,-4275939
210,2021-06-30,62,Value,0,-10689848,6413909,-4275939
210,2021-09-30,62,Value,0,-10689848,6413909,-4275939
210,2021-12-31,62,Value,0,-10689848,6413909,-4275939
216,2020-03-31,65,Value,0,-10000001,7031698,-2968303
216,2020-06-30,65,Value,0,-10000001,7031698,-2968303
216,2020-09-30,65,Value,0,-10000001,7031698,-2968303
216,2020-12-31,65,Value,0,-10000001,7031698,-2968303
216,2021-12-31,65,Value,0,-10000001,7031698,-2968303
217,2020-03-31,67,Value,0,-9967937,1034512,-8933425
217,2020-06-30,67,Value,0,-9967937,1034512,-8933425
217,2020-09-30,67,Value,0,-9967937,1034512,-8933425
217,2020-12-31,67,Value,0,-9967937,1034512,-8933425
217,2021-03-31,67,Value,0,-9967937,1034512,-8933425
217,2021-06-30,67,Value,0,-9967937,1034512,-8933425
217,2021-09-30,67,Value,0,-9967937,1034512,-8933425
217,2021-12-31,67,Value,0,-9967937,1034512,-8933425
223,2021-12-31,68,Value,0,-10004162,7241939,-2762223
226,2020-02-15,70,Distribution,19620,-9999999,15314196,5314197
226,2020-03-31,70,Value,0,-9999999,15314196,5314197
229,2020-03-31,72,Value,0,-10890845,14508368,3617523
229,2020-06-30,72,Value,0,-10890845,14508368,3617523
229,2020-09-30,72,Value,0,-10890845,14508368,3617523
229,2020-12-31,72,Value,0,-10890845,14508368,3617523
229,2021-03-31,72,Value,0,-10890845,14508368,3617523
229,2021-06-30,72,Value,0,-10890845,14508368,3617523
229,2021-09-30,72,Value,0,-10890845,14508368,3617523
229,2021-12-31,72,Value,0,-10890845,14508368,3617523
230,2020-03-31,72,Value,0,-11054212,15572305,4518093
230,2020-06-30,72,Value,0,-11054212,15572305,4518093
230,2020-09-30,72,Value,0,-11054212,15572305,4518093
230,2020-12-31,72,Value,0,-11054212,15572305,4518093
230,2021-03-31,72,Value,0,-11054212,15572305,4518093
230,2021-06-30,72,Value,0,-11054212,15572305,4518093
230,2021-09-30,72,Value,0,-11054212,15572305,4518093
230,2021-12-31,72,Value,0,-11054212,15572305,4518093
236,2020-01-15,75,Capital Call,0,-10017184,84188424,74171240
236,2020-01-15,75,Distribution,-164,-10017184,84188260,74171076
236,2020-02-29,75,Value,0,-10017184,84188260,74171076
236,2020-04-15,75,Capital Call,0,-10017184,84188260,74171076
236,2020-04-15,75,Distribution,1,-10017184,84188261,74171077
236,2020-05-31,75,Value,0,-10017184,84188261,74171077
236,2020-08-31,75,Value,0,-10017184,84188261,74171077
236,2020-11-30,75,Value,0,-10017184,84188261,74171077
236,2021-05-31,75,Value,0,-10017184,84188261,74171077
236,2021-08-31,75,Value,0,-10017184,84188261,74171077
236,2021-12-31,75,Value,0,-10017184,84188261,74171077
237,2020-02-29,75,Value,0,-10001330,19757176,9755846
237,2020-05-31,75,Value,0,-10001330,19757176,9755846
237,2020-07-16,75,Distribution,-2,-10001330,19757174,9755844
237,2020-08-31,75,Value,0,-10001330,19757174,9755844
237,2020-11-30,75,Value,0,-10001330,19757174,9755844
237,2021-02-28,75,Value,0,-10001330,19757174,9755844
237,2021-05-31,75,Value,0,-10001330,19757174,9755844
237,2021-08-31,75,Value,0,-10001330,19757174,9755844
237,2021-10-16,75,Capital Call,0,-10001330,19757174,9755844
237,2021-10-16,75,Distribution,0,-10001330,19757174,9755844
237,2021-12-31,75,Value,0,-10001330,19757174,9755844
238,2020-03-31,75,Value,0,-10582426,6561263,-4021163
238,2020-06-30,75,Value,0,-10582426,6561263,-4021163
238,2020-09-30,75,Value,0,-10582426,6561263,-4021163
238,2020-12-31,75,Value,0,-10582426,6561263,-4021163
238,2021-03-31,75,Value,0,-10582426,6561263,-4021163
238,2021-06-30,75,Value,0,-10582426,6561263,-4021163
238,2021-09-30,75,Value,0,-10582426,6561263,-4021163
238,2021-12-31,75,Value,0,-10582426,6561263,-4021163
239,2020-02-15,75,Distribution,0,-10000000,8056767,-1943233
239,2020-03-31,75,Value,17120,-10000000,8056767,-1943233
239,2020-05-16,75,Distribution,0,-10000000,8056767,-1943233
239,2020-06-30,75,Value,16460,-10000000,8056767,-1943233
239,2020-09-30,75,Value,16160,-10000000,8056767,-1943233
239,2020-11-15,75,Distribution,14978,-10000000,8071745,-1928255
239,2020-12-31,75,Value,16160,-10000000,8071745,-1928255
239,2021-12-31,75,Value,0,-10000000,8071745,-1928255
240,2020-02-15,75,Distribution,0,-10000005,16191445,6191440
240,2020-03-31,75,Value,353790,-10000005,16191445,6191440
240,2020-05-16,75,Distribution,180723,-10000005,16372168,6372163
240,2020-06-30,75,Value,172770,-10000005,16372168,6372163
240,2020-09-30,75,Value,173270,-10000005,16372168,6372163
240,2020-11-15,75,Distribution,0,-10000005,16372168,6372163
240,2020-12-31,75,Value,173280,-10000005,16372168,6372163
246,2020-03-31,79,Value,0,-10193181,15922430,5729249
246,2020-06-30,79,Value,0,-10193181,15922430,5729249
246,2020-09-30,79,Value,0,-10193181,15922430,5729249
246,2020-12-31,79,Value,0,-10193181,15922430,5729249
246,2021-03-31,79,Value,0,-10193181,15922430,5729249
246,2021-06-30,79,Value,0,-10193181,15922430,5729249
246,2021-09-30,79,Value,0,-10193181,15922430,5729249
246,2021-12-31,79,Value,0,-10193181,15922430,5729249
251,2020-03-31,335,Value,0,-8200000,16547600,8347600
251,2020-06-30,335,Value,0,-8200000,16547600,8347600
251,2020-09-30,335,Value,0,-8200000,16547600,8347600
251,2020-12-31,335,Value,0,-8200000,16547600,8347600
251,2021-03-31,335,Value,0,-8200000,16547600,8347600
251,2021-06-30,335,Value,0,-8200000,16547600,8347600
251,2021-09-30,335,Value,0,-8200000,16547600,8347600
251,2021-12-31,335,Value,0,-8200000,16547600,8347600
255,2020-01-15,81,Capital Call,0,-10309731,10804556,494825
255,2020-01-15,81,Distribution,0,-10309731,10804556,494825
255,2020-02-29,81,Value,1100260,-10309731,10804556,494825
255,2020-04-15,81,Capital Call,0,-10309731,10804556,494825
255,2020-04-15,81,Distribution,0,-10309731,10804556,494825
255,2020-05-31,81,Value,1405230,-10309731,10804556,494825
255,2020-08-31,81,Value,2075610,-10309731,10804556,494825
255,2020-11-30,81,Value,2426750,-10309731,10804556,494825
255,2021-02-28,81,Value,2426750,-10309731,10804556,494825
255,2021-05-31,81,Value,3166210,-10309731,10804556,494825
255,2021-08-31,81,Value,3161250,-10309731,10804556,494825
255,2021-10-16,81,Capital Call,0,-10309731,10804556,494825
255,2021-10-16,81,Distribution,0,-10309731,10804556,494825
255,2021-11-30,81,Value,3159440,-10309731,10804556,494825
258,2020-03-31,736,Value,0,-10000000,26250147,16250147
258,2020-06-30,736,Value,0,-10000000,26250147,16250147
258,2020-09-30,736,Value,0,-10000000,26250147,16250147
258,2020-12-31,736,Value,0,-10000000,26250147,16250147
258,2021-03-31,736,Value,0,-10000000,26250147,16250147
258,2021-06-30,736,Value,0,-10000000,26250147,16250147
258,2021-09-30,736,Value,0,-10000000,26250147,16250147
258,2021-12-31,736,Value,0,-10000000,26250147,16250147
259,2021-12-31,736,Value,0,-10000000,23011660,13011660
260,2020-03-31,736,Value,0,-10000000,22815001,12815001
260,2020-06-30,736,Value,0,-10000000,22815001,12815001
260,2020-09-30,736,Value,0,-10000000,22815001,12815001
260,2020-12-31,736,Value,0,-10000000,22815001,12815001
260,2021-03-31,736,Value,0,-10000000,22815001,12815001
260,2021-06-30,736,Value,0,-10000000,22815001,12815001
260,2021-09-30,736,Value,0,-10000000,22815001,12815001
260,2021-12-31,736,Value,0,-10000000,22815001,12815001
272,2020-03-31,124782,Value,0,-9797515,19318656,9521141
272,2020-06-30,124782,Value,0,-9797515,19318656,9521141
272,2020-09-30,124782,Value,0,-9797515,19318656,9521141
272,2020-12-31,124782,Value,0,-9797515,19318656,9521141
272,2021-03-31,124782,Value,0,-9797515,19318656,9521141
272,2021-06-30,124782,Value,0,-9797515,19318656,9521141
272,2021-09-30,124782,Value,0,-9797515,19318656,9521141
272,2021-12-31,124782,Value,0,-9797515,19318656,9521141
278,2020-03-31,93,Value,0,-10000000,13300000,3300000
278,2020-06-30,93,Value,0,-10000000,13300000,3300000
278,2020-09-30,93,Value,0,-10000000,13300000,3300000
278,2020-12-31,93,Value,0,-10000000,13300000,3300000
278,2021-03-31,93,Value,0,-10000000,13300000,3300000
278,2021-06-30,93,Value,0,-10000000,13300000,3300000
278,2021-09-30,93,Value,0,-10000000,13300000,3300000
278,2021-12-31,93,Value,0,-10000000,13300000,3300000
279,2020-03-31,93,Value,0,-10000003,13268991,3268988
279,2020-06-30,93,Value,0,-10000003,13268991,3268988
279,2020-09-30,93,Value,0,-10000003,13268991,3268988
279,2020-12-31,93,Value,0,-10000003,13268991,3268988
279,2021-03-31,93,Value,0,-10000003,13268991,3268988
279,2021-06-30,93,Value,0,-10000003,13268991,3268988
279,2021-09-30,93,Value,0,-10000003,13268991,3268988
279,2021-12-31,93,Value,0,-10000003,13268991,3268988
281,2020-03-31,94,Value,0,-10000000,18492096,8492096
281,2020-06-30,94,Value,0,-10000000,18492096,8492096
281,2020-09-30,94,Value,0,-10000000,18492096,8492096
281,2020-12-31,94,Value,0,-10000000,18492096,8492096
281,2021-03-31,94,Value,0,-10000000,18492096,8492096
281,2021-06-30,94,Value,0,-10000000,18492096,8492096
281,2021-09-30,94,Value,0,-10000000,18492096,8492096
281,2021-12-31,94,Value,0,-10000000,18492096,8492096
284,2020-03-31,96,Value,58510,-9999998,25313947,15313949
284,2020-06-30,96,Value,58510,-9999998,25313947,15313949
284,2020-09-30,96,Value,58510,-9999998,25313947,15313949
284,2020-12-31,96,Value,63530,-9999998,25313947,15313949
284,2021-03-31,96,Value,63530,-9999998,25313947,15313949
284,2021-06-30,96,Value,63530,-9999998,25313947,15313949
284,2021-12-31,96,Value,0,-9999998,25313947,15313949
291,2020-03-31,99,Value,0,-9908689,2517397,-7391292
291,2020-06-30,99,Value,0,-9908689,2517397,-7391292
291,2020-09-30,99,Value,0,-9908689,2517397,-7391292
291,2020-12-31,99,Value,0,-9908689,2517397,-7391292
291,2021-03-31,99,Value,0,-9908689,2517397,-7391292
291,2021-06-30,99,Value,0,-9908689,2517397,-7391292
291,2021-09-30,99,Value,0,-9908689,2517397,-7391292
291,2021-12-31,99,Value,0,-9908689,2517397,-7391292
295,2021-12-31,101,Value,0,-10237500,16288375,6050875
296,2020-03-31,101,Value,0,-9999998,12190001,2190003
296,2020-06-30,101,Value,0,-9999998,12190001,2190003
296,2020-09-30,101,Value,0,-9999998,12190001,2190003
296,2020-12-31,101,Value,0,-9999998,12190001,2190003
296,2021-03-31,101,Value,0,-9999998,12190001,2190003
296,2021-06-30,101,Value,0,-9999998,12190001,2190003
296,2021-09-30,101,Value,0,-9999998,12190001,2190003
296,2021-12-31,101,Value,0,-9999998,12190001,2190003
297,2020-03-31,101,Value,0,-10000001,17737728,7737727
297,2020-06-30,101,Value,0,-10000001,17737728,7737727
297,2020-09-30,101,Value,0,-10000001,17737728,7737727
297,2020-12-31,101,Value,0,-10000001,17737728,7737727
297,2021-03-31,101,Value,0,-10000001,17737728,7737727
297,2021-06-30,101,Value,0,-10000001,17737728,7737727
297,2021-09-30,101,Value,0,-10000001,17737728,7737727
297,2021-12-31,101,Value,0,-10000001,17737728,7737727
302,2020-03-31,102,Value,640270,-9800000,13285944,3485944
302,2020-06-30,102,Value,639530,-9800000,13285944,3485944
302,2020-09-30,102,Value,900230,-9800000,13285944,3485944
302,2020-11-15,102,Distribution,636643,-9800000,13922587,4122587
302,2020-12-31,102,Value,309070,-9800000,13922587,4122587
302,2021-03-31,102,Value,328780,-9800000,13922587,4122587
306,2020-03-31,103,Value,0,-9679000,37186718,27507718
306,2020-06-30,103,Value,0,-9679000,37186718,27507718
306,2020-09-30,103,Value,0,-9679000,37186718,27507718
306,2020-12-31,103,Value,0,-9679000,37186718,27507718
306,2021-03-31,103,Value,0,-9679000,37186718,27507718
306,2021-06-30,103,Value,0,-9679000,37186718,27507718
306,2021-09-30,103,Value,0,-9679000,37186718,27507718
306,2021-12-31,103,Value,0,-9679000,37186718,27507718
307,2020-03-31,103,Value,0,-9580404,24949736,15369332
307,2020-06-30,103,Value,0,-9580404,24949736,15369332
307,2020-09-30,103,Value,0,-9580404,24949736,15369332
307,2020-12-31,103,Value,0,-9580404,24949736,15369332
307,2021-03-31,103,Value,0,-9580404,24949736,15369332
307,2021-06-30,103,Value,0,-9580404,24949736,15369332
307,2021-09-30,103,Value,0,-9580404,24949736,15369332
307,2021-12-31,103,Value,0,-9580404,24949736,15369332
308,2020-03-31,103,Value,0,-9574999,25162145,15587146
308,2020-06-30,103,Value,0,-9574999,25162145,15587146
308,2020-09-30,103,Value,0,-9574999,25162145,15587146
308,2020-12-31,103,Value,0,-9574999,25162145,15587146
308,2021-03-31,103,Value,0,-9574999,25162145,15587146
308,2021-06-30,103,Value,0,-9574999,25162145,15587146
308,2021-09-30,103,Value,0,-9574999,25162145,15587146
308,2021-12-31,103,Value,0,-9574999,25162145,15587146
309,2020-03-31,103,Value,1667710,-9309793,27399897,18090104
309,2020-06-30,103,Value,2093640,-9309793,27399897,18090104
309,2020-09-30,103,Value,2230730,-9309793,27399897,18090104
309,2021-12-31,103,Value,0,-9309793,27399897,18090104
318,2020-03-31,111,Value,0,-10610000,23692130,13082130
318,2020-06-30,111,Value,0,-10610000,23692130,13082130
318,2020-09-30,111,Value,0,-10610000,23692130,13082130
318,2020-12-31,111,Value,0,-10610000,23692130,13082130
318,2021-03-31,111,Value,0,-10610000,23692130,13082130
318,2021-06-30,111,Value,0,-10610000,23692130,13082130
318,2021-09-30,111,Value,0,-10610000,23692130,13082130
318,2021-12-31,111,Value,0,-10610000,23692130,13082130
319,2020-03-31,111,Value,0,-10811033,21125906,10314873
319,2020-06-30,111,Value,0,-10811033,21125906,10314873
319,2020-09-30,111,Value,0,-10811033,21125906,10314873
319,2020-12-31,111,Value,0,-10811033,21125906,10314873
319,2021-03-31,111,Value,0,-10811033,21125906,10314873
319,2021-06-30,111,Value,0,-10811033,21125906,10314873
319,2021-09-30,111,Value,0,-10811033,21125906,10314873
319,2021-12-31,111,Value,0,-10811033,21125906,10314873
320,2020-03-31,111,Value,247830,-12065696,28575139,16509443
320,2020-06-30,111,Value,245910,-12065696,28575139,16509443
320,2020-09-30,111,Value,223320,-12065696,28575139,16509443
320,2020-11-15,111,Capital Call,0,-12065696,28575139,16509443
320,2020-11-15,111,Distribution,0,-12065696,28575139,16509443
320,2020-12-31,111,Value,220340,-12065696,28575139,16509443
320,2021-02-14,111,Capital Call,0,-12065696,28575139,16509443
320,2021-02-14,111,Distribution,0,-12065696,28575139,16509443
320,2021-03-31,111,Value,214300,-12065696,28575139,16509443
320,2021-05-16,111,Distribution,74360,-12065696,28649499,16583803
320,2021-06-30,111,Value,154870,-12065696,28649499,16583803
320,2021-08-15,111,Distribution,2276,-12065696,28651775,16586079
320,2021-09-30,111,Value,147140,-12065696,28651775,16586079
321,2020-03-31,111,Value,56420,-11122644,13547354,2424710
321,2020-06-30,111,Value,58600,-11122644,13547354,2424710
321,2020-09-30,111,Value,60660,-11122644,13547354,2424710
321,2020-12-31,111,Value,62850,-11122644,13547354,2424710
321,2021-03-31,111,Value,87360,-11122644,13547354,2424710
321,2021-06-30,111,Value,79870,-11122644,13547354,2424710
325,2020-03-31,113,Value,0,-10000000,15861000,5861000
325,2020-06-30,113,Value,0,-10000000,15861000,5861000
325,2020-09-30,113,Value,0,-10000000,15861000,5861000
325,2020-12-31,113,Value,0,-10000000,15861000,5861000
325,2021-03-31,113,Value,0,-10000000,15861000,5861000
325,2021-06-30,113,Value,0,-10000000,15861000,5861000
325,2021-09-30,113,Value,0,-10000000,15861000,5861000
325,2021-12-31,113,Value,0,-10000000,15861000,5861000
326,2020-03-31,113,Value,0,-10000000,10396215,396215
326,2020-06-30,113,Value,0,-10000000,10396215,396215
326,2020-09-30,113,Value,0,-10000000,10396215,396215
326,2020-12-31,113,Value,0,-10000000,10396215,396215
326,2021-03-31,113,Value,0,-10000000,10396215,396215
326,2021-06-30,113,Value,0,-10000000,10396215,396215
326,2021-09-30,113,Value,0,-10000000,10396215,396215
326,2021-12-31,113,Value,0,-10000000,10396215,396215
327,2020-03-31,113,Value,0,-10000000,3900000,-6100000
327,2020-06-30,113,Value,0,-10000000,3900000,-6100000
327,2020-09-30,113,Value,0,-10000000,3900000,-6100000
327,2020-12-31,113,Value,0,-10000000,3900000,-6100000
327,2021-03-31,113,Value,0,-10000000,3900000,-6100000
327,2021-06-30,113,Value,0,-10000000,3900000,-6100000
327,2021-09-30,113,Value,0,-10000000,3900000,-6100000
327,2021-12-31,113,Value,0,-10000000,3900000,-6100000
328,2020-03-31,113,Value,611450,-10000000,9508220,-491780
328,2020-06-30,113,Value,576320,-10000000,9508220,-491780
328,2020-09-30,113,Value,579830,-10000000,9508220,-491780
328,2020-12-31,113,Value,695310,-10000000,9508220,-491780
328,2021-03-31,113,Value,697900,-10000000,9508220,-491780
333,2020-03-31,116,Value,0,-8047613,18028431,9980818
333,2020-06-30,116,Value,0,-8047613,18028431,9980818
333,2020-09-30,116,Value,0,-8047613,18028431,9980818
333,2020-12-31,116,Value,0,-8047613,18028431,9980818
333,2021-03-31,116,Value,0,-8047613,18028431,9980818
333,2021-06-30,116,Value,0,-8047613,18028431,9980818
333,2021-09-30,116,Value,0,-8047613,18028431,9980818
333,2021-12-31,116,Value,0,-8047613,18028431,9980818
335,2020-03-31,117,Distribution,400000,-10000000,8000000,-2000000
335,2020-09-30,117,Value,500000,-10000000,8000000,-2000000
339,2020-03-31,118,Value,0,-9433072,14141116,4708044
339,2020-05-16,118,Capital Call,1459,-9431613,14141116,4709503
339,2020-06-30,118,Value,0,-9431613,14141116,4709503
339,2020-09-30,118,Value,0,-9431613,14141116,4709503
339,2020-12-31,118,Value,0,-9431613,14141116,4709503
339,2021-12-31,118,Value,0,-9431613,14141116,4709503
345,2020-03-31,120,Value,0,-10000000,6635850,-3364150
345,2020-06-30,120,Value,0,-10000000,6635850,-3364150
345,2020-09-30,120,Value,0,-10000000,6635850,-3364150
345,2020-12-31,120,Value,0,-10000000,6635850,-3364150
345,2021-03-31,120,Value,0,-10000000,6635850,-3364150
345,2021-06-30,120,Value,0,-10000000,6635850,-3364150
345,2021-09-30,120,Value,0,-10000000,6635850,-3364150
345,2021-12-31,120,Value,0,-10000000,6635850,-3364150
348,2020-03-31,121,Value,0,-11873318,17454723,5581405
348,2020-06-30,121,Value,0,-11873318,17454723,5581405
348,2020-09-30,121,Value,0,-11873318,17454723,5581405
348,2020-12-31,121,Value,0,-11873318,17454723,5581405
348,2021-03-31,121,Value,0,-11873318,17454723,5581405
348,2021-06-30,121,Value,0,-11873318,17454723,5581405
348,2021-09-30,121,Value,0,-11873318,17454723,5581405
348,2021-12-31,121,Value,0,-11873318,17454723,5581405
350,2021-03-31,7257,Value,0,-10000000,14462345,4462345
350,2021-06-30,7257,Value,0,-10000000,14462345,4462345
350,2021-09-30,7257,Value,0,-10000000,14462345,4462345
350,2021-12-31,7257,Value,0,-10000000,14462345,4462345
352,2021-12-31,7257,Value,0,-10000001,50098641,40098640
353,2020-03-31,7257,Value,0,-10000000,52604324,42604324
353,2020-06-30,7257,Value,0,-10000000,52604324,42604324
353,2020-09-30,7257,Value,0,-10000000,52604324,42604324
353,2020-12-31,7257,Value,0,-10000000,52604324,42604324
353,2021-03-31,7257,Value,0,-10000000,52604324,42604324
353,2021-06-30,7257,Value,0,-10000000,52604324,42604324
353,2021-09-30,7257,Value,0,-10000000,52604324,42604324
353,2021-12-31,7257,Value,0,-10000000,52604324,42604324
354,2020-03-31,122,Value,0,-5407004,4296945,-1110059
354,2020-06-30,122,Value,0,-5407004,4296945,-1110059
354,2020-09-30,122,Value,0,-5407004,4296945,-1110059
354,2020-12-31,122,Value,0,-5407004,4296945,-1110059
354,2021-03-31,122,Value,0,-5407004,4296945,-1110059
354,2021-06-30,122,Value,0,-5407004,4296945,-1110059
354,2021-09-30,122,Value,0,-5407004,4296945,-1110059
354,2021-12-31,122,Value,0,-5407004,4296945,-1110059
356,2021-12-31,124,Value,0,-10470000,16980000,6510000
376,2020-03-31,126,Value,22660,-9384000,20095333,10711333
376,2020-06-30,126,Value,22660,-9384000,20095333,10711333
376,2020-09-30,126,Value,27330,-9384000,20095333,10711333
376,2021-12-31,126,Value,0,-9384000,20095333,10711333
377,2020-03-31,129,Value,0,-10470001,18479550,8009549
377,2020-06-30,129,Value,0,-10470001,18479550,8009549
377,2020-09-30,129,Value,0,-10470001,18479550,8009549
377,2020-12-31,129,Value,0,-10470001,18479550,8009549
377,2021-03-31,129,Value,0,-10470001,18479550,8009549
377,2021-06-30,129,Value,0,-10470001,18479550,8009549
377,2021-09-30,129,Value,0,-10470001,18479550,8009549
377,2021-12-31,129,Value,0,-10470001,18479550,8009549
382,2020-03-31,558,Value,0,-10000000,16504301,6504301
382,2020-06-30,558,Value,0,-10000000,16504301,6504301
382,2020-09-30,558,Value,0,-10000000,16504301,6504301
382,2020-12-31,558,Value,0,-10000000,16504301,6504301
382,2021-03-31,558,Value,0,-10000000,16504301,6504301
382,2021-06-30,558,Value,0,-10000000,16504301,6504301
382,2021-09-30,558,Value,0,-10000000,16504301,6504301
382,2021-12-31,558,Value,0,-10000000,16504301,6504301
384,2020-03-31,1358,Value,0,-9990002,17102880,7112878
384,2020-06-30,1358,Value,0,-9990002,17102880,7112878
384,2020-09-30,1358,Value,0,-9990002,17102880,7112878
384,2020-12-31,1358,Value,0,-9990002,17102880,7112878
384,2021-03-31,1358,Value,0,-9990002,17102880,7112878
384,2021-06-30,1358,Value,0,-9990002,17102880,7112878
384,2021-09-30,1358,Value,0,-9990002,17102880,7112878
384,2021-12-31,1358,Value,0,-9990002,17102880,7112878
386,2020-03-31,131,Value,0,-7830099,18526014,10695915
386,2020-06-30,131,Value,0,-7830099,18526014,10695915
386,2020-09-30,131,Value,0,-7830099,18526014,10695915
386,2020-12-31,131,Value,0,-7830099,18526014,10695915
386,2021-03-31,131,Value,0,-7830099,18526014,10695915
386,2021-06-30,131,Value,0,-7830099,18526014,10695915
386,2021-09-30,131,Value,0,-7830099,18526014,10695915
386,2021-12-31,131,Value,0,-7830099,18526014,10695915
387,2020-03-31,131,Value,0,-8121847,15490022,7368175
387,2020-06-30,131,Value,0,-8121847,15490022,7368175
387,2020-09-30,131,Value,0,-8121847,15490022,7368175
387,2020-12-31,131,Value,0,-8121847,15490022,7368175
387,2021-03-31,131,Value,0,-8121847,15490022,7368175
387,2021-06-30,131,Value,0,-8121847,15490022,7368175
387,2021-09-30,131,Value,0,-8121847,15490022,7368175
387,2021-12-31,131,Value,0,-8121847,15490022,7368175
388,2020-03-31,54293,Value,0,-11725681,18041371,6315690
388,2020-06-30,54293,Value,0,-11725681,18041371,6315690
388,2020-09-30,54293,Value,0,-11725681,18041371,6315690
388,2020-12-31,54293,Value,0,-11725681,18041371,6315690
388,2021-03-31,54293,Value,0,-11725681,18041371,6315690
388,2021-06-30,54293,Value,0,-11725681,18041371,6315690
388,2021-09-30,54293,Value,0,-11725681,18041371,6315690
388,2021-12-31,54293,Value,0,-11725681,18041371,6315690
391,2020-03-31,133,Value,0,-9999891,19279791,9279900
391,2020-06-30,133,Value,0,-9999891,19279791,9279900
391,2020-09-30,133,Value,0,-9999891,19279791,9279900
391,2020-12-31,133,Value,0,-9999891,19279791,9279900
391,2021-03-31,133,Value,0,-9999891,19279791,9279900
391,2021-06-30,133,Value,0,-9999891,19279791,9279900
391,2021-09-30,133,Value,0,-9999891,19279791,9279900
391,2021-12-31,133,Value,0,-9999891,19279791,9279900
402,2020-03-31,138,Value,0,-10000000,18733679,8733679
402,2020-06-30,138,Value,0,-10000000,18733679,8733679
402,2020-09-30,138,Value,0,-10000000,18733679,8733679
402,2020-12-31,138,Value,0,-10000000,18733679,8733679
402,2021-03-31,138,Value,0,-10000000,18733679,8733679
402,2021-06-30,138,Value,0,-10000000,18733679,8733679
402,2021-09-30,138,Value,0,-10000000,18733679,8733679
402,2021-12-31,138,Value,0,-10000000,18733679,8733679
403,2020-03-31,138,Value,38000,-10000000,15266001,5266001
403,2020-06-30,138,Value,26000,-10000000,15266001,5266001
403,2020-09-30,138,Value,40000,-10000000,15266001,5266001
403,2020-12-31,138,Value,30000,-10000000,15266001,5266001
406,2021-12-31,140,Value,0,-10524990,28444082,17919092
418,2020-03-31,141,Value,0,-10000000,10217001,217001
418,2020-06-30,141,Value,0,-10000000,10217001,217001
418,2020-09-30,141,Value,0,-10000000,10217001,217001
418,2020-12-31,141,Value,0,-10000000,10217001,217001
418,2021-03-31,141,Value,0,-10000000,10217001,217001
418,2021-06-30,141,Value,0,-10000000,10217001,217001
418,2021-09-30,141,Value,0,-10000000,10217001,217001
418,2021-12-31,141,Value,0,-10000000,10217001,217001
420,2021-12-31,143,Value,0,-10000000,2800000,-7200000
424,2020-03-31,144,Value,919990,-11210000,14700000,3490000
424,2020-06-30,144,Value,919990,-11210000,14700000,3490000
424,2020-09-30,144,Value,1119990,-11210000,14700000,3490000
424,2020-11-15,144,Distribution,830000,-11210000,15530000,4320000
424,2020-12-31,144,Value,0,-11210000,15530000,4320000
424,2021-06-30,144,Value,0,-11210000,15530000,4320000
424,2021-09-30,144,Value,0,-11210000,15530000,4320000
424,2021-12-31,144,Value,0,-11210000,15530000,4320000
435,2021-12-31,152,Value,0,-10000000,9051529,-948471
437,2020-03-31,152,Value,0,-9600000,15898190,6298190
437,2020-06-30,152,Value,0,-9600000,15898190,6298190
437,2020-09-30,152,Value,0,-9600000,15898190,6298190
437,2020-12-31,152,Value,0,-9600000,15898190,6298190
437,2021-03-31,152,Value,0,-9600000,15898190,6298190
437,2021-06-30,152,Value,0,-9600000,15898190,6298190
437,2021-09-30,152,Value,0,-9600000,15898190,6298190
437,2021-12-31,152,Value,0,-9600000,15898190,6298190
438,2020-03-31,153,Value,0,-12856645,10401740,-2454905
438,2020-06-30,153,Value,0,-12856645,10401740,-2454905
438,2021-12-31,153,Value,0,-12856645,10401740,-2454905
446,2021-12-31,203,Value,0,-9959671,16977193,7017522
447,2020-03-31,203,Value,0,-8711919,13398877,4686958
447,2020-06-30,203,Value,0,-8711919,13398877,4686958
447,2020-09-30,203,Value,0,-8711919,13398877,4686958
447,2020-12-31,203,Value,0,-8711919,13398877,4686958
447,2021-03-31,203,Value,0,-8711919,13398877,4686958
447,2021-06-30,203,Value,0,-8711919,13398877,4686958
447,2021-09-30,203,Value,0,-8711919,13398877,4686958
447,2021-12-31,203,Value,0,-8711919,13398877,4686958
460,2020-03-31,162,Value,0,-9670002,24629489,14959487
460,2020-06-30,162,Value,0,-9670002,24629489,14959487
460,2020-09-30,162,Value,0,-9670002,24629489,14959487
460,2020-12-31,162,Value,0,-9670002,24629489,14959487
460,2021-03-31,162,Value,0,-9670002,24629489,14959487
460,2021-06-30,162,Value,0,-9670002,24629489,14959487
460,2021-09-30,162,Value,0,-9670002,24629489,14959487
460,2021-12-31,162,Value,0,-9670002,24629489,14959487
461,2020-03-31,162,Value,0,-11272259,23694050,12421791
461,2020-06-30,162,Value,0,-11272259,23694050,12421791
461,2020-09-30,162,Value,0,-11272259,23694050,12421791
461,2020-12-31,162,Value,0,-11272259,23694050,12421791
461,2021-12-31,162,Value,0,-11272259,23694050,12421791
463,2020-03-31,162,Value,0,-10861412,21026559,10165147
463,2020-06-30,162,Value,0,-10861412,21026559,10165147
463,2020-09-30,162,Value,0,-10861412,21026559,10165147
463,2020-12-31,162,Value,0,-10861412,21026559,10165147
463,2021-12-31,162,Value,0,-10861412,21026559,10165147
476,2020-03-31,168,Value,0,-10000000,7989500,-2010500
476,2020-06-30,168,Value,0,-10000000,7989500,-2010500
476,2020-09-30,168,Value,0,-10000000,7989500,-2010500
476,2020-12-31,168,Value,0,-10000000,7989500,-2010500
476,2021-03-31,168,Value,0,-10000000,7989500,-2010500
476,2021-06-30,168,Value,0,-10000000,7989500,-2010500
476,2021-09-30,168,Value,0,-10000000,7989500,-2010500
476,2021-12-31,168,Value,0,-10000000,7989500,-2010500
481,2020-03-31,169,Value,0,-9823396,10419672,596276
481,2020-06-30,169,Value,0,-9823396,10419672,596276
481,2020-09-30,169,Value,0,-9823396,10419672,596276
481,2020-12-31,169,Value,0,-9823396,10419672,596276
481,2021-03-31,169,Value,0,-9823396,10419672,596276
481,2021-06-30,169,Value,0,-9823396,10419672,596276
481,2021-09-30,169,Value,0,-9823396,10419672,596276
481,2021-12-31,169,Value,0,-9823396,10419672,596276
493,2020-03-31,313907,Value,0,-9750000,4446000,-5304000
493,2020-06-30,313907,Value,0,-9750000,4446000,-5304000
493,2020-09-30,313907,Value,0,-9750000,4446000,-5304000
493,2020-12-31,313907,Value,0,-9750000,4446000,-5304000
493,2021-03-31,313907,Value,0,-9750000,4446000,-5304000
493,2021-06-30,313907,Value,0,-9750000,4446000,-5304000
493,2021-09-30,313907,Value,0,-9750000,4446000,-5304000
493,2021-12-31,313907,Value,0,-9750000,4446000,-5304000
497,2020-03-31,174,Value,0,-10478078,17653181,7175103
497,2020-06-30,174,Value,0,-10478078,17653181,7175103
497,2020-09-30,174,Value,0,-10478078,17653181,7175103
497,2020-12-31,174,Value,0,-10478078,17653181,7175103
497,2021-03-31,174,Value,0,-10478078,17653181,7175103
497,2021-06-30,174,Value,0,-10478078,17653181,7175103
497,2021-09-30,174,Value,0,-10478078,17653181,7175103
497,2021-12-31,174,Value,0,-10478078,17653181,7175103
498,2020-03-31,174,Value,0,-9070521,14616267,5545746
498,2020-06-30,174,Value,0,-9070521,14616267,5545746
498,2020-09-30,174,Value,0,-9070521,14616267,5545746
498,2020-12-31,174,Value,0,-9070521,14616267,5545746
498,2021-03-31,174,Value,0,-9070521,14616267,5545746
498,2021-06-30,174,Value,0,-9070521,14616267,5545746
498,2021-09-30,174,Value,0,-9070521,14616267,5545746
498,2021-12-31,174,Value,0,-9070521,14616267,5545746
499,2020-03-31,174,Value,58290,-11530173,23906793,12376620
499,2020-06-30,174,Value,58290,-11530173,23906793,12376620
499,2020-09-30,174,Value,58290,-11530173,23906793,12376620
499,2020-12-31,174,Value,63260,-11530173,23906793,12376620
499,2021-03-31,174,Value,63260,-11530173,23906793,12376620
499,2021-06-30,174,Value,63260,-11530173,23906793,12376620
500,2020-03-31,9036,Value,0,-8097913,18258985,10161072
500,2020-06-30,9036,Value,0,-8097913,18258985,10161072
500,2020-09-30,9036,Value,0,-8097913,18258985,10161072
500,2020-12-31,9036,Value,0,-8097913,18258985,10161072
500,2021-03-31,9036,Value,0,-8097913,18258985,10161072
500,2021-06-30,9036,Value,0,-8097913,18258985,10161072
500,2021-09-30,9036,Value,0,-8097913,18258985,10161072
500,2021-12-31,9036,Value,0,-8097913,18258985,10161072
505,2020-03-31,178,Value,0,-9398001,11300155,1902154
505,2020-06-30,178,Value,0,-9398001,11300155,1902154
505,2020-09-30,178,Value,0,-9398001,11300155,1902154
505,2020-12-31,178,Value,0,-9398001,11300155,1902154
505,2021-03-31,178,Value,0,-9398001,11300155,1902154
505,2021-06-30,178,Value,0,-9398001,11300155,1902154
505,2021-09-30,178,Value,0,-9398001,11300155,1902154
505,2021-12-31,178,Value,0,-9398001,11300155,1902154
506,2020-03-31,178,Value,5000,-8145595,12426802,4281207
506,2020-06-30,178,Value,4950,-8145595,12426802,4281207
506,2020-09-30,178,Value,4910,-8145595,12426802,4281207
506,2020-12-31,178,Value,4910,-8145595,12426802,4281207
506,2021-03-31,178,Value,4820,-8145595,12426802,4281207
506,2021-06-30,178,Value,4700,-8145595,12426802,4281207
506,2021-09-30,178,Value,4660,-8145595,12426802,4281207
506,2021-12-31,178,Value,0,-8145595,12426802,4281207
508,2020-03-31,180,Value,0,-10000000,27961908,17961908
508,2020-06-30,180,Value,0,-10000000,27961908,17961908
508,2020-09-30,180,Value,0,-10000000,27961908,17961908
508,2020-12-31,180,Value,0,-10000000,27961908,17961908
508,2021-03-31,180,Value,0,-10000000,27961908,17961908
508,2021-06-30,180,Value,0,-10000000,27961908,17961908
508,2021-09-30,180,Value,0,-10000000,27961908,17961908
508,2021-12-31,180,Value,0,-10000000,27961908,17961908
509,2020-03-31,180,Value,0,-10000002,2400000,-7600002
509,2020-06-30,180,Value,0,-10000002,2400000,-7600002
509,2020-09-30,180,Value,0,-10000002,2400000,-7600002
509,2020-12-31,180,Value,0,-10000002,2400000,-7600002
509,2021-03-31,180,Value,0,-10000002,2400000,-7600002
509,2021-06-30,180,Value,0,-10000002,2400000,-7600002
509,2021-09-30,180,Value,0,-10000002,2400000,-7600002
509,2021-12-31,180,Value,0,-10000002,2400000,-7600002
512,2021-12-31,182,Value,0,-9999999,34944182,24944183
513,2020-03-31,182,Value,0,-9681000,14137164,4456164
513,2020-06-30,182,Value,0,-9681000,14137164,4456164
513,2020-09-30,182,Value,0,-9681000,14137164,4456164
513,2020-12-31,182,Value,0,-9681000,14137164,4456164
513,2021-03-31,182,Value,0,-9681000,14137164,4456164
513,2021-06-30,182,Value,0,-9681000,14137164,4456164
513,2021-09-30,182,Value,0,-9681000,14137164,4456164
513,2021-12-31,182,Value,0,-9681000,14137164,4456164
514,2020-03-31,182,Value,0,-10080639,15758839,5678200
514,2020-06-30,182,Value,0,-10080639,15758839,5678200
514,2020-09-30,182,Value,0,-10080639,15758839,5678200
514,2020-12-31,182,Value,0,-10080639,15758839,5678200
514,2021-12-31,182,Value,0,-10080639,15758839,5678200
520,2021-12-31,184,Value,0,-9207008,13604413,4397405
521,2021-12-31,184,Value,0,-10086630,14445815,4359185
522,2021-12-31,184,Value,0,-8920587,12055095,3134508
525,2020-03-31,187,Value,0,-9999999,7900002,-2099997
525,2020-06-30,187,Value,0,-9999999,7900002,-2099997
525,2020-09-30,187,Value,0,-9999999,7900002,-2099997
525,2020-12-31,187,Value,0,-9999999,7900002,-2099997
525,2021-03-31,187,Value,0,-9999999,7900002,-2099997
525,2021-06-30,187,Value,0,-9999999,7900002,-2099997
525,2021-09-30,187,Value,0,-9999999,7900002,-2099997
525,2021-12-31,187,Value,0,-9999999,7900002,-2099997
526,2020-06-30,187,Value,0,-11266427,13273875,2007448
526,2021-06-30,187,Value,0,-11266427,13273875,2007448
526,2021-12-31,187,Value,0,-11266427,13273875,2007448
546,2021-12-31,198,Value,0,-10000000,14533333,4533333
549,2020-03-31,199,Value,0,-10000000,9424998,-575002
549,2020-06-30,199,Value,0,-10000000,9424998,-575002
549,2020-09-30,199,Value,0,-10000000,9424998,-575002
549,2020-12-31,199,Value,0,-10000000,9424998,-575002
549,2021-03-31,199,Value,0,-10000000,9424998,-575002
549,2021-06-30,199,Value,0,-10000000,9424998,-575002
549,2021-09-30,199,Value,0,-10000000,9424998,-575002
549,2021-12-31,199,Value,0,-10000000,9424998,-575002
550,2020-03-31,199,Value,0,-10000000,6235001,-3764999
550,2020-06-30,199,Value,0,-10000000,6235001,-3764999
550,2020-09-30,199,Value,0,-10000000,6235001,-3764999
550,2020-12-31,199,Value,0,-10000000,6235001,-3764999
550,2021-03-31,199,Value,0,-10000000,6235001,-3764999
550,2021-06-30,199,Value,0,-10000000,6235001,-3764999
550,2021-09-30,199,Value,0,-10000000,6235001,-3764999
550,2021-12-31,199,Value,0,-10000000,6235001,-3764999
552,2020-03-31,200,Value,0,-10000000,16086000,6086000
552,2020-06-30,200,Value,0,-10000000,16086000,6086000
552,2020-09-30,200,Value,0,-10000000,16086000,6086000
552,2020-12-31,200,Value,0,-10000000,16086000,6086000
552,2021-03-31,200,Value,0,-10000000,16086000,6086000
552,2021-06-30,200,Value,0,-10000000,16086000,6086000
552,2021-09-30,200,Value,0,-10000000,16086000,6086000
552,2021-12-31,200,Value,0,-10000000,16086000,6086000
555,2020-03-31,202,Value,0,-9390001,8141131,-1248870
555,2020-06-30,202,Value,0,-9390001,8141131,-1248870
555,2020-09-30,202,Value,0,-9390001,8141131,-1248870
555,2020-12-31,202,Value,0,-9390001,8141131,-1248870
555,2021-03-31,202,Value,0,-9390001,8141131,-1248870
555,2021-06-30,202,Value,0,-9390001,8141131,-1248870
555,2021-09-30,202,Value,0,-9390001,8141131,-1248870
555,2021-12-31,202,Value,0,-9390001,8141131,-1248870
556,2020-03-31,202,Value,0,-10978456,22990363,12011907
556,2020-06-30,202,Value,0,-10978456,22990363,12011907
556,2020-09-30,202,Value,0,-10978456,22990363,12011907
556,2020-12-31,202,Value,0,-10978456,22990363,12011907
556,2021-03-31,202,Value,0,-10978456,22990363,12011907
556,2021-06-30,202,Value,0,-10978456,22990363,12011907
556,2021-09-30,202,Value,0,-10978456,22990363,12011907
556,2021-12-31,202,Value,0,-10978456,22990363,12011907
558,2020-03-31,211,Value,0,-9996123,2869720,-7126403
558,2020-09-30,211,Value,0,-9996123,2869720,-7126403
558,2021-12-31,211,Value,0,-9996123,2869720,-7126403
559,2021-12-31,206,Value,0,-10001262,13561618,3560356
560,2020-03-31,206,Value,0,-10002000,4673935,-5328065
560,2020-06-30,206,Value,0,-10002000,4673935,-5328065
560,2020-09-30,206,Value,0,-10002000,4673935,-5328065
560,2020-12-31,206,Value,0,-10002000,4673935,-5328065
560,2021-03-31,206,Value,0,-10002000,4673935,-5328065
560,2021-06-30,206,Value,0,-10002000,4673935,-5328065
560,2021-09-30,206,Value,0,-10002000,4673935,-5328065
560,2021-12-31,206,Value,0,-10002000,4673935,-5328065
561,2020-03-31,206,Value,0,-10001414,4528275,-5473139
561,2020-06-30,206,Value,0,-10001414,4528275,-5473139
561,2020-09-30,206,Value,0,-10001414,4528275,-5473139
561,2020-12-31,206,Value,0,-10001414,4528275,-5473139
561,2021-03-31,206,Value,0,-10001414,4528275,-5473139
561,2021-06-30,206,Value,0,-10001414,4528275,-5473139
561,2021-09-30,206,Value,0,-10001414,4528275,-5473139
561,2021-12-31,206,Value,0,-10001414,4528275,-5473139
568,2021-12-31,209,Value,0,-10000001,10129924,129923
569,2020-03-31,23182,Value,0,-9999999,23710001,13710002
569,2020-06-30,23182,Value,0,-9999999,23710001,13710002
569,2020-09-30,23182,Value,0,-9999999,23710001,13710002
569,2020-12-31,23182,Value,0,-9999999,23710001,13710002
569,2021-03-31,23182,Value,0,-9999999,23710001,13710002
569,2021-06-30,23182,Value,0,-9999999,23710001,13710002
569,2021-09-30,23182,Value,0,-9999999,23710001,13710002
569,2021-12-31,23182,Value,0,-9999999,23710001,13710002
578,2020-03-31,18619,Value,0,-8619044,16253630,7634586
578,2020-06-30,18619,Value,0,-8619044,16253630,7634586
578,2020-09-30,18619,Value,0,-8619044,16253630,7634586
578,2020-12-31,18619,Value,0,-8619044,16253630,7634586
578,2021-03-31,18619,Value,0,-8619044,16253630,7634586
578,2021-06-30,18619,Value,0,-8619044,16253630,7634586
578,2021-09-30,18619,Value,0,-8619044,16253630,7634586
578,2021-12-31,18619,Value,0,-8619044,16253630,7634586
583,2021-12-31,212,Value,0,-9687205,24309668,14622463
584,2020-03-31,212,Value,0,-9993834,23949066,13955232
584,2020-06-30,212,Value,0,-9993834,23949066,13955232
584,2020-09-30,212,Value,0,-9993834,23949066,13955232
584,2020-12-31,212,Value,0,-9993834,23949066,13955232
584,2021-03-31,212,Value,0,-9993834,23949066,13955232
584,2021-06-30,212,Value,0,-9993834,23949066,13955232
584,2021-09-30,212,Value,0,-9993834,23949066,13955232
584,2021-12-31,212,Value,0,-9993834,23949066,13955232
585,2020-06-30,212,Value,563260,-9851361,27746855,17895494
585,2020-12-31,212,Value,641590,-9851361,27746855,17895494
585,2021-06-30,212,Value,666750,-9851361,27746855,17895494
590,2020-03-31,215,Value,0,-10412735,12650140,2237405
590,2020-06-30,215,Value,0,-10412735,12650140,2237405
590,2020-09-30,215,Value,0,-10412735,12650140,2237405
590,2020-12-31,215,Value,0,-10412735,12650140,2237405
590,2021-03-31,215,Value,0,-10412735,12650140,2237405
590,2021-06-30,215,Value,0,-10412735,12650140,2237405
590,2021-09-30,215,Value,0,-10412735,12650140,2237405
590,2021-12-31,215,Value,0,-10412735,12650140,2237405
591,2020-03-31,215,Value,4830,-10938426,10162433,-775993
591,2020-06-30,215,Value,4660,-10938426,10162433,-775993
591,2020-09-30,215,Value,4660,-10938426,10162433,-775993
591,2020-12-31,215,Value,4470,-10938426,10162433,-775993
591,2021-03-31,215,Value,4470,-10938426,10162433,-775993
591,2021-06-30,215,Value,4270,-10938426,10162433,-775993
600,2021-12-31,221,Value,0,-9999997,1963007,-8036990
601,2020-03-31,221,Value,0,-10000001,12246667,2246666
601,2020-06-30,221,Value,0,-10000001,12246667,2246666
601,2020-09-30,221,Value,0,-10000001,12246667,2246666
601,2020-12-31,221,Value,0,-10000001,12246667,2246666
601,2021-03-31,221,Value,0,-10000001,12246667,2246666
601,2021-06-30,221,Value,0,-10000001,12246667,2246666
601,2021-09-30,221,Value,0,-10000001,12246667,2246666
601,2021-12-31,221,Value,0,-10000001,12246667,2246666
618,2020-03-31,25497,Value,0,-11418210,14661687,3243477
618,2020-06-30,25497,Value,0,-11418210,14661687,3243477
618,2020-09-30,25497,Value,0,-11418210,14661687,3243477
618,2020-12-31,25497,Value,0,-11418210,14661687,3243477
618,2021-03-31,25497,Value,0,-11418210,14661687,3243477
618,2021-06-30,25497,Value,0,-11418210,14661687,3243477
618,2021-09-30,25497,Value,0,-11418210,14661687,3243477
618,2021-12-31,25497,Value,0,-11418210,14661687,3243477
619,2020-03-31,25497,Value,0,-10628999,26694733,16065734
619,2020-06-30,25497,Value,0,-10628999,26694733,16065734
619,2020-09-30,25497,Value,0,-10628999,26694733,16065734
619,2020-12-31,25497,Value,0,-10628999,26694733,16065734
619,2021-03-31,25497,Value,0,-10628999,26694733,16065734
619,2021-06-30,25497,Value,0,-10628999,26694733,16065734
619,2021-09-30,25497,Value,0,-10628999,26694733,16065734
619,2021-12-31,25497,Value,0,-10628999,26694733,16065734
623,2020-03-31,18619,Value,0,-9536576,17376849,7840273
623,2020-06-30,18619,Value,0,-9536576,17376849,7840273
623,2020-09-30,18619,Value,0,-9536576,17376849,7840273
623,2020-12-31,18619,Value,0,-9536576,17376849,7840273
623,2021-03-31,18619,Value,0,-9536576,17376849,7840273
623,2021-06-30,18619,Value,0,-9536576,17376849,7840273
623,2021-09-30,18619,Value,0,-9536576,17376849,7840273
623,2021-12-31,18619,Value,0,-9536576,17376849,7840273
629,2020-03-31,232,Value,0,-9711162,6671352,-3039810
629,2020-06-30,232,Value,0,-9711162,6671352,-3039810
629,2020-09-30,232,Value,0,-9711162,6671352,-3039810
629,2020-12-31,232,Value,0,-9711162,6671352,-3039810
629,2021-03-31,232,Value,0,-9711162,6671352,-3039810
629,2021-06-30,232,Value,0,-9711162,6671352,-3039810
629,2021-09-30,232,Value,0,-9711162,6671352,-3039810
629,2021-12-31,232,Value,0,-9711162,6671352,-3039810
632,2020-03-31,233,Value,0,-9860001,23131559,13271558
632,2020-06-30,233,Value,0,-9860001,23131559,13271558
632,2020-09-30,233,Value,0,-9860001,23131559,13271558
632,2020-12-31,233,Value,0,-9860001,23131559,13271558
632,2021-03-31,233,Value,0,-9860001,23131559,13271558
632,2021-06-30,233,Value,0,-9860001,23131559,13271558
632,2021-09-30,233,Value,0,-9860001,23131559,13271558
632,2021-12-31,233,Value,0,-9860001,23131559,13271558
633,2020-02-29,233,Value,0,-10624425,20458270,9833845
633,2020-05-31,233,Value,0,-10624425,20458270,9833845
633,2020-08-31,233,Value,0,-10624425,20458270,9833845
633,2020-11-30,233,Value,0,-10624425,20458270,9833845
633,2021-02-28,233,Value,0,-10624425,20458270,9833845
633,2021-05-31,233,Value,0,-10624425,20458270,9833845
633,2021-08-31,233,Value,0,-10624425,20458270,9833845
633,2021-10-16,233,Capital Call,0,-10624425,20458270,9833845
633,2021-10-16,233,Distribution,0,-10624425,20458270,9833845
633,2021-12-31,233,Value,0,-10624425,20458270,9833845
634,2020-01-15,233,Capital Call,0,-10660083,15985098,5325015
634,2020-01-15,233,Distribution,0,-10660083,15985098,5325015
634,2020-02-29,233,Value,69970,-10660083,15985098,5325015
634,2020-04-15,233,Capital Call,0,-10660083,15985098,5325015
634,2020-04-15,233,Distribution,0,-10660083,15985098,5325015
634,2020-05-31,233,Value,70790,-10660083,15985098,5325015
634,2020-08-31,233,Value,76060,-10660083,15985098,5325015
634,2020-11-30,233,Value,76070,-10660083,15985098,5325015
634,2021-02-28,233,Value,71890,-10660083,15985098,5325015
634,2021-05-31,233,Value,72410,-10660083,15985098,5325015
634,2021-08-31,233,Value,69170,-10660083,15985098,5325015
634,2021-10-16,233,Capital Call,0,-10660083,15985098,5325015
634,2021-10-16,233,Distribution,0,-10660083,15985098,5325015
634,2021-12-31,233,Value,0,-10660083,15985098,5325015
639,2020-03-31,236,Value,0,-10000000,7200001,-2799999
639,2020-06-30,236,Value,0,-10000000,7200001,-2799999
639,2020-09-30,236,Value,0,-10000000,7200001,-2799999
639,2020-12-31,236,Value,0,-10000000,7200001,-2799999
639,2021-03-31,236,Value,0,-10000000,7200001,-2799999
639,2021-06-30,236,Value,0,-10000000,7200001,-2799999
639,2021-09-30,236,Value,0,-10000000,7200001,-2799999
639,2021-12-31,236,Value,0,-10000000,7200001,-2799999
650,2020-03-31,244,Value,0,-10200000,9485999,-714001
650,2020-06-30,244,Value,0,-10200000,9485999,-714001
650,2020-09-30,244,Value,0,-10200000,9485999,-714001
650,2020-12-31,244,Value,0,-10200000,9485999,-714001
650,2021-03-31,244,Value,0,-10200000,9485999,-714001
650,2021-06-30,244,Value,0,-10200000,9485999,-714001
650,2021-09-30,244,Value,0,-10200000,9485999,-714001
650,2021-12-31,244,Value,0,-10200000,9485999,-714001
654,2020-03-31,161149,Value,0,-10000000,5930537,-4069463
654,2020-06-30,161149,Value,0,-10000000,5930537,-4069463
654,2020-09-30,161149,Value,0,-10000000,5930537,-4069463
654,2020-12-31,161149,Value,0,-10000000,5930537,-4069463
654,2021-03-31,161149,Value,0,-10000000,5930537,-4069463
654,2021-06-30,161149,Value,0,-10000000,5930537,-4069463
654,2021-09-30,161149,Value,0,-10000000,5930537,-4069463
654,2021-12-31,161149,Value,0,-10000000,5930537,-4069463
657,2020-03-31,249,Value,0,-10000000,52918000,42918000
657,2020-06-30,249,Value,0,-10000000,52918000,42918000
657,2020-09-30,249,Value,0,-10000000,52918000,42918000
657,2020-12-31,249,Value,0,-10000000,52918000,42918000
657,2021-03-31,249,Value,0,-10000000,52918000,42918000
657,2021-06-30,249,Value,0,-10000000,52918000,42918000
657,2021-09-30,249,Value,0,-10000000,52918000,42918000
657,2021-12-31,249,Value,0,-10000000,52918000,42918000
658,2020-03-31,249,Value,0,-10000000,13995656,3995656
658,2020-06-30,249,Value,0,-10000000,13995656,3995656
658,2020-09-30,249,Value,0,-10000000,13995656,3995656
658,2020-12-31,249,Value,0,-10000000,13995656,3995656
658,2021-03-31,249,Value,0,-10000000,13995656,3995656
658,2021-06-30,249,Value,0,-10000000,13995656,3995656
658,2021-09-30,249,Value,0,-10000000,13995656,3995656
658,2021-12-31,249,Value,0,-10000000,13995656,3995656
659,2020-03-31,249,Value,0,-10000000,5710071,-4289929
659,2020-06-30,249,Value,0,-10000000,5710071,-4289929
659,2020-09-30,249,Value,0,-10000000,5710071,-4289929
659,2020-12-31,249,Value,0,-10000000,5710071,-4289929
659,2021-03-31,249,Value,0,-10000000,5710071,-4289929
659,2021-06-30,249,Value,0,-10000000,5710071,-4289929
659,2021-09-30,249,Value,0,-10000000,5710071,-4289929
659,2021-12-31,249,Value,0,-10000000,5710071,-4289929
660,2020-03-31,249,Value,0,-8480000,7362103,-1117897
660,2020-12-31,249,Value,0,-8480000,7362103,-1117897
660,2021-03-31,249,Value,0,-8480000,7362103,-1117897
660,2021-12-31,249,Value,0,-8480000,7362103,-1117897
677,2020-03-31,261,Value,0,-10000000,74198000,64198000
677,2020-06-30,261,Value,0,-10000000,74198000,64198000
677,2020-09-30,261,Value,0,-10000000,74198000,64198000
677,2020-12-31,261,Value,0,-10000000,74198000,64198000
677,2021-03-31,261,Value,0,-10000000,74198000,64198000
677,2021-06-30,261,Value,0,-10000000,74198000,64198000
677,2021-09-30,261,Value,0,-10000000,74198000,64198000
677,2021-12-31,261,Value,0,-10000000,74198000,64198000
680,2020-03-31,261,Value,0,-10000000,732840,-9267160
680,2020-06-30,261,Value,0,-10000000,732840,-9267160
680,2020-09-30,261,Value,0,-10000000,732840,-9267160
680,2020-12-31,261,Value,0,-10000000,732840,-9267160
680,2021-03-31,261,Value,0,-10000000,732840,-9267160
680,2021-06-30,261,Value,0,-10000000,732840,-9267160
680,2021-09-30,261,Value,0,-10000000,732840,-9267160
680,2021-12-31,261,Value,0,-10000000,732840,-9267160
693,2020-03-31,268,Value,0,-10000001,16081986,6081985
693,2020-06-30,268,Value,0,-10000001,16081986,6081985
693,2020-09-30,268,Value,0,-10000001,16081986,6081985
693,2020-12-31,268,Value,0,-10000001,16081986,6081985
693,2021-03-31,268,Value,0,-10000001,16081986,6081985
693,2021-06-30,268,Value,0,-10000001,16081986,6081985
693,2021-09-30,268,Value,0,-10000001,16081986,6081985
693,2021-12-31,268,Value,0,-10000001,16081986,6081985
694,2020-02-15,268,Distribution,-1,-10000000,12960051,2960051
694,2020-03-31,268,Value,1720350,-10000000,12960051,2960051
694,2020-06-30,268,Value,1734970,-10000000,12960051,2960051
694,2020-09-30,268,Value,1642560,-10000000,12960051,2960051
694,2020-11-15,268,Distribution,1,-10000000,12960052,2960052
694,2020-12-31,268,Value,1642560,-10000000,12960052,2960052
695,2020-03-31,268,Value,1090530,-10200000,10791086,591086
695,2020-06-30,268,Value,1218760,-10200000,10791086,591086
695,2020-09-30,268,Value,1222520,-10200000,10791086,591086
695,2020-12-31,268,Value,1222520,-10200000,10791086,591086
695,2021-03-31,268,Value,1262710,-10200000,10791086,591086
695,2021-06-30,268,Value,1302190,-10200000,10791086,591086
696,2021-12-31,270,Value,0,-10573815,17631560,7057745
697,2021-12-31,270,Value,0,-11090752,16582338,5491586
717,2020-03-31,274,Value,0,-11215000,13550937,2335937
717,2020-06-30,274,Value,0,-11215000,13550937,2335937
717,2020-09-30,274,Value,0,-11215000,13550937,2335937
717,2020-12-31,274,Value,0,-11215000,13550937,2335937
717,2021-03-31,274,Value,0,-11215000,13550937,2335937
717,2021-06-30,274,Value,0,-11215000,13550937,2335937
717,2021-09-30,274,Value,0,-11215000,13550937,2335937
717,2021-12-31,274,Value,0,-11215000,13550937,2335937
718,2020-03-31,274,Value,0,-9452801,14137848,4685047
718,2020-06-30,274,Value,0,-9452801,14137848,4685047
718,2020-09-30,274,Value,0,-9452801,14137848,4685047
718,2020-12-31,274,Value,0,-9452801,14137848,4685047
718,2021-03-31,274,Value,0,-9452801,14137848,4685047
718,2021-06-30,274,Value,0,-9452801,14137848,4685047
718,2021-09-30,274,Value,0,-9452801,14137848,4685047
718,2021-12-31,274,Value,0,-9452801,14137848,4685047
721,2020-03-31,275,Value,0,-10044143,6882863,-3161280
721,2020-06-30,275,Value,0,-10044143,6882863,-3161280
721,2020-09-30,275,Value,0,-10044143,6882863,-3161280
721,2020-12-31,275,Value,0,-10044143,6882863,-3161280
721,2021-03-31,275,Value,0,-10044143,6882863,-3161280
721,2021-06-30,275,Value,0,-10044143,6882863,-3161280
721,2021-09-30,275,Value,0,-10044143,6882863,-3161280
721,2021-12-31,275,Value,0,-10044143,6882863,-3161280
726,2020-03-31,49,Value,0,-10000000,22177000,12177000
726,2020-06-30,49,Value,0,-10000000,22177000,12177000
726,2020-09-30,49,Value,0,-10000000,22177000,12177000
726,2020-12-31,49,Value,0,-10000000,22177000,12177000
726,2021-03-31,49,Value,0,-10000000,22177000,12177000
726,2021-06-30,49,Value,0,-10000000,22177000,12177000
726,2021-09-30,49,Value,0,-10000000,22177000,12177000
726,2021-12-31,49,Value,0,-10000000,22177000,12177000
729,2021-12-31,49,Value,0,-9676781,18080246,8403465
735,2020-03-31,280,Value,0,-9879013,4050395,-5828618
735,2020-06-30,280,Value,0,-9879013,4050395,-5828618
735,2020-09-30,280,Value,0,-9879013,4050395,-5828618
735,2020-12-31,280,Value,0,-9879013,4050395,-5828618
735,2021-03-31,280,Value,0,-9879013,4050395,-5828618
735,2021-06-30,280,Value,0,-9879013,4050395,-5828618
735,2021-09-30,280,Value,0,-9879013,4050395,-5828618
735,2021-12-31,280,Value,0,-9879013,4050395,-5828618
736,2020-03-31,280,Value,0,-9918807,7637481,-2281326
736,2020-06-30,280,Value,0,-9918807,7637481,-2281326
736,2020-09-30,280,Value,0,-9918807,7637481,-2281326
736,2020-12-31,280,Value,0,-9918807,7637481,-2281326
736,2021-03-31,280,Value,0,-9918807,7637481,-2281326
736,2021-06-30,280,Value,0,-9918807,7637481,-2281326
736,2021-09-30,280,Value,0,-9918807,7637481,-2281326
736,2021-12-31,280,Value,0,-9918807,7637481,-2281326
738,2020-06-30,280,Value,0,-10000001,13413189,3413188
738,2020-09-30,280,Value,0,-10000001,13413189,3413188
738,2020-12-31,280,Value,0,-10000001,13413189,3413188
738,2021-03-31,280,Value,0,-10000001,13413189,3413188
738,2021-12-31,280,Value,0,-10000001,13413189,3413188
745,2020-03-31,283,Value,0,-9867214,10001624,134410
745,2020-06-30,283,Value,0,-9867214,10001624,134410
745,2020-09-30,283,Value,0,-9867214,10001624,134410
745,2020-12-31,283,Value,0,-9867214,10001624,134410
745,2021-03-31,283,Value,0,-9867214,10001624,134410
745,2021-06-30,283,Value,0,-9867214,10001624,134410
745,2021-09-30,283,Value,0,-9867214,10001624,134410
745,2021-12-31,283,Value,0,-9867214,10001624,134410
746,2021-12-31,283,Value,0,-9391206,10272795,881589
748,2020-03-31,284,Value,0,-11185106,18668545,7483439
748,2020-06-30,284,Value,0,-11185106,18668545,7483439
748,2020-09-30,284,Value,0,-11185106,18668545,7483439
748,2020-12-31,284,Value,0,-11185106,18668545,7483439
748,2021-03-31,284,Value,0,-11185106,18668545,7483439
748,2021-06-30,284,Value,0,-11185106,18668545,7483439
748,2021-09-30,284,Value,0,-11185106,18668545,7483439
748,2021-12-31,284,Value,0,-11185106,18668545,7483439
755,2020-03-31,289,Value,0,-10820088,30801025,19980937
755,2020-06-30,289,Value,0,-10820088,30801025,19980937
755,2020-09-30,289,Value,0,-10820088,30801025,19980937
755,2020-12-31,289,Value,0,-10820088,30801025,19980937
755,2021-03-31,289,Value,0,-10820088,30801025,19980937
755,2021-06-30,289,Value,0,-10820088,30801025,19980937
755,2021-09-30,289,Value,0,-10820088,30801025,19980937
755,2021-12-31,289,Value,0,-10820088,30801025,19980937
756,2020-03-31,289,Value,0,-10000000,28200001,18200001
756,2020-06-30,289,Value,0,-10000000,28200001,18200001
756,2020-09-30,289,Value,0,-10000000,28200001,18200001
756,2020-12-31,289,Value,0,-10000000,28200001,18200001
756,2021-03-31,289,Value,0,-10000000,28200001,18200001
756,2021-06-30,289,Value,0,-10000000,28200001,18200001
756,2021-09-30,289,Value,0,-10000000,28200001,18200001
756,2021-12-31,289,Value,0,-10000000,28200001,18200001
758,2020-03-31,289,Value,0,-10779513,20740247,9960734
758,2020-06-30,289,Value,0,-10779513,20740247,9960734
758,2020-09-30,289,Value,0,-10779513,20740247,9960734
758,2020-12-31,289,Value,0,-10779513,20740247,9960734
758,2021-03-31,289,Value,0,-10779513,20740247,9960734
758,2021-06-30,289,Value,0,-10779513,20740247,9960734
758,2021-09-30,289,Value,0,-10779513,20740247,9960734
758,2021-12-31,289,Value,0,-10779513,20740247,9960734
772,2020-03-31,293,Value,0,-9550000,10779468,1229468
772,2020-06-30,293,Value,0,-9550000,10779468,1229468
772,2020-09-30,293,Value,0,-9550000,10779468,1229468
772,2020-12-31,293,Value,0,-9550000,10779468,1229468
772,2021-03-31,293,Value,0,-9550000,10779468,1229468
772,2021-06-30,293,Value,0,-9550000,10779468,1229468
772,2021-09-30,293,Value,0,-9550000,10779468,1229468
772,2021-12-31,293,Value,0,-9550000,10779468,1229468
780,2020-03-31,295,Value,0,-9336900,23017500,13680600
780,2020-06-30,295,Value,0,-9336900,23017500,13680600
780,2020-09-30,295,Value,0,-9336900,23017500,13680600
780,2020-12-31,295,Value,0,-9336900,23017500,13680600
780,2021-03-31,295,Value,0,-9336900,23017500,13680600
780,2021-06-30,295,Value,0,-9336900,23017500,13680600
780,2021-09-30,295,Value,0,-9336900,23017500,13680600
780,2021-12-31,295,Value,0,-9336900,23017500,13680600
785,2020-03-31,295,Value,0,-10861278,48722115,37860837
785,2020-06-30,295,Value,0,-10861278,48722115,37860837
785,2020-09-30,295,Value,0,-10861278,48722115,37860837
785,2020-12-31,295,Value,0,-10861278,48722115,37860837
785,2021-03-31,295,Value,0,-10861278,48722115,37860837
785,2021-06-30,295,Value,0,-10861278,48722115,37860837
785,2021-09-30,295,Value,0,-10861278,48722115,37860837
785,2021-12-31,295,Value,0,-10861278,48722115,37860837
790,2020-03-31,12961,Value,0,-12582237,29392738,16810501
790,2020-06-30,12961,Value,0,-12582237,29392738,16810501
790,2020-09-30,12961,Value,0,-12582237,29392738,16810501
790,2020-12-31,12961,Value,0,-12582237,29392738,16810501
790,2021-03-31,12961,Value,0,-12582237,29392738,16810501
790,2021-06-30,12961,Value,0,-12582237,29392738,16810501
790,2021-09-30,12961,Value,0,-12582237,29392738,16810501
790,2021-12-31,12961,Value,0,-12582237,29392738,16810501
793,2020-03-31,299,Value,0,-10100000,6399999,-3700001
793,2020-06-30,299,Value,0,-10100000,6399999,-3700001
793,2020-09-30,299,Value,0,-10100000,6399999,-3700001
793,2020-12-31,299,Value,0,-10100000,6399999,-3700001
793,2021-03-31,299,Value,0,-10100000,6399999,-3700001
793,2021-06-30,299,Value,0,-10100000,6399999,-3700001
793,2021-09-30,299,Value,0,-10100000,6399999,-3700001
793,2021-12-31,299,Value,0,-10100000,6399999,-3700001
795,2020-03-31,16819,Value,0,-10000000,14453334,4453334
795,2020-06-30,16819,Value,0,-10000000,14453334,4453334
795,2020-09-30,16819,Value,0,-10000000,14453334,4453334
795,2020-12-31,16819,Value,0,-10000000,14453334,4453334
795,2021-03-31,16819,Value,0,-10000000,14453334,4453334
795,2021-06-30,16819,Value,0,-10000000,14453334,4453334
795,2021-09-30,16819,Value,0,-10000000,14453334,4453334
795,2021-12-31,16819,Value,0,-10000000,14453334,4453334
796,2020-03-31,301,Value,0,-9859999,18760000,8900001
796,2020-06-30,301,Value,0,-9859999,18760000,8900001
796,2020-09-30,301,Value,0,-9859999,18760000,8900001
796,2020-12-31,301,Value,0,-9859999,18760000,8900001
796,2021-03-31,301,Value,0,-9859999,18760000,8900001
796,2021-06-30,301,Value,0,-9859999,18760000,8900001
796,2021-09-30,301,Value,0,-9859999,18760000,8900001
796,2021-12-31,301,Value,0,-9859999,18760000,8900001
798,2020-03-31,913,Value,98610,-10002175,16855150,6852975
798,2020-06-30,913,Value,99680,-10002175,16855150,6852975
798,2020-09-30,913,Value,103910,-10002175,16855150,6852975
799,2020-03-31,302,Value,0,-10576234,13418003,2841769
799,2020-09-30,302,Value,0,-10576234,13418003,2841769
799,2020-12-31,302,Value,0,-10576234,13418003,2841769
799,2021-12-31,302,Value,0,-10576234,13418003,2841769
802,2020-03-31,303,Value,0,-10114091,14786379,4672288
802,2020-06-30,303,Value,0,-10114091,14786379,4672288
802,2020-09-30,303,Value,0,-10114091,14786379,4672288
802,2020-12-31,303,Value,0,-10114091,14786379,4672288
802,2021-03-31,303,Value,0,-10114091,14786379,4672288
802,2021-06-30,303,Value,0,-10114091,14786379,4672288
802,2021-12-31,303,Value,0,-10114091,14786379,4672288
803,2020-03-31,303,Value,0,-10660873,5011473,-5649400
803,2020-06-30,303,Value,0,-10660873,5011473,-5649400
803,2020-09-30,303,Value,0,-10660873,5011473,-5649400
803,2020-12-31,303,Value,0,-10660873,5011473,-5649400
803,2021-03-31,303,Value,0,-10660873,5011473,-5649400
803,2021-06-30,303,Value,0,-10660873,5011473,-5649400
803,2021-09-30,303,Value,0,-10660873,5011473,-5649400
803,2021-12-31,303,Value,0,-10660873,5011473,-5649400
804,2020-02-15,303,Distribution,6932,-9940000,10216248,276248
804,2020-03-31,303,Value,369770,-9940000,10216248,276248
804,2020-09-30,303,Value,0,-9940000,10216248,276248
804,2020-12-31,303,Value,0,-9940000,10216248,276248
804,2021-03-31,303,Value,0,-9940000,10216248,276248
804,2021-06-30,303,Value,0,-9940000,10216248,276248
804,2021-09-30,303,Value,0,-9940000,10216248,276248
804,2021-12-31,303,Value,0,-9940000,10216248,276248
807,2021-12-31,305,Value,0,-10998419,10298920,-699499
810,2020-03-31,307,Value,0,-10000000,12529999,2529999
810,2020-06-30,307,Value,0,-10000000,12529999,2529999
810,2020-09-30,307,Value,0,-10000000,12529999,2529999
810,2020-12-31,307,Value,0,-10000000,12529999,2529999
810,2021-03-31,307,Value,0,-10000000,12529999,2529999
810,2021-06-30,307,Value,0,-10000000,12529999,2529999
810,2021-09-30,307,Value,0,-10000000,12529999,2529999
810,2021-12-31,307,Value,0,-10000000,12529999,2529999
811,2020-03-31,307,Value,0,-10000000,13990002,3990002
811,2020-06-30,307,Value,0,-10000000,13990002,3990002
811,2020-09-30,307,Value,0,-10000000,13990002,3990002
811,2020-12-31,307,Value,0,-10000000,13990002,3990002
811,2021-03-31,307,Value,0,-10000000,13990002,3990002
811,2021-06-30,307,Value,0,-10000000,13990002,3990002
811,2021-09-30,307,Value,0,-10000000,13990002,3990002
811,2021-12-31,307,Value,0,-10000000,13990002,3990002
812,2020-03-31,307,Value,0,-9550000,12858120,3308120
812,2020-06-30,307,Value,0,-9550000,12858120,3308120
812,2020-09-30,307,Value,0,-9550000,12858120,3308120
812,2020-12-31,307,Value,0,-9550000,12858120,3308120
812,2021-03-31,307,Value,0,-9550000,12858120,3308120
812,2021-06-30,307,Value,0,-9550000,12858120,3308120
812,2021-09-30,307,Value,0,-9550000,12858120,3308120
812,2021-12-31,307,Value,0,-9550000,12858120,3308120
813,2020-03-31,304,Value,0,-11482500,17264500,5782000
813,2020-06-30,304,Value,0,-11482500,17264500,5782000
813,2020-09-30,304,Value,0,-11482500,17264500,5782000
813,2020-12-31,304,Value,0,-11482500,17264500,5782000
813,2021-03-31,304,Value,0,-11482500,17264500,5782000
813,2021-06-30,304,Value,0,-11482500,17264500,5782000
813,2021-09-30,304,Value,0,-11482500,17264500,5782000
813,2021-12-31,304,Value,0,-11482500,17264500,5782000
814,2020-03-31,304,Value,0,-10000000,21972566,11972566
814,2020-06-30,304,Value,0,-10000000,21972566,11972566
814,2020-09-30,304,Value,0,-10000000,21972566,11972566
814,2020-12-31,304,Value,0,-10000000,21972566,11972566
814,2021-03-31,304,Value,0,-10000000,21972566,11972566
814,2021-06-30,304,Value,0,-10000000,21972566,11972566
814,2021-09-30,304,Value,0,-10000000,21972566,11972566
814,2021-12-31,304,Value,0,-10000000,21972566,11972566
816,2020-06-30,304,Value,579590,-8715203,16891578,8176375
816,2020-09-30,304,Value,858070,-8715203,16891578,8176375
816,2020-12-31,304,Value,920740,-8715203,16891578,8176375
816,2021-03-31,304,Value,994170,-8715203,16891578,8176375
816,2021-05-16,304,Capital Call,82297,-8632906,16891578,8258672
816,2021-06-30,304,Value,906420,-8632906,16891578,8258672
843,2020-06-30,318,Value,1671320,-10000000,16167885,6167885
843,2020-09-30,318,Value,1668730,-10000000,16167885,6167885
843,2020-12-31,318,Value,1668730,-10000000,16167885,6167885
843,2021-03-31,318,Value,1674180,-10000000,16167885,6167885
847,2020-03-31,333,Value,0,-10660608,14600770,3940162
847,2020-06-30,333,Value,0,-10660608,14600770,3940162
847,2020-09-30,333,Value,0,-10660608,14600770,3940162
847,2020-12-31,333,Value,0,-10660608,14600770,3940162
847,2021-03-31,333,Value,0,-10660608,14600770,3940162
847,2021-06-30,333,Value,0,-10660608,14600770,3940162
847,2021-09-30,333,Value,0,-10660608,14600770,3940162
847,2021-12-31,333,Value,0,-10660608,14600770,3940162
848,2020-03-31,321,Value,123660,-11404023,15348840,3944817
848,2020-05-16,321,Distribution,48298,-11404023,15397138,3993115
848,2020-06-30,321,Value,18730,-11404023,15397138,3993115
848,2020-09-30,321,Value,21780,-11404023,15397138,3993115
848,2020-11-15,321,Distribution,14211,-11404023,15411349,4007326
848,2020-12-31,321,Value,0,-11404023,15411349,4007326
848,2021-03-31,321,Value,0,-11404023,15411349,4007326
848,2021-06-30,321,Value,0,-11404023,15411349,4007326
848,2021-09-30,321,Value,0,-11404023,15411349,4007326
848,2021-12-31,321,Value,0,-11404023,15411349,4007326
849,2020-03-31,322,Value,0,-11105887,23363565,12257678
849,2020-06-30,322,Value,0,-11105887,23363565,12257678
849,2020-09-30,322,Value,0,-11105887,23363565,12257678
849,2020-12-31,322,Value,0,-11105887,23363565,12257678
849,2021-03-31,322,Value,0,-11105887,23363565,12257678
849,2021-06-30,322,Value,0,-11105887,23363565,12257678
849,2021-09-30,322,Value,0,-11105887,23363565,12257678
849,2021-12-31,322,Value,0,-11105887,23363565,12257678
862,2020-03-31,23,Value,0,-9600000,31189394,21589394
862,2020-06-30,23,Value,0,-9600000,31189394,21589394
862,2020-09-30,23,Value,0,-9600000,31189394,21589394
862,2020-12-31,23,Value,0,-9600000,31189394,21589394
862,2021-03-31,23,Value,0,-9600000,31189394,21589394
862,2021-06-30,23,Value,0,-9600000,31189394,21589394
862,2021-09-30,23,Value,0,-9600000,31189394,21589394
862,2021-12-31,23,Value,0,-9600000,31189394,21589394
867,2020-03-31,412,Value,2017500,-10383278,12934414,2551136
867,2020-06-30,412,Value,3471160,-10383278,12934414,2551136
867,2020-08-15,412,Distribution,2951132,-10383278,15885546,5502268
867,2020-09-30,412,Value,312360,-10383278,15885546,5502268
867,2020-12-31,412,Value,104700,-10383278,15885546,5502268
867,2021-03-31,412,Value,104700,-10383278,15885546,5502268
867,2021-06-30,412,Value,104700,-10383278,15885546,5502268
868,2021-12-31,7976,Value,0,-12170003,20490000,8319997
871,2021-12-31,346,Value,0,-10000000,118698000,108698000
873,2020-03-31,346,Value,0,-10000000,55930000,45930000
873,2020-06-30,346,Value,0,-10000000,55930000,45930000
873,2020-09-30,346,Value,0,-10000000,55930000,45930000
873,2020-12-31,346,Value,0,-10000000,55930000,45930000
873,2021-03-31,346,Value,0,-10000000,55930000,45930000
873,2021-06-30,346,Value,0,-10000000,55930000,45930000
873,2021-09-30,346,Value,0,-10000000,55930000,45930000
873,2021-12-31,346,Value,0,-10000000,55930000,45930000
874,2020-03-31,346,Value,0,-10000000,21232291,11232291
874,2020-06-30,346,Value,0,-10000000,21232291,11232291
874,2020-09-30,346,Value,0,-10000000,21232291,11232291
874,2020-12-31,346,Value,0,-10000000,21232291,11232291
874,2021-03-31,346,Value,0,-10000000,21232291,11232291
874,2021-06-30,346,Value,0,-10000000,21232291,11232291
874,2021-09-30,346,Value,0,-10000000,21232291,11232291
874,2021-12-31,346,Value,0,-10000000,21232291,11232291
875,2020-03-31,346,Value,0,-10000000,18226081,8226081
875,2020-06-30,346,Value,0,-10000000,18226081,8226081
875,2020-09-30,346,Value,0,-10000000,18226081,8226081
875,2020-12-31,346,Value,0,-10000000,18226081,8226081
875,2021-03-31,346,Value,0,-10000000,18226081,8226081
875,2021-06-30,346,Value,0,-10000000,18226081,8226081
875,2021-09-30,346,Value,0,-10000000,18226081,8226081
875,2021-12-31,346,Value,0,-10000000,18226081,8226081
885,2021-12-31,454,Value,0,-9834823,20439513,10604690
886,2020-03-31,454,Value,0,-9116001,21608566,12492565
886,2020-06-30,454,Value,0,-9116001,21608566,12492565
886,2020-09-30,454,Value,0,-9116001,21608566,12492565
886,2020-12-31,454,Value,0,-9116001,21608566,12492565
886,2021-03-31,454,Value,0,-9116001,21608566,12492565
886,2021-06-30,454,Value,0,-9116001,21608566,12492565
886,2021-09-30,454,Value,0,-9116001,21608566,12492565
886,2021-12-31,454,Value,0,-9116001,21608566,12492565
896,2020-03-31,341,Value,0,-9999999,9835295,-164704
896,2020-06-30,341,Value,0,-9999999,9835295,-164704
896,2020-09-30,341,Value,0,-9999999,9835295,-164704
896,2020-12-31,341,Value,0,-9999999,9835295,-164704
896,2021-03-31,341,Value,0,-9999999,9835295,-164704
896,2021-06-30,341,Value,0,-9999999,9835295,-164704
896,2021-09-30,341,Value,0,-9999999,9835295,-164704
896,2021-12-31,341,Value,0,-9999999,9835295,-164704
902,2020-03-31,344,Value,15120,-12122858,14194908,2072050
902,2020-06-30,344,Value,13790,-12122858,14194908,2072050
902,2020-09-30,344,Value,13660,-12122858,14194908,2072050
902,2020-12-31,344,Value,12100,-12122858,14194908,2072050
902,2021-03-31,344,Value,12100,-12122858,14194908,2072050
902,2021-06-30,344,Value,12090,-12122858,14194908,2072050
902,2021-12-31,344,Value,0,-12122858,14194908,2072050
903,2021-12-31,50947,Value,0,-10475483,23061787,12586304
904,2020-03-31,50947,Value,0,-9858121,12128383,2270262
904,2020-06-30,50947,Value,0,-9858121,12128383,2270262
904,2020-09-30,50947,Value,0,-9858121,12128383,2270262
904,2020-12-31,50947,Value,0,-9858121,12128383,2270262
904,2021-03-31,50947,Value,0,-9858121,12128383,2270262
904,2021-06-30,50947,Value,0,-9858121,12128383,2270262
904,2021-09-30,50947,Value,0,-9858121,12128383,2270262
904,2021-12-31,50947,Value,0,-9858121,12128383,2270262
911,2020-03-31,346,Value,0,-9925006,23377927,13452921
911,2020-06-30,346,Value,0,-9925006,23377927,13452921
911,2020-09-30,346,Value,0,-9925006,23377927,13452921
911,2020-12-31,346,Value,0,-9925006,23377927,13452921
911,2021-03-31,346,Value,0,-9925006,23377927,13452921
911,2021-06-30,346,Value,0,-9925006,23377927,13452921
911,2021-09-30,346,Value,0,-9925006,23377927,13452921
911,2021-12-31,346,Value,0,-9925006,23377927,13452921
912,2020-03-31,346,Value,0,-10170000,9060000,-1110000
912,2020-06-30,346,Value,0,-10170000,9060000,-1110000
912,2020-09-30,346,Value,0,-10170000,9060000,-1110000
912,2020-12-31,346,Value,0,-10170000,9060000,-1110000
912,2021-03-31,346,Value,0,-10170000,9060000,-1110000
912,2021-06-30,346,Value,0,-10170000,9060000,-1110000
912,2021-09-30,346,Value,0,-10170000,9060000,-1110000
912,2021-12-31,346,Value,0,-10170000,9060000,-1110000
916,2020-03-31,348,Value,0,-7993497,12794578,4801081
916,2020-06-30,348,Value,0,-7993497,12794578,4801081
916,2020-09-30,348,Value,0,-7993497,12794578,4801081
916,2020-12-31,348,Value,0,-7993497,12794578,4801081
916,2021-03-31,348,Value,0,-7993497,12794578,4801081
916,2021-06-30,348,Value,0,-7993497,12794578,4801081
916,2021-09-30,348,Value,0,-7993497,12794578,4801081
916,2021-12-31,348,Value,0,-7993497,12794578,4801081
917,2020-03-31,349,Value,0,-10199998,2334836,-7865162
917,2020-06-30,349,Value,0,-10199998,2334836,-7865162
917,2020-09-30,349,Value,0,-10199998,2334836,-7865162
917,2020-12-31,349,Value,0,-10199998,2334836,-7865162
917,2021-03-31,349,Value,0,-10199998,2334836,-7865162
917,2021-06-30,349,Value,0,-10199998,2334836,-7865162
917,2021-09-30,349,Value,0,-10199998,2334836,-7865162
917,2021-12-31,349,Value,0,-10199998,2334836,-7865162
918,2020-09-30,349,Value,0,-10265449,11713341,1447892
918,2020-12-31,349,Value,0,-10265449,11713341,1447892
918,2021-03-31,349,Value,0,-10265449,11713341,1447892
918,2021-06-30,349,Value,0,-10265449,11713341,1447892
918,2021-09-30,349,Value,0,-10265449,11713341,1447892
918,2021-12-31,349,Value,0,-10265449,11713341,1447892
923,2020-03-31,737,Value,0,-9341999,13885948,4543949
923,2020-06-30,737,Value,0,-9341999,13885948,4543949
923,2020-09-30,737,Value,0,-9341999,13885948,4543949
923,2020-12-31,737,Value,0,-9341999,13885948,4543949
923,2021-03-31,737,Value,0,-9341999,13885948,4543949
923,2021-06-30,737,Value,0,-9341999,13885948,4543949
923,2021-09-30,737,Value,0,-9341999,13885948,4543949
923,2021-12-31,737,Value,0,-9341999,13885948,4543949
927,2020-03-31,355,Value,0,-9757635,8145225,-1612410
927,2020-06-30,355,Value,0,-9757635,8145225,-1612410
927,2020-09-30,355,Value,0,-9757635,8145225,-1612410
927,2020-12-31,355,Value,0,-9757635,8145225,-1612410
927,2021-03-31,355,Value,0,-9757635,8145225,-1612410
927,2021-06-30,355,Value,0,-9757635,8145225,-1612410
927,2021-09-30,355,Value,0,-9757635,8145225,-1612410
927,2021-12-31,355,Value,0,-9757635,8145225,-1612410
929,2020-03-31,355,Value,0,-10004825,17202567,7197742
929,2020-06-30,355,Value,0,-10004825,17202567,7197742
929,2020-09-30,355,Value,0,-10004825,17202567,7197742
929,2020-12-31,355,Value,0,-10004825,17202567,7197742
929,2021-03-31,355,Value,0,-10004825,17202567,7197742
929,2021-06-30,355,Value,0,-10004825,17202567,7197742
929,2021-09-30,355,Value,0,-10004825,17202567,7197742
929,2021-12-31,355,Value,0,-10004825,17202567,7197742
932,2021-12-31,355,Value,0,-10000000,19369421,9369421
940,2020-03-31,355,Value,21270,-9904255,12127660,2223405
940,2020-06-30,355,Value,21270,-9904255,12127660,2223405
940,2020-09-30,355,Value,21270,-9904255,12127660,2223405
940,2020-12-31,355,Value,10630,-9904255,12127660,2223405
940,2021-02-14,355,Distribution,10638,-9904255,12138298,2234043
940,2021-03-31,355,Value,0,-9904255,12138298,2234043
940,2021-06-30,355,Value,0,-9904255,12138298,2234043
941,2020-02-15,355,Distribution,138600,-9825000,14396084,4571084
941,2020-03-31,355,Value,1554900,-9825000,14396084,4571084
941,2020-05-16,355,Distribution,97020,-9825000,14493104,4668104
941,2020-06-30,355,Value,1384920,-9825000,14493104,4668104
941,2020-08-15,355,Distribution,78210,-9825000,14571314,4746314
941,2020-09-30,355,Value,1516700,-9825000,14571314,4746314
941,2020-11-15,355,Distribution,148500,-9825000,14719814,4894814
941,2020-12-31,355,Value,1368200,-9825000,14719814,4894814
941,2021-02-14,355,Distribution,156700,-9825000,14876514,5051514
941,2021-03-31,355,Value,1023510,-9825000,14876514,5051514
941,2021-06-30,355,Value,1029900,-9825000,14876514,5051514
941,2021-08-15,355,Distribution,489223,-9825000,15365737,5540737
941,2021-09-30,355,Value,546800,-9825000,15365737,5540737
944,2021-12-31,355,Value,0,-9800000,16730725,6930725
945,2020-03-31,355,Value,2439230,-9600000,13432858,3832858
945,2020-06-30,355,Value,2124870,-9600000,13432858,3832858
945,2020-09-30,355,Value,2131950,-9600000,13432858,3832858
945,2020-11-15,355,Distribution,178326,-9600000,13611184,4011184
945,2020-12-31,355,Value,1953630,-9600000,13611184,4011184
945,2021-03-31,355,Value,2431990,-9600000,13611184,4011184
945,2021-05-16,355,Distribution,777180,-9600000,14388364,4788364
945,2021-06-30,355,Value,2094870,-9600000,14388364,4788364
945,2021-09-30,355,Value,2232160,-9600000,14388364,4788364
948,2021-12-31,356,Value,0,-9761811,5386626,-4375185
949,2020-03-31,356,Value,81590,-9714000,21738960,12024960
949,2020-05-16,356,Capital Call,-286000,-10000000,21738960,11738960
949,2020-05-16,356,Distribution,722039,-10000000,22460999,12460999
949,2020-06-30,356,Value,0,-10000000,22460999,12460999
949,2020-09-30,356,Value,0,-10000000,22460999,12460999
949,2020-12-31,356,Value,0,-10000000,22460999,12460999
949,2021-12-31,356,Value,0,-10000000,22460999,12460999
958,2020-02-29,361,Value,0,-10006908,30364966,20358058
958,2020-05-31,361,Value,0,-10006908,30364966,20358058
958,2020-07-16,361,Distribution,-3,-10006908,30364963,20358055
958,2020-08-31,361,Value,0,-10006908,30364963,20358055
958,2020-11-30,361,Value,0,-10006908,30364963,20358055
958,2021-02-28,361,Value,0,-10006908,30364963,20358055
958,2021-05-31,361,Value,0,-10006908,30364963,20358055
958,2021-08-31,361,Value,0,-10006908,30364963,20358055
958,2021-10-16,361,Capital Call,0,-10006908,30364963,20358055
958,2021-10-16,361,Distribution,0,-10006908,30364963,20358055
958,2021-12-31,361,Value,0,-10006908,30364963,20358055
959,2020-03-31,361,Value,0,-9995851,22863070,12867219
959,2020-06-30,361,Value,0,-9995851,22863070,12867219
959,2020-09-30,361,Value,0,-9995851,22863070,12867219
959,2020-12-31,361,Value,0,-9995851,22863070,12867219
959,2021-03-31,361,Value,0,-9995851,22863070,12867219
959,2021-06-30,361,Value,0,-9995851,22863070,12867219
959,2021-09-30,361,Value,0,-9995851,22863070,12867219
959,2021-12-31,361,Value,0,-9995851,22863070,12867219
960,2020-03-31,361,Value,0,-8952000,25087083,16135083
960,2020-06-30,361,Value,0,-8952000,25087083,16135083
960,2020-09-30,361,Value,0,-8952000,25087083,16135083
960,2020-12-31,361,Value,0,-8952000,25087083,16135083
960,2021-03-31,361,Value,0,-8952000,25087083,16135083
960,2021-06-30,361,Value,0,-8952000,25087083,16135083
960,2021-09-30,361,Value,0,-8952000,25087083,16135083
960,2021-12-31,361,Value,0,-8952000,25087083,16135083
968,2020-03-31,363,Value,0,-9999999,9902194,-97805
968,2020-06-30,363,Value,0,-9999999,9902194,-97805
968,2020-09-30,363,Value,0,-9999999,9902194,-97805
968,2020-12-31,363,Value,0,-9999999,9902194,-97805
968,2021-03-31,363,Value,0,-9999999,9902194,-97805
968,2021-06-30,363,Value,0,-9999999,9902194,-97805
968,2021-09-30,363,Value,0,-9999999,9902194,-97805
968,2021-12-31,363,Value,0,-9999999,9902194,-97805
969,2020-03-31,363,Value,0,-9965160,9076430,-888730
969,2020-06-30,363,Value,0,-9965160,9076430,-888730
969,2020-09-30,363,Value,0,-9965160,9076430,-888730
969,2020-12-31,363,Value,0,-9965160,9076430,-888730
969,2021-03-31,363,Value,0,-9965160,9076430,-888730
969,2021-06-30,363,Value,0,-9965160,9076430,-888730
969,2021-09-30,363,Value,0,-9965160,9076430,-888730
969,2021-12-31,363,Value,0,-9965160,9076430,-888730
970,2020-03-31,363,Value,0,-9382858,4488380,-4894478
970,2020-06-30,363,Value,0,-9382858,4488380,-4894478
970,2020-09-30,363,Value,0,-9382858,4488380,-4894478
970,2020-12-31,363,Value,0,-9382858,4488380,-4894478
970,2021-03-31,363,Value,0,-9382858,4488380,-4894478
970,2021-06-30,363,Value,0,-9382858,4488380,-4894478
970,2021-09-30,363,Value,0,-9382858,4488380,-4894478
970,2021-12-31,363,Value,0,-9382858,4488380,-4894478
977,2020-03-31,366,Value,0,-12459999,23540001,11080002
977,2020-06-30,366,Value,0,-12459999,23540001,11080002
977,2020-09-30,366,Value,0,-12459999,23540001,11080002
977,2020-12-31,366,Value,0,-12459999,23540001,11080002
977,2021-03-31,366,Value,0,-12459999,23540001,11080002
977,2021-06-30,366,Value,0,-12459999,23540001,11080002
977,2021-09-30,366,Value,0,-12459999,23540001,11080002
977,2021-12-31,366,Value,0,-12459999,23540001,11080002
979,2020-03-31,366,Value,0,-10585873,6656884,-3928989
979,2020-06-30,366,Value,0,-10585873,6656884,-3928989
979,2020-09-30,366,Value,0,-10585873,6656884,-3928989
979,2020-12-31,366,Value,0,-10585873,6656884,-3928989
979,2021-03-31,366,Value,0,-10585873,6656884,-3928989
979,2021-06-30,366,Value,0,-10585873,6656884,-3928989
979,2021-09-30,366,Value,0,-10585873,6656884,-3928989
979,2021-12-31,366,Value,0,-10585873,6656884,-3928989
981,2020-03-31,366,Value,0,-10807478,18848205,8040727
981,2020-06-30,366,Value,0,-10807478,18848205,8040727
981,2020-09-30,366,Value,0,-10807478,18848205,8040727
981,2020-12-31,366,Value,0,-10807478,18848205,8040727
981,2021-03-31,366,Value,0,-10807478,18848205,8040727
981,2021-06-30,366,Value,0,-10807478,18848205,8040727
981,2021-09-30,366,Value,0,-10807478,18848205,8040727
981,2021-12-31,366,Value,0,-10807478,18848205,8040727
990,2020-06-30,368,Value,0,-10000000,10263134,263134
990,2020-09-30,368,Value,0,-10000000,10263134,263134
990,2020-12-31,368,Value,0,-10000000,10263134,263134
990,2021-03-31,368,Value,0,-10000000,10263134,263134
990,2021-06-30,368,Value,0,-10000000,10263134,263134
990,2021-09-30,368,Value,0,-10000000,10263134,263134
990,2021-12-31,368,Value,0,-10000000,10263134,263134
991,2020-03-31,368,Value,142910,-10000000,15858942,5858942
991,2020-06-30,368,Value,142350,-10000000,15858942,5858942
991,2020-09-30,368,Value,141740,-10000000,15858942,5858942
991,2020-12-31,368,Value,350830,-10000000,15858942,5858942
991,2021-03-31,368,Value,350310,-10000000,15858942,5858942
991,2021-09-30,368,Value,349650,-10000000,15858942,5858942
992,2021-12-31,369,Value,0,-9958267,4492715,-5465552
997,2021-12-31,373,Value,0,-12552397,22550492,9998095
998,2021-12-31,373,Value,0,-11229652,20707173,9477521
1000,2020-02-15,375,Distribution,89127,-9747358,11035785,1288427
1000,2020-03-31,375,Value,755470,-9747358,11035785,1288427
1000,2020-05-16,375,Distribution,163389,-9747358,11199174,1451816
1000,2020-06-30,375,Value,571430,-9747358,11199174,1451816
1000,2020-08-15,375,Capital Call,-88000,-9835358,11199174,1363816
1000,2020-08-15,375,Distribution,292990,-9835358,11492164,1656806
1000,2020-09-30,375,Value,728290,-9835358,11492164,1656806
1000,2020-11-15,375,Capital Call,88000,-9747358,11492164,1744806
1000,2020-11-15,375,Distribution,95454,-9747358,11587618,1840260
1000,2020-12-31,375,Value,632840,-9747358,11587618,1840260
1000,2021-02-14,375,Distribution,105087,-9747358,11692705,1945347
1000,2021-03-31,375,Value,699460,-9747358,11692705,1945347
1000,2021-05-16,375,Distribution,167138,-9747358,11859843,2112485
1000,2021-06-30,375,Value,581620,-9747358,11859843,2112485
1000,2021-08-15,375,Distribution,87012,-9747358,11946855,2199497
1000,2021-09-30,375,Value,519680,-9747358,11946855,2199497
1010,2020-03-31,377,Value,0,-10000000,10344000,344000
1010,2020-06-30,377,Value,0,-10000000,10344000,344000
1010,2020-09-30,377,Value,0,-10000000,10344000,344000
1010,2020-12-31,377,Value,0,-10000000,10344000,344000
1010,2021-03-31,377,Value,0,-10000000,10344000,344000
1010,2021-06-30,377,Value,0,-10000000,10344000,344000
1010,2021-09-30,377,Value,0,-10000000,10344000,344000
1010,2021-12-31,377,Value,0,-10000000,10344000,344000
1015,2020-03-31,380,Value,0,-7412599,12510985,5098386
1015,2020-06-30,380,Value,0,-7412599,12510985,5098386
1015,2020-09-30,380,Value,0,-7412599,12510985,5098386
1015,2020-12-31,380,Value,0,-7412599,12510985,5098386
1015,2021-03-31,380,Value,0,-7412599,12510985,5098386
1015,2021-06-30,380,Value,0,-7412599,12510985,5098386
1015,2021-09-30,380,Value,0,-7412599,12510985,5098386
1015,2021-12-31,380,Value,0,-7412599,12510985,5098386
1019,2020-03-31,406,Value,0,-10000001,7540000,-2460001
1019,2020-06-30,406,Value,0,-10000001,7540000,-2460001
1019,2020-09-30,406,Value,0,-10000001,7540000,-2460001
1019,2020-12-31,406,Value,0,-10000001,7540000,-2460001
1019,2021-03-31,406,Value,0,-10000001,7540000,-2460001
1019,2021-06-30,406,Value,0,-10000001,7540000,-2460001
1019,2021-09-30,406,Value,0,-10000001,7540000,-2460001
1019,2021-12-31,406,Value,0,-10000001,7540000,-2460001
1021,2020-03-31,381,Value,0,-9979210,18733236,8754026
1021,2020-06-30,381,Value,0,-9979210,18733236,8754026
1021,2020-09-30,381,Value,0,-9979210,18733236,8754026
1021,2020-12-31,381,Value,0,-9979210,18733236,8754026
1021,2021-03-31,381,Value,0,-9979210,18733236,8754026
1021,2021-06-30,381,Value,0,-9979210,18733236,8754026
1021,2021-09-30,381,Value,0,-9979210,18733236,8754026
1021,2021-12-31,381,Value,0,-9979210,18733236,8754026
1028,2020-03-31,386,Value,0,-9306479,14514284,5207805
1028,2020-06-30,386,Value,0,-9306479,14514284,5207805
1028,2020-09-30,386,Value,0,-9306479,14514284,5207805
1028,2020-12-31,386,Value,0,-9306479,14514284,5207805
1028,2021-03-31,386,Value,0,-9306479,14514284,5207805
1028,2021-06-30,386,Value,0,-9306479,14514284,5207805
1028,2021-09-30,386,Value,0,-9306479,14514284,5207805
1028,2021-12-31,386,Value,0,-9306479,14514284,5207805
1029,2020-03-31,387,Value,0,-10000000,1066667,-8933333
1029,2020-06-30,387,Value,0,-10000000,1066667,-8933333
1029,2020-09-30,387,Value,0,-10000000,1066667,-8933333
1029,2020-12-31,387,Value,0,-10000000,1066667,-8933333
1029,2021-03-31,387,Value,0,-10000000,1066667,-8933333
1029,2021-06-30,387,Value,0,-10000000,1066667,-8933333
1029,2021-09-30,387,Value,0,-10000000,1066667,-8933333
1029,2021-12-31,387,Value,0,-10000000,1066667,-8933333
1030,2020-03-31,387,Value,0,-10000000,55529999,45529999
1030,2020-06-30,387,Value,0,-10000000,55529999,45529999
1030,2020-09-30,387,Value,0,-10000000,55529999,45529999
1030,2020-12-31,387,Value,0,-10000000,55529999,45529999
1030,2021-03-31,387,Value,0,-10000000,55529999,45529999
1030,2021-06-30,387,Value,0,-10000000,55529999,45529999
1030,2021-09-30,387,Value,0,-10000000,55529999,45529999
1030,2021-12-31,387,Value,0,-10000000,55529999,45529999
1031,2020-03-31,387,Value,0,-10000000,7730000,-2270000
1031,2020-06-30,387,Value,0,-10000000,7730000,-2270000
1031,2020-09-30,387,Value,0,-10000000,7730000,-2270000
1031,2020-12-31,387,Value,0,-10000000,7730000,-2270000
1031,2021-03-31,387,Value,0,-10000000,7730000,-2270000
1031,2021-06-30,387,Value,0,-10000000,7730000,-2270000
1031,2021-09-30,387,Value,0,-10000000,7730000,-2270000
1031,2021-12-31,387,Value,0,-10000000,7730000,-2270000
1036,2020-03-31,390,Value,0,-10000000,2904000,-7096000
1036,2020-06-30,390,Value,0,-10000000,2904000,-7096000
1036,2020-09-30,390,Value,0,-10000000,2904000,-7096000
1036,2020-12-31,390,Value,0,-10000000,2904000,-7096000
1036,2021-03-31,390,Value,0,-10000000,2904000,-7096000
1036,2021-06-30,390,Value,0,-10000000,2904000,-7096000
1036,2021-09-30,390,Value,0,-10000000,2904000,-7096000
1036,2021-12-31,390,Value,0,-10000000,2904000,-7096000
1039,2021-06-30,394,Value,0,-10000000,2000001,-7999999
1039,2021-09-30,394,Value,0,-10000000,2000001,-7999999
1039,2021-12-31,394,Value,0,-10000000,2000001,-7999999
1043,2020-03-31,395,Value,0,-10000000,58160001,48160001
1043,2020-06-30,395,Value,0,-10000000,58160001,48160001
1043,2020-09-30,395,Value,0,-10000000,58160001,48160001
1043,2020-12-31,395,Value,0,-10000000,58160001,48160001
1043,2021-03-31,395,Value,0,-10000000,58160001,48160001
1043,2021-06-30,395,Value,0,-10000000,58160001,48160001
1043,2021-09-30,395,Value,0,-10000000,58160001,48160001
1043,2021-12-31,395,Value,0,-10000000,58160001,48160001
1044,2020-03-31,395,Value,0,-10000000,67196931,57196931
1044,2020-06-30,395,Value,0,-10000000,67196931,57196931
1044,2020-09-30,395,Value,0,-10000000,67196931,57196931
1044,2020-12-31,395,Value,0,-10000000,67196931,57196931
1044,2021-03-31,395,Value,0,-10000000,67196931,57196931
1044,2021-06-30,395,Value,0,-10000000,67196931,57196931
1044,2021-09-30,395,Value,0,-10000000,67196931,57196931
1044,2021-12-31,395,Value,0,-10000000,67196931,57196931
1045,2020-03-31,395,Value,0,-10000000,10655838,655838
1045,2020-06-30,395,Value,0,-10000000,10655838,655838
1045,2020-09-30,395,Value,0,-10000000,10655838,655838
1045,2020-12-31,395,Value,0,-10000000,10655838,655838
1045,2021-03-31,395,Value,0,-10000000,10655838,655838
1045,2021-06-30,395,Value,0,-10000000,10655838,655838
1045,2021-09-30,395,Value,0,-10000000,10655838,655838
1045,2021-12-31,395,Value,0,-10000000,10655838,655838
1051,2020-03-31,398,Value,0,-10000110,6669995,-3330115
1051,2020-06-30,398,Value,0,-10000110,6669995,-3330115
1051,2020-09-30,398,Value,0,-10000110,6669995,-3330115
1051,2020-12-31,398,Value,0,-10000110,6669995,-3330115
1051,2021-03-31,398,Value,0,-10000110,6669995,-3330115
1051,2021-06-30,398,Value,0,-10000110,6669995,-3330115
1051,2021-09-30,398,Value,0,-10000110,6669995,-3330115
1051,2021-12-31,398,Value,0,-10000110,6669995,-3330115
1053,2021-12-31,400,Value,0,-10002000,16495000,6493000
1054,2021-12-31,400,Value,0,-10000000,44113304,34113304
1055,2020-03-31,400,Value,0,-10000000,29717541,19717541
1055,2020-06-30,400,Value,0,-10000000,29717541,19717541
1055,2020-09-30,400,Value,0,-10000000,29717541,19717541
1055,2021-12-31,400,Value,0,-10000000,29717541,19717541
1056,2021-12-31,400,Value,0,-10000000,7388890,-2611110
1057,2020-03-31,400,Value,1430000,-10000000,5179999,-4820001
1057,2020-06-30,400,Value,1302500,-10000000,5179999,-4820001
1057,2020-08-15,400,Distribution,355000,-10000000,5534999,-4465001
1057,2020-09-30,400,Value,1045000,-10000000,5534999,-4465001
1057,2020-12-31,400,Value,1045000,-10000000,5534999,-4465001
1068,2020-03-31,78,Value,0,-10000000,9039998,-960002
1068,2020-06-30,78,Value,0,-10000000,9039998,-960002
1068,2020-09-30,78,Value,0,-10000000,9039998,-960002
1068,2020-12-31,78,Value,0,-10000000,9039998,-960002
1068,2021-03-31,78,Value,0,-10000000,9039998,-960002
1068,2021-06-30,78,Value,0,-10000000,9039998,-960002
1068,2021-09-30,78,Value,0,-10000000,9039998,-960002
1068,2021-12-31,78,Value,0,-10000000,9039998,-960002
1071,2020-03-31,412,Value,0,-9918000,5988488,-3929512
1071,2020-06-30,412,Value,0,-9918000,5988488,-3929512
1071,2020-09-30,412,Value,0,-9918000,5988488,-3929512
1071,2020-12-31,412,Value,0,-9918000,5988488,-3929512
1071,2021-03-31,412,Value,0,-9918000,5988488,-3929512
1071,2021-06-30,412,Value,0,-9918000,5988488,-3929512
1071,2021-09-30,412,Value,0,-9918000,5988488,-3929512
1071,2021-12-31,412,Value,0,-9918000,5988488,-3929512
1075,2020-06-30,413,Value,0,-9999999,17943998,7943999
1075,2020-09-30,413,Value,0,-9999999,17943998,7943999
1075,2020-12-31,413,Value,0,-9999999,17943998,7943999
1075,2021-03-31,413,Value,0,-9999999,17943998,7943999
1075,2021-06-30,413,Value,0,-9999999,17943998,7943999
1075,2021-09-30,413,Value,0,-9999999,17943998,7943999
1075,2021-12-31,413,Value,0,-9999999,17943998,7943999
1077,2020-03-31,414,Distribution,100000,-9400000,17400000,8000000
1077,2020-09-30,414,Value,0,-9400000,17400000,8000000
1077,2021-03-31,414,Value,0,-9400000,17400000,8000000
1077,2021-06-30,414,Value,0,-9400000,17400000,8000000
1077,2021-09-30,414,Value,0,-9400000,17400000,8000000
1077,2021-12-31,414,Value,0,-9400000,17400000,8000000
1081,2021-12-31,417,Value,0,-10919000,28657000,17738000
1082,2020-03-31,417,Value,0,-11109003,16594625,5485622
1082,2020-06-30,417,Value,0,-11109003,16594625,5485622
1082,2020-09-30,417,Value,0,-11109003,16594625,5485622
1082,2020-12-31,417,Value,0,-11109003,16594625,5485622
1082,2021-03-31,417,Value,0,-11109003,16594625,5485622
1082,2021-06-30,417,Value,0,-11109003,16594625,5485622
1082,2021-09-30,417,Value,0,-11109003,16594625,5485622
1082,2021-12-31,417,Value,0,-11109003,16594625,5485622
1087,2021-12-31,418,Value,0,-9255644,7384156,-1871488
1102,2021-12-31,424,Value,0,-10662498,35046573,24384075
1103,2021-12-31,424,Value,0,-10744999,35159997,24414998
1104,2020-03-31,424,Value,0,-8495621,11842250,3346629
1104,2020-06-30,424,Value,0,-8495621,11842250,3346629
1104,2020-09-30,424,Value,0,-8495621,11842250,3346629
1104,2020-12-31,424,Value,0,-8495621,11842250,3346629
1104,2021-03-31,424,Value,0,-8495621,11842250,3346629
1104,2021-06-30,424,Value,0,-8495621,11842250,3346629
1104,2021-09-30,424,Value,0,-8495621,11842250,3346629
1104,2021-12-31,424,Value,0,-8495621,11842250,3346629
1107,2020-03-31,427,Value,0,-9999999,700000,-9299999
1107,2020-06-30,427,Value,0,-9999999,700000,-9299999
1107,2020-09-30,427,Value,0,-9999999,700000,-9299999
1107,2020-12-31,427,Value,0,-9999999,700000,-9299999
1107,2021-03-31,427,Value,0,-9999999,700000,-9299999
1107,2021-06-30,427,Value,0,-9999999,700000,-9299999
1107,2021-09-30,427,Value,0,-9999999,700000,-9299999
1107,2021-12-31,427,Value,0,-9999999,700000,-9299999
1110,2021-12-31,428,Value,0,-9261302,382983,-8878319
1113,2020-03-31,429,Value,0,-9292980,14343625,5050645
1113,2020-06-30,429,Value,0,-9292980,14343625,5050645
1113,2020-09-30,429,Value,0,-9292980,14343625,5050645
1113,2020-12-31,429,Value,0,-9292980,14343625,5050645
1113,2021-03-31,429,Value,0,-9292980,14343625,5050645
1113,2021-06-30,429,Value,0,-9292980,14343625,5050645
1113,2021-09-30,429,Value,0,-9292980,14343625,5050645
1113,2021-12-31,429,Value,0,-9292980,14343625,5050645
1116,2020-03-31,436,Value,0,-13321783,27374457,14052674
1116,2020-06-30,436,Value,0,-13321783,27374457,14052674
1116,2020-09-30,436,Value,0,-13321783,27374457,14052674
1116,2020-12-31,436,Value,0,-13321783,27374457,14052674
1116,2021-12-31,436,Value,0,-13321783,27374457,14052674
1124,2020-03-31,436,Value,8100,-13876560,24864669,10988109
1124,2020-06-30,436,Value,8100,-13876560,24864669,10988109
1124,2020-09-30,436,Value,8100,-13876560,24864669,10988109
1124,2020-12-31,436,Value,8100,-13876560,24864669,10988109
1124,2021-03-31,436,Value,8100,-13876560,24864669,10988109
1124,2021-06-30,436,Value,8100,-13876560,24864669,10988109
1130,2020-03-31,430,Value,0,-10000000,33124376,23124376
1130,2020-06-30,430,Value,0,-10000000,33124376,23124376
1130,2020-09-30,430,Value,0,-10000000,33124376,23124376
1130,2020-12-31,430,Value,0,-10000000,33124376,23124376
1130,2021-03-31,430,Value,0,-10000000,33124376,23124376
1130,2021-06-30,430,Value,0,-10000000,33124376,23124376
1130,2021-09-30,430,Value,0,-10000000,33124376,23124376
1130,2021-12-31,430,Value,0,-10000000,33124376,23124376
1135,2020-03-31,432,Value,0,-9161000,25131372,15970372
1135,2020-06-30,432,Value,0,-9161000,25131372,15970372
1135,2020-09-30,432,Value,0,-9161000,25131372,15970372
1135,2020-12-31,432,Value,0,-9161000,25131372,15970372
1135,2021-03-31,432,Value,0,-9161000,25131372,15970372
1135,2021-06-30,432,Value,0,-9161000,25131372,15970372
1135,2021-09-30,432,Value,0,-9161000,25131372,15970372
1135,2021-12-31,432,Value,0,-9161000,25131372,15970372
1136,2020-03-31,432,Value,0,-10030755,6775024,-3255731
1136,2020-06-30,432,Value,0,-10030755,6775024,-3255731
1136,2020-09-30,432,Value,0,-10030755,6775024,-3255731
1136,2020-12-31,432,Value,0,-10030755,6775024,-3255731
1136,2021-03-31,432,Value,0,-10030755,6775024,-3255731
1136,2021-06-30,432,Value,0,-10030755,6775024,-3255731
1136,2021-09-30,432,Value,0,-10030755,6775024,-3255731
1136,2021-12-31,432,Value,0,-10030755,6775024,-3255731
1141,2020-03-31,434,Value,0,-9833335,9833334,-1
1141,2020-06-30,434,Value,0,-9833335,9833334,-1
1141,2020-09-30,434,Value,0,-9833335,9833334,-1
1141,2020-12-31,434,Value,0,-9833335,9833334,-1
1141,2021-03-31,434,Value,0,-9833335,9833334,-1
1141,2021-06-30,434,Value,0,-9833335,9833334,-1
1141,2021-09-30,434,Value,0,-9833335,9833334,-1
1141,2021-12-31,434,Value,0,-9833335,9833334,-1
1142,2021-12-31,434,Value,0,-9873333,9513335,-359998
1151,2020-03-31,439,Value,0,-8599998,18218240,9618242
1151,2020-06-30,439,Value,0,-8599998,18218240,9618242
1151,2020-09-30,439,Value,0,-8599998,18218240,9618242
1151,2020-12-31,439,Value,0,-8599998,18218240,9618242
1151,2021-03-31,439,Value,0,-8599998,18218240,9618242
1151,2021-06-30,439,Value,0,-8599998,18218240,9618242
1151,2021-09-30,439,Value,0,-8599998,18218240,9618242
1151,2021-12-31,439,Value,0,-8599998,18218240,9618242
1155,2020-02-15,443,Distribution,-6241,-10628502,30231926,19603424
1155,2020-03-31,443,Value,85190,-10628502,30231926,19603424
1155,2020-05-16,443,Distribution,-95344,-10628502,30136582,19508080
1155,2020-08-15,443,Capital Call,3742,-10624760,30136582,19511822
1155,2020-08-15,443,Distribution,-10611,-10624760,30125971,19501211
1155,2020-09-30,443,Value,0,-10624760,30125971,19501211
1155,2020-12-31,443,Value,0,-10624760,30125971,19501211
1155,2021-03-31,443,Value,0,-10624760,30125971,19501211
1155,2021-06-30,443,Value,0,-10624760,30125971,19501211
1155,2021-09-30,443,Value,0,-10624760,30125971,19501211
1155,2021-12-31,443,Value,0,-10624760,30125971,19501211
1159,2020-03-31,444,Value,0,-10286670,26789111,16502441
1159,2020-06-30,444,Value,0,-10286670,26789111,16502441
1159,2020-09-30,444,Value,0,-10286670,26789111,16502441
1159,2020-12-31,444,Value,0,-10286670,26789111,16502441
1159,2021-03-31,444,Value,0,-10286670,26789111,16502441
1159,2021-06-30,444,Value,0,-10286670,26789111,16502441
1159,2021-09-30,444,Value,0,-10286670,26789111,16502441
1159,2021-12-31,444,Value,0,-10286670,26789111,16502441
1160,2021-12-31,444,Value,0,-9504629,14072509,4567880
1161,2020-03-31,444,Value,0,-9629995,8281801,-1348194
1161,2020-06-30,444,Value,0,-9629995,8281801,-1348194
1161,2020-09-30,444,Value,0,-9629995,8281801,-1348194
1161,2020-12-31,444,Value,0,-9629995,8281801,-1348194
1161,2021-03-31,444,Value,0,-9629995,8281801,-1348194
1161,2021-06-30,444,Value,0,-9629995,8281801,-1348194
1161,2021-09-30,444,Value,0,-9629995,8281801,-1348194
1161,2021-12-31,444,Value,0,-9629995,8281801,-1348194
1162,2020-03-31,444,Value,0,-9695789,11914215,2218426
1162,2020-06-30,444,Value,0,-9695789,11914215,2218426
1162,2020-09-30,444,Value,0,-9695789,11914215,2218426
1162,2020-12-31,444,Value,0,-9695789,11914215,2218426
1162,2021-03-31,444,Value,0,-9695789,11914215,2218426
1162,2021-06-30,444,Value,0,-9695789,11914215,2218426
1162,2021-09-30,444,Value,0,-9695789,11914215,2218426
1162,2021-12-31,444,Value,0,-9695789,11914215,2218426
1163,2020-03-31,444,Value,0,-9920004,12796812,2876808
1163,2020-06-30,444,Value,0,-9920004,12796812,2876808
1163,2020-09-30,444,Value,0,-9920004,12796812,2876808
1163,2020-12-31,444,Value,0,-9920004,12796812,2876808
1163,2021-03-31,444,Value,0,-9920004,12796812,2876808
1163,2021-06-30,444,Value,0,-9920004,12796812,2876808
1163,2021-09-30,444,Value,0,-9920004,12796812,2876808
1163,2021-12-31,444,Value,0,-9920004,12796812,2876808
1167,2020-03-31,445,Value,0,-10000000,10571000,571000
1167,2020-06-30,445,Value,0,-10000000,10571000,571000
1167,2020-09-30,445,Value,0,-10000000,10571000,571000
1167,2020-12-31,445,Value,0,-10000000,10571000,571000
1167,2021-03-31,445,Value,0,-10000000,10571000,571000
1167,2021-06-30,445,Value,0,-10000000,10571000,571000
1167,2021-09-30,445,Value,0,-10000000,10571000,571000
1167,2021-12-31,445,Value,0,-10000000,10571000,571000
1170,2021-12-31,877,Value,0,-9678801,7353200,-2325601
1171,2020-03-31,446,Value,0,-9300003,9782131,482128
1171,2020-06-30,446,Value,0,-9300003,9782131,482128
1171,2020-09-30,446,Value,0,-9300003,9782131,482128
1171,2020-12-31,446,Value,0,-9300003,9782131,482128
1171,2021-03-31,446,Value,0,-9300003,9782131,482128
1171,2021-06-30,446,Value,0,-9300003,9782131,482128
1171,2021-09-30,446,Value,0,-9300003,9782131,482128
1171,2021-12-31,446,Value,0,-9300003,9782131,482128
1172,2020-03-31,447,Value,0,-10000000,24146000,14146000
1172,2020-06-30,447,Value,0,-10000000,24146000,14146000
1172,2020-09-30,447,Value,0,-10000000,24146000,14146000
1172,2020-12-31,447,Value,0,-10000000,24146000,14146000
1172,2021-03-31,447,Value,0,-10000000,24146000,14146000
1172,2021-06-30,447,Value,0,-10000000,24146000,14146000
1172,2021-09-30,447,Value,0,-10000000,24146000,14146000
1172,2021-12-31,447,Value,0,-10000000,24146000,14146000
1173,2020-03-31,447,Value,0,-9499784,20789133,11289349
1173,2020-06-30,447,Value,0,-9499784,20789133,11289349
1173,2020-09-30,447,Value,0,-9499784,20789133,11289349
1173,2020-12-31,447,Value,0,-9499784,20789133,11289349
1173,2021-03-31,447,Value,0,-9499784,20789133,11289349
1173,2021-06-30,447,Value,0,-9499784,20789133,11289349
1173,2021-09-30,447,Value,0,-9499784,20789133,11289349
1173,2021-12-31,447,Value,0,-9499784,20789133,11289349
1175,2020-03-31,449,Value,19180,-10294303,13447700,3153397
1175,2020-06-30,449,Value,17330,-10294303,13447700,3153397
1175,2020-09-30,449,Value,17310,-10294303,13447700,3153397
1175,2020-12-31,449,Value,16730,-10294303,13447700,3153397
1175,2021-03-31,449,Value,16730,-10294303,13447700,3153397
1175,2021-06-30,449,Value,16730,-10294303,13447700,3153397
1175,2021-12-31,449,Value,0,-10294303,13447700,3153397
1185,2020-03-31,455,Value,0,-10773699,12084982,1311283
1185,2020-06-30,455,Value,0,-10773699,12084982,1311283
1185,2020-09-30,455,Value,0,-10773699,12084982,1311283
1185,2020-12-31,455,Value,0,-10773699,12084982,1311283
1185,2021-03-31,455,Value,0,-10773699,12084982,1311283
1185,2021-06-30,455,Value,0,-10773699,12084982,1311283
1185,2021-09-30,455,Value,0,-10773699,12084982,1311283
1185,2021-12-31,455,Value,0,-10773699,12084982,1311283
1186,2020-03-31,455,Value,0,-11100003,14985002,3884999
1186,2020-06-30,455,Value,0,-11100003,14985002,3884999
1186,2020-09-30,455,Value,0,-11100003,14985002,3884999
1186,2020-12-31,455,Value,0,-11100003,14985002,3884999
1186,2021-03-31,455,Value,0,-11100003,14985002,3884999
1186,2021-06-30,455,Value,0,-11100003,14985002,3884999
1186,2021-09-30,455,Value,0,-11100003,14985002,3884999
1186,2021-12-31,455,Value,0,-11100003,14985002,3884999
1190,2020-03-31,458,Value,0,-10000001,12672368,2672367
1190,2020-06-30,458,Value,0,-10000001,12672368,2672367
1190,2020-09-30,458,Value,0,-10000001,12672368,2672367
1190,2020-12-31,458,Value,0,-10000001,12672368,2672367
1190,2021-03-31,458,Value,0,-10000001,12672368,2672367
1190,2021-06-30,458,Value,0,-10000001,12672368,2672367
1190,2021-09-30,458,Value,0,-10000001,12672368,2672367
1190,2021-12-31,458,Value,0,-10000001,12672368,2672367
1191,2020-03-31,458,Value,0,-9920500,13178052,3257552
1191,2020-06-30,458,Value,0,-9920500,13178052,3257552
1191,2020-09-30,458,Value,0,-9920500,13178052,3257552
1191,2020-12-31,458,Value,0,-9920500,13178052,3257552
1191,2021-03-31,458,Value,0,-9920500,13178052,3257552
1191,2021-06-30,458,Value,0,-9920500,13178052,3257552
1191,2021-09-30,458,Value,0,-9920500,13178052,3257552
1191,2021-12-31,458,Value,0,-9920500,13178052,3257552
1192,2020-03-31,458,Value,0,-9861850,12439736,2577886
1192,2020-06-30,458,Value,0,-9861850,12439736,2577886
1192,2020-09-30,458,Value,0,-9861850,12439736,2577886
1192,2020-12-31,458,Value,0,-9861850,12439736,2577886
1192,2021-03-31,458,Value,0,-9861850,12439736,2577886
1192,2021-06-30,458,Value,0,-9861850,12439736,2577886
1192,2021-09-30,458,Value,0,-9861850,12439736,2577886
1192,2021-12-31,458,Value,0,-9861850,12439736,2577886
1193,2020-03-31,458,Value,0,-9811218,17419612,7608394
1193,2020-06-30,458,Value,0,-9811218,17419612,7608394
1193,2020-09-30,458,Value,0,-9811218,17419612,7608394
1193,2020-12-31,458,Value,0,-9811218,17419612,7608394
1193,2021-03-31,458,Value,0,-9811218,17419612,7608394
1193,2021-06-30,458,Value,0,-9811218,17419612,7608394
1193,2021-09-30,458,Value,0,-9811218,17419612,7608394
1193,2021-12-31,458,Value,0,-9811218,17419612,7608394
1194,2020-03-31,458,Value,53990,-11026974,17752794,6725820
1194,2020-06-30,458,Value,51950,-11026974,17752794,6725820
1194,2020-09-30,458,Value,39020,-11026974,17752794,6725820
1194,2020-12-31,458,Value,39300,-11026974,17752794,6725820
1194,2021-03-31,458,Value,38690,-11026974,17752794,6725820
1194,2021-06-30,458,Value,38670,-11026974,17752794,6725820
1196,2020-03-31,460,Value,0,-10000001,23001310,13001309
1196,2020-06-30,460,Value,0,-10000001,23001310,13001309
1196,2020-09-30,460,Value,0,-10000001,23001310,13001309
1196,2020-12-31,460,Value,0,-10000001,23001310,13001309
1196,2021-03-31,460,Value,0,-10000001,23001310,13001309
1196,2021-06-30,460,Value,0,-10000001,23001310,13001309
1196,2021-09-30,460,Value,0,-10000001,23001310,13001309
1196,2021-12-31,460,Value,0,-10000001,23001310,13001309
1197,2020-03-31,460,Value,0,-10467398,16817431,6350033
1197,2020-06-30,460,Value,0,-10467398,16817431,6350033
1197,2020-09-30,460,Value,0,-10467398,16817431,6350033
1197,2020-12-31,460,Value,0,-10467398,16817431,6350033
1197,2021-03-31,460,Value,0,-10467398,16817431,6350033
1197,2021-06-30,460,Value,0,-10467398,16817431,6350033
1197,2021-09-30,460,Value,0,-10467398,16817431,6350033
1197,2021-12-31,460,Value,0,-10467398,16817431,6350033
1198,2020-03-31,460,Value,0,-10454832,10630347,175515
1198,2020-06-30,460,Value,0,-10454832,10630347,175515
1198,2020-09-30,460,Value,0,-10454832,10630347,175515
1198,2020-12-31,460,Value,0,-10454832,10630347,175515
1198,2021-03-31,460,Value,0,-10454832,10630347,175515
1198,2021-06-30,460,Value,0,-10454832,10630347,175515
1198,2021-09-30,460,Value,0,-10454832,10630347,175515
1198,2021-12-31,460,Value,0,-10454832,10630347,175515
1199,2020-03-31,460,Value,0,-10155250,6771909,-3383341
1199,2020-06-30,460,Value,0,-10155250,6771909,-3383341
1199,2020-09-30,460,Value,0,-10155250,6771909,-3383341
1199,2020-12-31,460,Value,0,-10155250,6771909,-3383341
1199,2021-03-31,460,Value,0,-10155250,6771909,-3383341
1199,2021-06-30,460,Value,0,-10155250,6771909,-3383341
1199,2021-09-30,460,Value,0,-10155250,6771909,-3383341
1199,2021-12-31,460,Value,0,-10155250,6771909,-3383341
1200,2020-03-31,460,Value,0,-10534899,12040152,1505253
1200,2020-06-30,460,Value,0,-10534899,12040152,1505253
1200,2020-09-30,460,Value,0,-10534899,12040152,1505253
1200,2020-12-31,460,Value,0,-10534899,12040152,1505253
1200,2021-03-31,460,Value,0,-10534899,12040152,1505253
1200,2021-06-30,460,Value,0,-10534899,12040152,1505253
1200,2021-09-30,460,Value,0,-10534899,12040152,1505253
1200,2021-12-31,460,Value,0,-10534899,12040152,1505253
1201,2020-03-31,460,Value,0,-22092378,18944215,-3148163
1201,2020-06-30,460,Value,0,-22092378,18944215,-3148163
1201,2020-09-30,460,Value,0,-22092378,18944215,-3148163
1201,2020-12-31,460,Value,0,-22092378,18944215,-3148163
1201,2021-03-31,460,Value,0,-22092378,18944215,-3148163
1201,2021-06-30,460,Value,0,-22092378,18944215,-3148163
1201,2021-09-30,460,Value,0,-22092378,18944215,-3148163
1201,2021-12-31,460,Value,0,-22092378,18944215,-3148163
1204,2021-12-31,463,Value,0,-10522221,24220093,13697872
1205,2020-03-31,464,Value,0,-9999999,25609352,15609353
1205,2020-06-30,464,Value,0,-9999999,25609352,15609353
1205,2020-09-30,464,Value,0,-9999999,25609352,15609353
1205,2020-12-31,464,Value,0,-9999999,25609352,15609353
1205,2021-03-31,464,Value,0,-9999999,25609352,15609353
1205,2021-12-31,464,Value,0,-9999999,25609352,15609353
1206,2021-12-31,465,Value,0,-10859396,16981716,6122320
1211,2020-03-31,469,Value,0,-8900002,12104000,3203998
1211,2020-06-30,469,Value,0,-8900002,12104000,3203998
1211,2020-09-30,469,Value,0,-8900002,12104000,3203998
1211,2020-12-31,469,Value,0,-8900002,12104000,3203998
1211,2021-03-31,469,Value,0,-8900002,12104000,3203998
1211,2021-06-30,469,Value,0,-8900002,12104000,3203998
1211,2021-09-30,469,Value,0,-8900002,12104000,3203998
1211,2021-12-31,469,Value,0,-8900002,12104000,3203998
1215,2020-03-31,32667,Value,61960,-10278183,20703706,10425523
1215,2020-05-16,32667,Distribution,0,-10278183,20703706,10425523
1215,2020-06-30,32667,Value,91310,-10278183,20703706,10425523
1215,2020-11-14,32667,Distribution,77378,-10278183,20781084,10502901
1215,2021-03-31,32667,Value,15130,-10278183,20781084,10502901
1216,2020-03-31,32667,Value,32040,-9522599,22202396,12679797
1216,2020-06-30,32667,Value,31640,-9522599,22202396,12679797
1216,2020-12-31,32667,Value,31790,-9522599,22202396,12679797
1216,2021-03-31,32667,Value,32920,-9522599,22202396,12679797
1216,2021-06-30,32667,Value,32820,-9522599,22202396,12679797
1228,2020-03-31,479,Value,0,-9669271,32767872,23098601
1228,2020-06-30,479,Value,0,-9669271,32767872,23098601
1228,2020-09-30,479,Value,0,-9669271,32767872,23098601
1228,2020-12-31,479,Value,0,-9669271,32767872,23098601
1228,2021-03-31,479,Value,0,-9669271,32767872,23098601
1228,2021-12-31,479,Value,0,-9669271,32767872,23098601
1229,2021-12-31,479,Value,0,-10000002,23325217,13325215
1230,2020-03-31,479,Value,0,-10018000,15264427,5246427
1230,2020-06-30,479,Value,0,-10018000,15264427,5246427
1230,2020-09-30,479,Value,0,-10018000,15264427,5246427
1230,2020-12-31,479,Value,0,-10018000,15264427,5246427
1230,2021-03-31,479,Value,0,-10018000,15264427,5246427
1230,2021-06-30,479,Value,0,-10018000,15264427,5246427
1230,2021-09-30,479,Value,0,-10018000,15264427,5246427
1230,2021-12-31,479,Value,0,-10018000,15264427,5246427
1237,2020-03-31,483,Value,0,-8355162,23855659,15500497
1237,2020-06-30,483,Value,0,-8355162,23855659,15500497
1237,2020-09-30,483,Value,0,-8355162,23855659,15500497
1237,2020-12-31,483,Value,0,-8355162,23855659,15500497
1237,2021-03-31,483,Value,0,-8355162,23855659,15500497
1237,2021-06-30,483,Value,0,-8355162,23855659,15500497
1237,2021-09-30,483,Value,0,-8355162,23855659,15500497
1237,2021-12-31,483,Value,0,-8355162,23855659,15500497
1240,2020-03-31,486,Value,0,-10000000,205113156,195113156
1240,2020-06-30,486,Value,0,-10000000,205113156,195113156
1240,2020-09-30,486,Value,0,-10000000,205113156,195113156
1240,2020-12-31,486,Value,0,-10000000,205113156,195113156
1240,2021-03-31,486,Value,0,-10000000,205113156,195113156
1240,2021-06-30,486,Value,0,-10000000,205113156,195113156
1240,2021-09-30,486,Value,0,-10000000,205113156,195113156
1240,2021-12-31,486,Value,0,-10000000,205113156,195113156
1241,2020-03-31,486,Value,0,-10000000,198622442,188622442
1241,2020-06-30,486,Value,0,-10000000,198622442,188622442
1241,2020-09-30,486,Value,0,-10000000,198622442,188622442
1241,2020-12-31,486,Value,0,-10000000,198622442,188622442
1241,2021-03-31,486,Value,0,-10000000,198622442,188622442
1241,2021-06-30,486,Value,0,-10000000,198622442,188622442
1241,2021-09-30,486,Value,0,-10000000,198622442,188622442
1241,2021-12-31,486,Value,0,-10000000,198622442,188622442
1242,2020-03-31,486,Value,0,-10000000,12243095,2243095
1242,2020-06-30,486,Value,0,-10000000,12243095,2243095
1242,2020-09-30,486,Value,0,-10000000,12243095,2243095
1242,2020-12-31,486,Value,0,-10000000,12243095,2243095
1242,2021-03-31,486,Value,0,-10000000,12243095,2243095
1242,2021-06-30,486,Value,0,-10000000,12243095,2243095
1242,2021-09-30,486,Value,0,-10000000,12243095,2243095
1242,2021-12-31,486,Value,0,-10000000,12243095,2243095
1243,2020-03-31,486,Value,232580,-9510074,13483698,3973624
1243,2020-06-30,486,Value,263390,-9510074,13483698,3973624
1243,2020-09-30,486,Value,263290,-9510074,13483698,3973624
1243,2020-12-31,486,Value,263150,-9510074,13483698,3973624
1243,2021-03-31,486,Value,263010,-9510074,13483698,3973624
1245,2020-03-31,487,Value,0,-10000000,39262666,29262666
1245,2020-06-30,487,Value,0,-10000000,39262666,29262666
1245,2020-09-30,487,Value,0,-10000000,39262666,29262666
1245,2020-12-31,487,Value,0,-10000000,39262666,29262666
1245,2021-03-31,487,Value,0,-10000000,39262666,29262666
1245,2021-06-30,487,Value,0,-10000000,39262666,29262666
1245,2021-09-30,487,Value,0,-10000000,39262666,29262666
1245,2021-12-31,487,Value,0,-10000000,39262666,29262666
1246,2020-03-31,487,Value,0,-10000000,28583332,18583332
1246,2020-06-30,487,Value,0,-10000000,28583332,18583332
1246,2020-09-30,487,Value,0,-10000000,28583332,18583332
1246,2020-12-31,487,Value,0,-10000000,28583332,18583332
1246,2021-03-31,487,Value,0,-10000000,28583332,18583332
1246,2021-06-30,487,Value,0,-10000000,28583332,18583332
1246,2021-09-30,487,Value,0,-10000000,28583332,18583332
1246,2021-12-31,487,Value,0,-10000000,28583332,18583332
1247,2020-03-31,487,Value,0,-10000000,31196666,21196666
1247,2020-06-30,487,Value,0,-10000000,31196666,21196666
1247,2020-09-30,487,Value,0,-10000000,31196666,21196666
1247,2020-12-31,487,Value,0,-10000000,31196666,21196666
1247,2021-03-31,487,Value,0,-10000000,31196666,21196666
1247,2021-06-30,487,Value,0,-10000000,31196666,21196666
1247,2021-09-30,487,Value,0,-10000000,31196666,21196666
1247,2021-12-31,487,Value,0,-10000000,31196666,21196666
1249,2021-12-31,487,Value,0,-8600000,4718856,-3881144
1253,2020-03-31,490,Value,0,-10159999,13431522,3271523
1253,2020-06-30,490,Value,0,-10159999,13431522,3271523
1253,2020-09-30,490,Value,0,-10159999,13431522,3271523
1253,2020-12-31,490,Value,0,-10159999,13431522,3271523
1253,2021-03-31,490,Value,0,-10159999,13431522,3271523
1253,2021-06-30,490,Value,0,-10159999,13431522,3271523
1253,2021-09-30,490,Value,0,-10159999,13431522,3271523
1253,2021-12-31,490,Value,0,-10159999,13431522,3271523
1254,2020-03-31,490,Value,0,-8526121,6684351,-1841770
1254,2020-06-30,490,Value,0,-8526121,6684351,-1841770
1254,2020-09-30,490,Value,0,-8526121,6684351,-1841770
1254,2020-12-31,490,Value,0,-8526121,6684351,-1841770
1254,2021-03-31,490,Value,0,-8526121,6684351,-1841770
1254,2021-06-30,490,Value,0,-8526121,6684351,-1841770
1254,2021-09-30,490,Value,0,-8526121,6684351,-1841770
1254,2021-12-31,490,Value,0,-8526121,6684351,-1841770
1256,2020-03-31,5906,Value,0,-10000000,16109073,6109073
1256,2020-06-30,5906,Value,0,-10000000,16109073,6109073
1256,2020-09-30,5906,Value,0,-10000000,16109073,6109073
1256,2020-12-31,5906,Value,0,-10000000,16109073,6109073
1256,2021-03-31,5906,Value,0,-10000000,16109073,6109073
1256,2021-06-30,5906,Value,0,-10000000,16109073,6109073
1256,2021-09-30,5906,Value,0,-10000000,16109073,6109073
1256,2021-12-31,5906,Value,0,-10000000,16109073,6109073
1257,2020-03-31,5906,Value,0,-10000000,44745019,34745019
1257,2020-06-30,5906,Value,0,-10000000,44745019,34745019
1257,2020-09-30,5906,Value,0,-10000000,44745019,34745019
1257,2020-12-31,5906,Value,0,-10000000,44745019,34745019
1257,2021-03-31,5906,Value,0,-10000000,44745019,34745019
1257,2021-06-30,5906,Value,0,-10000000,44745019,34745019
1257,2021-09-30,5906,Value,0,-10000000,44745019,34745019
1257,2021-12-31,5906,Value,0,-10000000,44745019,34745019
1265,2021-12-31,496,Value,0,-10000000,15676520,5676520
1268,2020-03-31,496,Value,0,-10000000,31079999,21079999
1268,2020-06-30,496,Value,0,-10000000,31079999,21079999
1268,2020-09-30,496,Value,0,-10000000,31079999,21079999
1268,2020-12-31,496,Value,0,-10000000,31079999,21079999
1268,2021-03-31,496,Value,0,-10000000,31079999,21079999
1268,2021-06-30,496,Value,0,-10000000,31079999,21079999
1268,2021-09-30,496,Value,0,-10000000,31079999,21079999
1268,2021-12-31,496,Value,0,-10000000,31079999,21079999
1269,2020-03-31,496,Value,0,-10000000,47104062,37104062
1269,2020-06-30,496,Value,0,-10000000,47104062,37104062
1269,2020-09-30,496,Value,0,-10000000,47104062,37104062
1269,2020-12-31,496,Value,0,-10000000,47104062,37104062
1269,2021-03-31,496,Value,0,-10000000,47104062,37104062
1269,2021-06-30,496,Value,0,-10000000,47104062,37104062
1269,2021-09-30,496,Value,0,-10000000,47104062,37104062
1269,2021-12-31,496,Value,0,-10000000,47104062,37104062
1270,2020-03-31,496,Value,0,-10000000,4989003,-5010997
1270,2020-06-30,496,Value,0,-10000000,4989003,-5010997
1270,2020-09-30,496,Value,0,-10000000,4989003,-5010997
1270,2020-12-31,496,Value,0,-10000000,4989003,-5010997
1270,2021-03-31,496,Value,0,-10000000,4989003,-5010997
1270,2021-06-30,496,Value,0,-10000000,4989003,-5010997
1270,2021-09-30,496,Value,0,-10000000,4989003,-5010997
1270,2021-12-31,496,Value,0,-10000000,4989003,-5010997
1280,2020-03-31,1439,Value,0,-12015000,43523666,31508666
1280,2020-06-30,1439,Value,0,-12015000,43523666,31508666
1280,2020-09-30,1439,Value,0,-12015000,43523666,31508666
1280,2020-12-31,1439,Value,0,-12015000,43523666,31508666
1280,2021-03-31,1439,Value,0,-12015000,43523666,31508666
1280,2021-06-30,1439,Value,0,-12015000,43523666,31508666
1280,2021-09-30,1439,Value,0,-12015000,43523666,31508666
1280,2021-12-31,1439,Value,0,-12015000,43523666,31508666
1281,2020-03-31,1439,Value,0,-11106072,16239047,5132975
1281,2020-06-30,1439,Value,0,-11106072,16239047,5132975
1281,2020-09-30,1439,Value,0,-11106072,16239047,5132975
1281,2020-12-31,1439,Value,0,-11106072,16239047,5132975
1281,2021-03-31,1439,Value,0,-11106072,16239047,5132975
1281,2021-06-30,1439,Value,0,-11106072,16239047,5132975
1281,2021-09-30,1439,Value,0,-11106072,16239047,5132975
1281,2021-12-31,1439,Value,0,-11106072,16239047,5132975
1283,2020-03-31,506,Value,0,-10000000,12073074,2073074
1283,2020-06-30,506,Value,0,-10000000,12073074,2073074
1283,2020-09-30,506,Value,0,-10000000,12073074,2073074
1283,2020-12-31,506,Value,0,-10000000,12073074,2073074
1283,2021-03-31,506,Value,0,-10000000,12073074,2073074
1283,2021-06-30,506,Value,0,-10000000,12073074,2073074
1283,2021-09-30,506,Value,0,-10000000,12073074,2073074
1283,2021-12-31,506,Value,0,-10000000,12073074,2073074
1284,2020-03-31,506,Value,0,-9875000,2190033,-7684967
1284,2020-06-30,506,Value,0,-9875000,2190033,-7684967
1284,2020-09-30,506,Value,0,-9875000,2190033,-7684967
1284,2020-12-31,506,Value,0,-9875000,2190033,-7684967
1284,2021-03-31,506,Value,0,-9875000,2190033,-7684967
1284,2021-06-30,506,Value,0,-9875000,2190033,-7684967
1284,2021-09-30,506,Value,0,-9875000,2190033,-7684967
1284,2021-12-31,506,Value,0,-9875000,2190033,-7684967
1286,2020-03-31,506,Value,132530,-10000000,18664128,8664128
1286,2020-05-16,506,Distribution,51021,-10000000,18715149,8715149
1286,2020-06-30,506,Value,78080,-10000000,18715149,8715149
1286,2021-12-31,506,Value,0,-10000000,18715149,8715149
1298,2021-12-31,514,Value,0,-10000000,5373000,-4627000
1303,2020-03-31,515,Value,67750,-9882563,5854764,-4027799
1303,2020-06-30,515,Value,67640,-9882563,5854764,-4027799
1303,2020-09-30,515,Value,64280,-9882563,5854764,-4027799
1303,2020-11-15,515,Distribution,59192,-9882563,5913956,-3968607
1303,2020-12-31,515,Value,0,-9882563,5913956,-3968607
1303,2021-03-31,515,Value,0,-9882563,5913956,-3968607
1303,2021-06-30,515,Value,0,-9882563,5913956,-3968607
1303,2021-09-30,515,Value,0,-9882563,5913956,-3968607
1303,2021-12-31,515,Value,0,-9882563,5913956,-3968607
1305,2020-03-31,355,Value,928160,-10500609,9584427,-916182
1325,2020-03-31,107708,Value,0,-9942763,23244048,13301285
1325,2020-06-30,107708,Value,0,-9942763,23244048,13301285
1325,2020-09-30,107708,Value,0,-9942763,23244048,13301285
1325,2020-12-31,107708,Value,0,-9942763,23244048,13301285
1325,2021-03-31,107708,Value,0,-9942763,23244048,13301285
1325,2021-06-30,107708,Value,0,-9942763,23244048,13301285
1325,2021-09-30,107708,Value,0,-9942763,23244048,13301285
1325,2021-12-31,107708,Value,0,-9942763,23244048,13301285
1326,2020-03-31,107708,Value,232000,-10000000,7948000,-2052000
1326,2020-06-30,107708,Value,238000,-10000000,7948000,-2052000
1326,2020-09-30,107708,Value,238000,-10000000,7948000,-2052000
1326,2020-11-15,107708,Distribution,136000,-10000000,8084000,-1916000
1326,2020-12-31,107708,Value,120000,-10000000,8084000,-1916000
1328,2020-03-31,526,Value,0,-10001557,21310542,11308985
1328,2020-06-30,526,Value,0,-10001557,21310542,11308985
1328,2020-09-30,526,Value,0,-10001557,21310542,11308985
1328,2020-12-31,526,Value,0,-10001557,21310542,11308985
1328,2021-03-31,526,Value,0,-10001557,21310542,11308985
1328,2021-06-30,526,Value,0,-10001557,21310542,11308985
1328,2021-09-30,526,Value,0,-10001557,21310542,11308985
1328,2021-12-31,526,Value,0,-10001557,21310542,11308985
1329,2020-03-31,526,Value,0,-10001361,17572024,7570663
1329,2020-06-30,526,Value,0,-10001361,17572024,7570663
1329,2020-09-30,526,Value,0,-10001361,17572024,7570663
1329,2020-12-31,526,Value,0,-10001361,17572024,7570663
1329,2021-03-31,526,Value,0,-10001361,17572024,7570663
1329,2021-06-30,526,Value,0,-10001361,17572024,7570663
1329,2021-09-30,526,Value,0,-10001361,17572024,7570663
1329,2021-12-31,526,Value,0,-10001361,17572024,7570663
1330,2020-03-31,526,Value,0,-10109000,5760109,-4348891
1330,2020-06-30,526,Value,0,-10109000,5760109,-4348891
1330,2020-09-30,526,Value,0,-10109000,5760109,-4348891
1330,2020-12-31,526,Value,0,-10109000,5760109,-4348891
1330,2021-03-31,526,Value,0,-10109000,5760109,-4348891
1330,2021-06-30,526,Value,0,-10109000,5760109,-4348891
1330,2021-09-30,526,Value,0,-10109000,5760109,-4348891
1330,2021-12-31,526,Value,0,-10109000,5760109,-4348891
1331,2020-02-15,526,Distribution,0,-10002280,8685745,-1316535
1331,2020-03-31,526,Value,73710,-10002280,8685745,-1316535
1331,2020-05-16,526,Distribution,0,-10002280,8685745,-1316535
1331,2020-06-30,526,Value,77650,-10002280,8685745,-1316535
1331,2020-09-30,526,Value,78180,-10002280,8685745,-1316535
1331,2020-12-31,526,Value,83350,-10002280,8685745,-1316535
1331,2021-03-31,526,Value,83770,-10002280,8685745,-1316535
1331,2021-06-30,526,Value,0,-10002280,8685745,-1316535
1331,2021-09-30,526,Value,0,-10002280,8685745,-1316535
1331,2021-12-31,526,Value,0,-10002280,8685745,-1316535
1332,2020-03-31,505,Value,0,-9658000,53067000,43409000
1332,2020-06-30,505,Value,0,-9658000,53067000,43409000
1332,2020-09-30,505,Value,0,-9658000,53067000,43409000
1332,2020-12-31,505,Value,0,-9658000,53067000,43409000
1332,2021-03-31,505,Value,0,-9658000,53067000,43409000
1332,2021-06-30,505,Value,0,-9658000,53067000,43409000
1332,2021-09-30,505,Value,0,-9658000,53067000,43409000
1332,2021-12-31,505,Value,0,-9658000,53067000,43409000
1338,2020-03-31,532,Value,0,-10000001,31340376,21340375
1338,2020-06-30,532,Value,0,-10000001,31340376,21340375
1338,2020-09-30,532,Value,0,-10000001,31340376,21340375
1338,2020-12-31,532,Value,0,-10000001,31340376,21340375
1338,2021-03-31,532,Value,0,-10000001,31340376,21340375
1338,2021-06-30,532,Value,0,-10000001,31340376,21340375
1338,2021-09-30,532,Value,0,-10000001,31340376,21340375
1338,2021-12-31,532,Value,0,-10000001,31340376,21340375
1339,2020-02-15,533,Capital Call,0,-9617911,19751959,10134048
1339,2020-02-15,533,Distribution,0,-9617911,19751959,10134048
1339,2020-03-31,533,Value,435640,-9617911,19751959,10134048
1339,2020-06-30,533,Value,406610,-9617911,19751959,10134048
1339,2020-09-30,533,Value,410630,-9617911,19751959,10134048
1339,2020-11-15,533,Capital Call,0,-9617911,19751959,10134048
1339,2020-11-15,533,Distribution,0,-9617911,19751959,10134048
1339,2020-12-31,533,Value,434250,-9617911,19751959,10134048
1346,2020-03-31,878,Value,0,-10000000,9650732,-349268
1346,2020-06-30,878,Value,0,-10000000,9650732,-349268
1346,2020-09-30,878,Value,0,-10000000,9650732,-349268
1346,2020-12-31,878,Value,0,-10000000,9650732,-349268
1346,2021-03-31,878,Value,0,-10000000,9650732,-349268
1346,2021-06-30,878,Value,0,-10000000,9650732,-349268
1346,2021-09-30,878,Value,0,-10000000,9650732,-349268
1346,2021-12-31,878,Value,0,-10000000,9650732,-349268
1350,2021-12-31,537,Value,0,-10000000,27974061,17974061
1352,2020-03-31,537,Value,0,-10000000,34117001,24117001
1352,2020-06-30,537,Value,0,-10000000,34117001,24117001
1352,2020-09-30,537,Value,0,-10000000,34117001,24117001
1352,2020-12-31,537,Value,0,-10000000,34117001,24117001
1352,2021-03-31,537,Value,0,-10000000,34117001,24117001
1352,2021-06-30,537,Value,0,-10000000,34117001,24117001
1352,2021-09-30,537,Value,0,-10000000,34117001,24117001
1352,2021-12-31,537,Value,0,-10000000,34117001,24117001
1354,2021-12-31,537,Value,0,-10000000,15786000,5786000
1356,2020-03-31,537,Value,1279550,-10000000,9713039,-286961
1356,2020-06-30,537,Value,1505270,-10000000,9713039,-286961
1356,2020-09-30,537,Value,1686450,-10000000,9713039,-286961
1356,2020-12-31,537,Value,2103600,-10000000,9713039,-286961
1356,2021-03-31,537,Value,2164460,-10000000,9713039,-286961
1356,2021-05-16,537,Distribution,107623,-10000000,9820662,-179338
1356,2021-06-30,537,Value,2077000,-10000000,9820662,-179338
1357,2021-12-31,538,Value,0,-8585611,12884590,4298979
1359,2021-12-31,475912,Value,0,-11079999,8764279,-2315720
1360,2021-12-31,475912,Value,0,-11447866,31314444,19866578
1364,2020-03-31,542,Value,0,-10006668,19296667,9289999
1364,2020-06-30,542,Value,0,-10006668,19296667,9289999
1364,2020-09-30,542,Value,0,-10006668,19296667,9289999
1364,2020-12-31,542,Value,0,-10006668,19296667,9289999
1364,2021-03-31,542,Value,0,-10006668,19296667,9289999
1364,2021-06-30,542,Value,0,-10006668,19296667,9289999
1364,2021-09-30,542,Value,0,-10006668,19296667,9289999
1364,2021-12-31,542,Value,0,-10006668,19296667,9289999
1369,2020-03-31,545,Value,0,-11318679,40367019,29048340
1369,2020-06-30,545,Value,0,-11318679,40367019,29048340
1369,2020-09-30,545,Value,0,-11318679,40367019,29048340
1369,2020-12-31,545,Value,0,-11318679,40367019,29048340
1369,2021-12-31,545,Value,0,-11318679,40367019,29048340
1370,2020-03-31,545,Value,0,-11490558,32399323,20908765
1370,2020-06-30,545,Value,0,-11490558,32399323,20908765
1370,2020-09-30,545,Value,0,-11490558,32399323,20908765
1370,2020-12-31,545,Value,0,-11490558,32399323,20908765
1370,2021-12-31,545,Value,0,-11490558,32399323,20908765
1386,2020-03-31,551,Value,0,-10000000,3225536,-6774464
1386,2020-06-30,551,Value,0,-10000000,3225536,-6774464
1386,2020-09-30,551,Value,0,-10000000,3225536,-6774464
1386,2020-12-31,551,Value,0,-10000000,3225536,-6774464
1386,2021-03-31,551,Value,0,-10000000,3225536,-6774464
1386,2021-06-30,551,Value,0,-10000000,3225536,-6774464
1386,2021-09-30,551,Value,0,-10000000,3225536,-6774464
1386,2021-12-31,551,Value,0,-10000000,3225536,-6774464
1389,2020-03-31,5687,Value,0,-10000001,18900002,8900001
1389,2020-06-30,5687,Value,0,-10000001,18900002,8900001
1389,2020-09-30,5687,Value,0,-10000001,18900002,8900001
1389,2020-12-31,5687,Value,0,-10000001,18900002,8900001
1389,2021-03-31,5687,Value,0,-10000001,18900002,8900001
1389,2021-06-30,5687,Value,0,-10000001,18900002,8900001
1389,2021-09-30,5687,Value,0,-10000001,18900002,8900001
1389,2021-12-31,5687,Value,0,-10000001,18900002,8900001
1392,2020-03-31,553,Value,40050,-10000000,6514498,-3485502
1392,2020-06-30,553,Value,39760,-10000000,6514498,-3485502
1392,2020-09-30,553,Value,39540,-10000000,6514498,-3485502
1392,2020-12-31,553,Value,26830,-10000000,6514498,-3485502
1392,2021-03-31,553,Value,26520,-10000000,6514498,-3485502
1392,2021-06-30,553,Value,5020,-10000000,6514498,-3485502
1393,2020-03-31,553,Value,0,-10000000,15194985,5194985
1393,2020-06-30,553,Value,0,-10000000,15194985,5194985
1393,2020-09-30,553,Value,0,-10000000,15194985,5194985
1393,2020-12-31,553,Value,0,-10000000,15194985,5194985
1393,2021-03-31,553,Value,0,-10000000,15194985,5194985
1393,2021-06-30,553,Value,0,-10000000,15194985,5194985
1393,2021-09-30,553,Value,0,-10000000,15194985,5194985
1393,2021-12-31,553,Value,0,-10000000,15194985,5194985
1394,2020-03-31,553,Value,0,-10000000,29072366,19072366
1394,2020-06-30,553,Value,0,-10000000,29072366,19072366
1394,2020-09-30,553,Value,0,-10000000,29072366,19072366
1394,2020-12-31,553,Value,0,-10000000,29072366,19072366
1394,2021-03-31,553,Value,0,-10000000,29072366,19072366
1394,2021-06-30,553,Value,0,-10000000,29072366,19072366
1394,2021-09-30,553,Value,0,-10000000,29072366,19072366
1394,2021-12-31,553,Value,0,-10000000,29072366,19072366
1396,2020-03-31,553,Value,0,-10000000,18006002,8006002
1396,2020-06-30,553,Value,0,-10000000,18006002,8006002
1396,2020-09-30,553,Value,0,-10000000,18006002,8006002
1396,2020-12-31,553,Value,0,-10000000,18006002,8006002
1396,2021-03-31,553,Value,0,-10000000,18006002,8006002
1396,2021-06-30,553,Value,0,-10000000,18006002,8006002
1396,2021-09-30,553,Value,0,-10000000,18006002,8006002
1396,2021-12-31,553,Value,0,-10000000,18006002,8006002
1397,2020-03-31,553,Value,117140,-10000002,12504087,2504085
1397,2020-06-30,553,Value,116730,-10000002,12504087,2504085
1397,2020-09-30,553,Value,115840,-10000002,12504087,2504085
1397,2020-12-31,553,Value,109410,-10000002,12504087,2504085
1397,2021-03-31,553,Value,109020,-10000002,12504087,2504085
1397,2021-05-16,553,Distribution,52595,-10000002,12556682,2556680
1397,2021-06-30,553,Value,56110,-10000002,12556682,2556680
1410,2021-12-31,561,Value,0,-10000000,13117500,3117500
1413,2020-03-31,561,Value,0,-10000000,2700000,-7300000
1413,2020-06-30,561,Value,0,-10000000,2700000,-7300000
1413,2020-09-30,561,Value,0,-10000000,2700000,-7300000
1413,2020-12-31,561,Value,0,-10000000,2700000,-7300000
1413,2021-03-31,561,Value,0,-10000000,2700000,-7300000
1413,2021-06-30,561,Value,0,-10000000,2700000,-7300000
1413,2021-09-30,561,Value,0,-10000000,2700000,-7300000
1413,2021-12-31,561,Value,0,-10000000,2700000,-7300000
1414,2020-03-31,561,Value,13540,-10000000,2826642,-7173358
1414,2020-06-30,561,Value,13540,-10000000,2826642,-7173358
1414,2020-09-30,561,Value,13540,-10000000,2826642,-7173358
1414,2020-12-31,561,Value,0,-10000000,2826642,-7173358
1414,2021-02-14,561,Distribution,11703,-10000000,2838345,-7161655
1414,2021-03-31,561,Value,0,-10000000,2838345,-7161655
1414,2021-06-30,561,Value,0,-10000000,2838345,-7161655
1414,2021-12-31,561,Value,0,-10000000,2838345,-7161655
1416,2020-03-31,557,Value,0,-10337000,23435011,13098011
1416,2020-06-30,557,Value,0,-10337000,23435011,13098011
1416,2020-09-30,557,Value,0,-10337000,23435011,13098011
1416,2020-12-31,557,Value,0,-10337000,23435011,13098011
1416,2021-03-31,557,Value,0,-10337000,23435011,13098011
1416,2021-06-30,557,Value,0,-10337000,23435011,13098011
1416,2021-09-30,557,Value,0,-10337000,23435011,13098011
1416,2021-12-31,557,Value,0,-10337000,23435011,13098011
1417,2020-03-31,557,Value,0,-9467884,17750276,8282392
1417,2020-06-30,557,Value,0,-9467884,17750276,8282392
1417,2020-09-30,557,Value,0,-9467884,17750276,8282392
1417,2020-12-31,557,Value,0,-9467884,17750276,8282392
1417,2021-03-31,557,Value,0,-9467884,17750276,8282392
1417,2021-06-30,557,Value,0,-9467884,17750276,8282392
1417,2021-12-31,557,Value,0,-9467884,17750276,8282392
1420,2020-03-31,8700,Value,925040,-10000000,13370542,3370542
1420,2020-06-30,8700,Value,925040,-10000000,13370542,3370542
1420,2020-09-30,8700,Value,923290,-10000000,13370542,3370542
1420,2020-12-31,8700,Value,923290,-10000000,13370542,3370542
1420,2021-03-31,8700,Value,873760,-10000000,13370542,3370542
1420,2021-06-30,8700,Value,873760,-10000000,13370542,3370542
1421,2020-03-31,8700,Value,1326710,-10000000,4407347,-5592653
1421,2020-06-30,8700,Value,1326710,-10000000,4407347,-5592653
1421,2020-09-30,8700,Value,1283010,-10000000,4407347,-5592653
1421,2020-12-31,8700,Value,1283010,-10000000,4407347,-5592653
1421,2021-03-31,8700,Value,1273670,-10000000,4407347,-5592653
1421,2021-06-30,8700,Value,1273670,-10000000,4407347,-5592653
1421,2021-09-30,8700,Value,1786650,-10000000,4407347,-5592653
1426,2020-03-31,562,Value,0,-10000000,3567160,-6432840
1426,2020-06-30,562,Value,0,-10000000,3567160,-6432840
1426,2020-09-30,562,Value,0,-10000000,3567160,-6432840
1426,2020-12-31,562,Value,0,-10000000,3567160,-6432840
1426,2021-03-31,562,Value,0,-10000000,3567160,-6432840
1426,2021-06-30,562,Value,0,-10000000,3567160,-6432840
1426,2021-09-30,562,Value,0,-10000000,3567160,-6432840
1426,2021-12-31,562,Value,0,-10000000,3567160,-6432840
1427,2020-03-31,562,Value,0,-10000000,5957267,-4042733
1427,2020-06-30,562,Value,0,-10000000,5957267,-4042733
1427,2020-09-30,562,Value,0,-10000000,5957267,-4042733
1427,2020-12-31,562,Value,0,-10000000,5957267,-4042733
1427,2021-03-31,562,Value,0,-10000000,5957267,-4042733
1427,2021-06-30,562,Value,0,-10000000,5957267,-4042733
1427,2021-09-30,562,Value,0,-10000000,5957267,-4042733
1427,2021-12-31,562,Value,0,-10000000,5957267,-4042733
1428,2020-03-31,2049,Value,0,-9999999,16910000,6910001
1428,2020-06-30,2049,Value,0,-9999999,16910000,6910001
1428,2020-09-30,2049,Value,0,-9999999,16910000,6910001
1428,2020-12-31,2049,Value,0,-9999999,16910000,6910001
1428,2021-03-31,2049,Value,0,-9999999,16910000,6910001
1428,2021-06-30,2049,Value,0,-9999999,16910000,6910001
1428,2021-09-30,2049,Value,0,-9999999,16910000,6910001
1428,2021-12-31,2049,Value,0,-9999999,16910000,6910001
1456,2020-03-31,576,Value,0,-9350020,12353549,3003529
1456,2021-12-31,576,Value,0,-9350020,12353549,3003529
1457,2021-12-31,576,Value,0,-9650000,13394552,3744552
1459,2020-01-15,577,Capital Call,0,-10718045,17307547,6589502
1459,2020-02-29,577,Value,132550,-10718045,17307547,6589502
1459,2020-04-15,577,Capital Call,0,-10718045,17307547,6589502
1459,2020-05-31,577,Value,116630,-10718045,17307547,6589502
1459,2020-08-31,577,Value,83750,-10718045,17307547,6589502
1459,2020-11-30,577,Value,121410,-10718045,17307547,6589502
1459,2021-02-28,577,Value,121410,-10718045,17307547,6589502
1459,2021-05-31,577,Value,279250,-10718045,17307547,6589502
1459,2021-07-16,577,Capital Call,-3113,-10721158,17307547,6586389
1459,2021-07-16,577,Distribution,276138,-10721158,17583685,6862527
1459,2021-08-31,577,Value,200740,-10721158,17583685,6862527
1459,2021-11-30,577,Value,248250,-10721158,17583685,6862527
1479,2020-03-31,275,Value,0,-10000000,27270000,17270000
1479,2020-06-30,275,Value,0,-10000000,27270000,17270000
1479,2020-09-30,275,Value,0,-10000000,27270000,17270000
1479,2020-12-31,275,Value,0,-10000000,27270000,17270000
1479,2021-03-31,275,Value,0,-10000000,27270000,17270000
1479,2021-06-30,275,Value,0,-10000000,27270000,17270000
1479,2021-09-30,275,Value,0,-10000000,27270000,17270000
1479,2021-12-31,275,Value,0,-10000000,27270000,17270000
1488,2020-03-31,592,Value,0,-10000000,11638275,1638275
1488,2020-06-30,592,Value,0,-10000000,11638275,1638275
1488,2020-09-30,592,Value,0,-10000000,11638275,1638275
1488,2020-12-31,592,Value,0,-10000000,11638275,1638275
1488,2021-03-31,592,Value,0,-10000000,11638275,1638275
1488,2021-06-30,592,Value,0,-10000000,11638275,1638275
1488,2021-09-30,592,Value,0,-10000000,11638275,1638275
1488,2021-12-31,592,Value,0,-10000000,11638275,1638275
1492,2020-03-31,7476,Value,0,-10000000,21885672,11885672
1492,2020-06-30,7476,Value,0,-10000000,21885672,11885672
1492,2020-09-30,7476,Value,0,-10000000,21885672,11885672
1492,2020-12-31,7476,Value,0,-10000000,21885672,11885672
1492,2021-03-31,7476,Value,0,-10000000,21885672,11885672
1492,2021-06-30,7476,Value,0,-10000000,21885672,11885672
1492,2021-09-30,7476,Value,0,-10000000,21885672,11885672
1492,2021-12-31,7476,Value,0,-10000000,21885672,11885672
1501,2020-03-31,11065,Value,0,-10000000,1790000,-8210000
1501,2020-06-30,11065,Value,0,-10000000,1790000,-8210000
1501,2020-09-30,11065,Value,0,-10000000,1790000,-8210000
1501,2020-12-31,11065,Value,0,-10000000,1790000,-8210000
1501,2021-03-31,11065,Value,0,-10000000,1790000,-8210000
1501,2021-06-30,11065,Value,0,-10000000,1790000,-8210000
1501,2021-09-30,11065,Value,0,-10000000,1790000,-8210000
1501,2021-12-31,11065,Value,0,-10000000,1790000,-8210000
1506,2020-03-31,6468,Value,0,-10000000,6033000,-3967000
1506,2020-06-30,6468,Value,0,-10000000,6033000,-3967000
1506,2020-09-30,6468,Value,0,-10000000,6033000,-3967000
1506,2020-12-31,6468,Value,0,-10000000,6033000,-3967000
1506,2021-03-31,6468,Value,0,-10000000,6033000,-3967000
1506,2021-06-30,6468,Value,0,-10000000,6033000,-3967000
1506,2021-09-30,6468,Value,0,-10000000,6033000,-3967000
1506,2021-12-31,6468,Value,0,-10000000,6033000,-3967000
1507,2020-03-31,6468,Value,0,-10000000,4359034,-5640966
1507,2020-06-30,6468,Value,0,-10000000,4359034,-5640966
1507,2020-09-30,6468,Value,0,-10000000,4359034,-5640966
1507,2020-12-31,6468,Value,0,-10000000,4359034,-5640966
1507,2021-03-31,6468,Value,0,-10000000,4359034,-5640966
1507,2021-06-30,6468,Value,0,-10000000,4359034,-5640966
1507,2021-09-30,6468,Value,0,-10000000,4359034,-5640966
1507,2021-12-31,6468,Value,0,-10000000,4359034,-5640966
1514,2020-03-31,1597,Value,162360,-9900000,7276501,-2623499
1514,2020-06-30,1597,Value,164340,-9900000,7276501,-2623499
1514,2020-09-30,1597,Value,168300,-9900000,7276501,-2623499
1514,2020-12-31,1597,Value,139590,-9900000,7276501,-2623499
1514,2021-03-31,1597,Value,144540,-9900000,7276501,-2623499
1514,2021-06-30,1597,Value,147510,-9900000,7276501,-2623499
1514,2021-09-30,1597,Value,199980,-9900000,7276501,-2623499
1515,2020-01-15,1597,Capital Call,0,-9952134,10703049,750915
1515,2020-01-15,1597,Distribution,0,-9952134,10703049,750915
1515,2020-02-29,1597,Value,1376170,-9952134,10703049,750915
1515,2020-04-15,1597,Capital Call,0,-9952134,10703049,750915
1515,2020-04-15,1597,Distribution,409881,-9952134,11112930,1160796
1515,2020-05-31,1597,Value,904310,-9952134,11112930,1160796
1515,2020-08-31,1597,Value,895420,-9952134,11112930,1160796
1515,2020-10-16,1597,Distribution,275900,-9952134,11388830,1436696
1515,2020-11-30,1597,Value,610350,-9952134,11388830,1436696
1515,2021-02-28,1597,Value,617100,-9952134,11388830,1436696
1515,2021-05-31,1597,Value,623020,-9952134,11388830,1436696
1515,2021-08-31,1597,Value,1055370,-9952134,11388830,1436696
1515,2021-10-16,1597,Capital Call,0,-9952134,11388830,1436696
1515,2021-10-16,1597,Distribution,819763,-9952134,12208593,2256459
1515,2021-11-30,1597,Value,405740,-9952134,12208593,2256459
1516,2020-03-31,260,Value,0,-11042030,29840853,18798823
1516,2020-06-30,260,Value,0,-11042030,29840853,18798823
1516,2020-09-30,260,Value,0,-11042030,29840853,18798823
1516,2020-12-31,260,Value,0,-11042030,29840853,18798823
1516,2021-03-31,260,Value,0,-11042030,29840853,18798823
1516,2021-06-30,260,Value,0,-11042030,29840853,18798823
1516,2021-09-30,260,Value,0,-11042030,29840853,18798823
1516,2021-12-31,260,Value,0,-11042030,29840853,18798823
1517,2020-01-15,599,Capital Call,0,-9917629,14167367,4249738
1517,2020-01-15,599,Distribution,39778,-9917629,14207145,4289516
1517,2020-02-29,599,Value,147420,-9917629,14207145,4289516
1517,2020-04-15,599,Capital Call,0,-9917629,14207145,4289516
1517,2020-04-15,599,Distribution,0,-9917629,14207145,4289516
1517,2020-05-31,599,Value,147420,-9917629,14207145,4289516
1517,2020-08-31,599,Value,133160,-9917629,14207145,4289516
1517,2020-11-30,599,Value,133960,-9917629,14207145,4289516
1517,2021-01-14,599,Distribution,47412,-9917629,14254557,4336928
1517,2021-02-28,599,Value,83280,-9917629,14254557,4336928
1517,2021-05-31,599,Value,90150,-9917629,14254557,4336928
1517,2021-08-31,599,Value,90270,-9917629,14254557,4336928
1517,2021-10-16,599,Capital Call,0,-9917629,14254557,4336928
1517,2021-10-16,599,Distribution,0,-9917629,14254557,4336928
1517,2021-11-30,599,Value,90270,-9917629,14254557,4336928
1527,2020-03-31,739,Value,0,-10000000,23190000,13190000
1527,2020-06-30,739,Value,0,-10000000,23190000,13190000
1527,2020-09-30,739,Value,0,-10000000,23190000,13190000
1527,2020-12-31,739,Value,0,-10000000,23190000,13190000
1527,2021-03-31,739,Value,0,-10000000,23190000,13190000
1527,2021-06-30,739,Value,0,-10000000,23190000,13190000
1527,2021-09-30,739,Value,0,-10000000,23190000,13190000
1527,2021-12-31,739,Value,0,-10000000,23190000,13190000
1528,2020-03-31,739,Value,0,-10000000,35055886,25055886
1528,2020-06-30,739,Value,0,-10000000,35055886,25055886
1528,2020-09-30,739,Value,0,-10000000,35055886,25055886
1528,2020-12-31,739,Value,0,-10000000,35055886,25055886
1528,2021-03-31,739,Value,0,-10000000,35055886,25055886
1528,2021-06-30,739,Value,0,-10000000,35055886,25055886
1528,2021-09-30,739,Value,0,-10000000,35055886,25055886
1528,2021-12-31,739,Value,0,-10000000,35055886,25055886
1529,2020-03-31,739,Value,0,-9750000,10860525,1110525
1529,2020-06-30,739,Value,0,-9750000,10860525,1110525
1529,2020-09-30,739,Value,0,-9750000,10860525,1110525
1529,2020-12-31,739,Value,0,-9750000,10860525,1110525
1529,2021-03-31,739,Value,0,-9750000,10860525,1110525
1529,2021-06-30,739,Value,0,-9750000,10860525,1110525
1529,2021-09-30,739,Value,0,-9750000,10860525,1110525
1529,2021-12-31,739,Value,0,-9750000,10860525,1110525
1530,2020-03-31,739,Value,838750,-10299822,16515769,6215947
1530,2020-06-30,739,Value,649260,-10299822,16515769,6215947
1530,2020-09-30,739,Value,722920,-10299822,16515769,6215947
1530,2020-12-31,739,Value,790670,-10299822,16515769,6215947
1530,2021-03-31,739,Value,641880,-10299822,16515769,6215947
1531,2020-03-31,605,Value,0,-10050643,12134298,2083655
1531,2020-06-30,605,Value,0,-10050643,12134298,2083655
1531,2020-09-30,605,Value,0,-10050643,12134298,2083655
1531,2020-12-31,605,Value,0,-10050643,12134298,2083655
1531,2021-03-31,605,Value,0,-10050643,12134298,2083655
1531,2021-06-30,605,Value,0,-10050643,12134298,2083655
1531,2021-09-30,605,Value,0,-10050643,12134298,2083655
1531,2021-12-31,605,Value,0,-10050643,12134298,2083655
1532,2020-03-31,605,Value,0,-10001776,6938955,-3062821
1532,2020-06-30,605,Value,0,-10001776,6938955,-3062821
1532,2020-09-30,605,Value,0,-10001776,6938955,-3062821
1532,2020-12-31,605,Value,0,-10001776,6938955,-3062821
1532,2021-03-31,605,Value,0,-10001776,6938955,-3062821
1532,2021-06-30,605,Value,0,-10001776,6938955,-3062821
1532,2021-09-30,605,Value,0,-10001776,6938955,-3062821
1532,2021-12-31,605,Value,0,-10001776,6938955,-3062821
1533,2020-03-31,605,Value,0,-10000000,11828023,1828023
1533,2020-06-30,605,Value,0,-10000000,11828023,1828023
1533,2020-09-30,605,Value,0,-10000000,11828023,1828023
1533,2020-12-31,605,Value,0,-10000000,11828023,1828023
1533,2021-03-31,605,Value,0,-10000000,11828023,1828023
1533,2021-06-30,605,Value,0,-10000000,11828023,1828023
1533,2021-09-30,605,Value,0,-10000000,11828023,1828023
1533,2021-12-31,605,Value,0,-10000000,11828023,1828023
1534,2020-03-31,605,Value,0,-9800000,3513012,-6286988
1534,2020-06-30,605,Value,0,-9800000,3513012,-6286988
1534,2020-09-30,605,Value,0,-9800000,3513012,-6286988
1534,2020-12-31,605,Value,0,-9800000,3513012,-6286988
1534,2021-03-31,605,Value,0,-9800000,3513012,-6286988
1534,2021-06-30,605,Value,0,-9800000,3513012,-6286988
1534,2021-09-30,605,Value,0,-9800000,3513012,-6286988
1534,2021-12-31,605,Value,0,-9800000,3513012,-6286988
1535,2020-03-31,605,Value,0,-10000000,7340126,-2659874
1535,2020-06-30,605,Value,0,-10000000,7340126,-2659874
1535,2020-09-30,605,Value,0,-10000000,7340126,-2659874
1535,2020-12-31,605,Value,0,-10000000,7340126,-2659874
1535,2021-03-31,605,Value,0,-10000000,7340126,-2659874
1535,2021-06-30,605,Value,0,-10000000,7340126,-2659874
1535,2021-09-30,605,Value,0,-10000000,7340126,-2659874
1535,2021-12-31,605,Value,0,-10000000,7340126,-2659874
1538,2020-03-31,24,Value,0,-10000000,11710000,1710000
1538,2020-06-30,24,Value,0,-10000000,11710000,1710000
1538,2020-09-30,24,Value,0,-10000000,11710000,1710000
1538,2020-12-31,24,Value,0,-10000000,11710000,1710000
1538,2021-03-31,24,Value,0,-10000000,11710000,1710000
1538,2021-06-30,24,Value,0,-10000000,11710000,1710000
1538,2021-09-30,24,Value,0,-10000000,11710000,1710000
1538,2021-12-31,24,Value,0,-10000000,11710000,1710000
1539,2020-03-31,24,Value,64510,-9900002,14068831,4168829
1539,2020-05-16,24,Capital Call,-120,-9900122,14068831,4168709
1539,2020-05-16,24,Distribution,171,-9900122,14069002,4168880
1539,2020-06-30,24,Value,64200,-9900122,14069002,4168880
1539,2020-08-15,24,Capital Call,120,-9900002,14069002,4169000
1539,2020-08-15,24,Distribution,-171,-9900002,14068831,4168829
1539,2020-09-30,24,Value,63780,-9900002,14068831,4168829
1539,2020-12-31,24,Value,63270,-9900002,14068831,4168829
1539,2021-02-14,24,Capital Call,-120,-9900122,14068831,4168709
1539,2021-02-14,24,Distribution,171,-9900122,14069002,4168880
1539,2021-03-31,24,Value,63170,-9900122,14069002,4168880
1539,2021-05-16,24,Capital Call,120,-9900002,14069002,4169000
1539,2021-05-16,24,Distribution,-171,-9900002,14068831,4168829
1539,2021-06-30,24,Value,62890,-9900002,14068831,4168829
1539,2021-09-30,24,Value,62680,-9900002,14068831,4168829
1555,2020-03-31,610,Value,0,-10008500,7478025,-2530475
1555,2020-06-30,610,Value,0,-10008500,7478025,-2530475
1555,2020-09-30,610,Value,0,-10008500,7478025,-2530475
1555,2020-12-31,610,Value,0,-10008500,7478025,-2530475
1555,2021-03-31,610,Value,0,-10008500,7478025,-2530475
1555,2021-06-30,610,Value,0,-10008500,7478025,-2530475
1555,2021-09-30,610,Value,0,-10008500,7478025,-2530475
1555,2021-12-31,610,Value,0,-10008500,7478025,-2530475
1556,2020-02-15,610,Capital Call,0,-9257031,11897812,2640781
1556,2020-02-15,610,Distribution,0,-9257031,11897812,2640781
1556,2020-03-31,610,Value,98200,-9257031,11897812,2640781
1556,2020-05-16,610,Capital Call,0,-9257031,11897812,2640781
1556,2020-05-16,610,Distribution,0,-9257031,11897812,2640781
1556,2020-06-30,610,Value,64870,-9257031,11897812,2640781
1556,2020-09-30,610,Value,64630,-9257031,11897812,2640781
1556,2020-12-31,610,Value,102950,-9257031,11897812,2640781
1556,2021-03-31,610,Value,115480,-9257031,11897812,2640781
1556,2021-06-30,610,Value,122430,-9257031,11897812,2640781
1556,2021-09-30,610,Value,122160,-9257031,11897812,2640781
1558,2020-03-31,613,Value,0,-10640001,16460002,5820001
1558,2020-06-30,613,Value,0,-10640001,16460002,5820001
1558,2020-09-30,613,Value,0,-10640001,16460002,5820001
1558,2020-12-31,613,Value,0,-10640001,16460002,5820001
1558,2021-03-31,613,Value,0,-10640001,16460002,5820001
1558,2021-06-30,613,Value,0,-10640001,16460002,5820001
1558,2021-09-30,613,Value,0,-10640001,16460002,5820001
1558,2021-12-31,613,Value,0,-10640001,16460002,5820001
1560,2020-03-31,613,Value,0,-10295801,12440781,2144980
1560,2020-06-30,613,Value,0,-10295801,12440781,2144980
1560,2020-09-30,613,Value,0,-10295801,12440781,2144980
1560,2020-12-31,613,Value,0,-10295801,12440781,2144980
1560,2021-03-31,613,Value,0,-10295801,12440781,2144980
1560,2021-06-30,613,Value,0,-10295801,12440781,2144980
1560,2021-09-30,613,Value,0,-10295801,12440781,2144980
1560,2021-12-31,613,Value,0,-10295801,12440781,2144980
1561,2020-03-31,613,Value,0,-12440000,42460001,30020001
1561,2020-06-30,613,Value,0,-12440000,42460001,30020001
1561,2020-09-30,613,Value,0,-12440000,42460001,30020001
1561,2020-12-31,613,Value,0,-12440000,42460001,30020001
1561,2021-03-31,613,Value,0,-12440000,42460001,30020001
1561,2021-06-30,613,Value,0,-12440000,42460001,30020001
1561,2021-09-30,613,Value,0,-12440000,42460001,30020001
1561,2021-12-31,613,Value,0,-12440000,42460001,30020001
1563,2020-03-31,915,Value,0,-10000000,10340000,340000
1563,2020-06-30,915,Value,0,-10000000,10340000,340000
1563,2020-09-30,915,Value,0,-10000000,10340000,340000
1563,2020-12-31,915,Value,0,-10000000,10340000,340000
1563,2021-03-31,915,Value,0,-10000000,10340000,340000
1563,2021-06-30,915,Value,0,-10000000,10340000,340000
1563,2021-09-30,915,Value,0,-10000000,10340000,340000
1563,2021-12-31,915,Value,0,-10000000,10340000,340000
1564,2020-03-31,616,Value,0,-10000000,23280002,13280002
1564,2020-06-30,616,Value,0,-10000000,23280002,13280002
1564,2020-09-30,616,Value,0,-10000000,23280002,13280002
1564,2020-12-31,616,Value,0,-10000000,23280002,13280002
1564,2021-03-31,616,Value,0,-10000000,23280002,13280002
1564,2021-06-30,616,Value,0,-10000000,23280002,13280002
1564,2021-09-30,616,Value,0,-10000000,23280002,13280002
1564,2021-12-31,616,Value,0,-10000000,23280002,13280002
1566,2020-03-31,617,Value,0,-10000000,14600000,4600000
1566,2020-06-30,617,Value,0,-10000000,14600000,4600000
1566,2020-09-30,617,Value,0,-10000000,14600000,4600000
1566,2020-12-31,617,Value,0,-10000000,14600000,4600000
1566,2021-03-31,617,Value,0,-10000000,14600000,4600000
1566,2021-06-30,617,Value,0,-10000000,14600000,4600000
1566,2021-09-30,617,Value,0,-10000000,14600000,4600000
1566,2021-12-31,617,Value,0,-10000000,14600000,4600000
1571,2020-03-31,622,Value,0,-10111838,14298119,4186281
1571,2020-06-30,622,Value,0,-10111838,14298119,4186281
1571,2020-09-30,622,Value,0,-10111838,14298119,4186281
1571,2020-12-31,622,Value,0,-10111838,14298119,4186281
1571,2021-03-31,622,Value,0,-10111838,14298119,4186281
1571,2021-06-30,622,Value,0,-10111838,14298119,4186281
1571,2021-09-30,622,Value,0,-10111838,14298119,4186281
1571,2021-12-31,622,Value,0,-10111838,14298119,4186281
1572,2020-03-31,622,Value,0,-10966665,13000000,2033335
1572,2020-06-30,622,Value,0,-10966665,13000000,2033335
1572,2020-09-30,622,Value,0,-10966665,13000000,2033335
1572,2020-12-31,622,Value,0,-10966665,13000000,2033335
1572,2021-03-31,622,Value,0,-10966665,13000000,2033335
1572,2021-06-30,622,Value,0,-10966665,13000000,2033335
1572,2021-09-30,622,Value,0,-10966665,13000000,2033335
1572,2021-12-31,622,Value,0,-10966665,13000000,2033335
1580,2020-03-31,626,Value,0,-9512000,13154145,3642145
1580,2020-06-30,626,Value,0,-9512000,13154145,3642145
1580,2020-09-30,626,Value,0,-9512000,13154145,3642145
1580,2020-12-31,626,Value,0,-9512000,13154145,3642145
1580,2021-03-31,626,Value,0,-9512000,13154145,3642145
1580,2021-06-30,626,Value,0,-9512000,13154145,3642145
1580,2021-09-30,626,Value,0,-9512000,13154145,3642145
1580,2021-12-31,626,Value,0,-9512000,13154145,3642145
1583,2020-03-31,628,Value,0,-9800000,8318433,-1481567
1583,2020-06-30,628,Value,0,-9800000,8318433,-1481567
1583,2020-09-30,628,Value,0,-9800000,8318433,-1481567
1583,2020-12-31,628,Value,0,-9800000,8318433,-1481567
1583,2021-03-31,628,Value,0,-9800000,8318433,-1481567
1583,2021-06-30,628,Value,0,-9800000,8318433,-1481567
1583,2021-09-30,628,Value,0,-9800000,8318433,-1481567
1583,2021-12-31,628,Value,0,-9800000,8318433,-1481567
1584,2020-03-31,628,Value,72330,-9700000,13837120,4137120
1584,2020-06-30,628,Value,64710,-9700000,13837120,4137120
1584,2020-09-30,628,Value,61610,-9700000,13837120,4137120
1584,2020-11-15,628,Distribution,61378,-9700000,13898498,4198498
1584,2020-12-31,628,Value,0,-9700000,13898498,4198498
1584,2021-06-30,628,Value,0,-9700000,13898498,4198498
1584,2021-09-30,628,Value,0,-9700000,13898498,4198498
1584,2021-12-31,628,Value,0,-9700000,13898498,4198498
1590,2020-03-31,632,Value,0,-9999999,14895067,4895068
1590,2020-06-30,632,Value,0,-9999999,14895067,4895068
1590,2020-09-30,632,Value,0,-9999999,14895067,4895068
1590,2020-12-31,632,Value,0,-9999999,14895067,4895068
1590,2021-03-31,632,Value,0,-9999999,14895067,4895068
1590,2021-06-30,632,Value,0,-9999999,14895067,4895068
1590,2021-09-30,632,Value,0,-9999999,14895067,4895068
1590,2021-12-31,632,Value,0,-9999999,14895067,4895068
1593,2021-12-31,632,Value,0,-8715349,11739210,3023861
1602,2020-03-31,637,Value,0,-10000000,8478486,-1521514
1602,2020-06-30,637,Value,0,-10000000,8478486,-1521514
1602,2020-09-30,637,Value,0,-10000000,8478486,-1521514
1602,2020-12-31,637,Value,0,-10000000,8478486,-1521514
1602,2021-03-31,637,Value,0,-10000000,8478486,-1521514
1602,2021-06-30,637,Value,0,-10000000,8478486,-1521514
1602,2021-09-30,637,Value,0,-10000000,8478486,-1521514
1602,2021-12-31,637,Value,0,-10000000,8478486,-1521514
1604,2020-03-31,639,Value,0,-9759797,17577256,7817459
1604,2020-06-30,639,Value,0,-9759797,17577256,7817459
1604,2020-09-30,639,Value,0,-9759797,17577256,7817459
1604,2020-12-31,639,Value,0,-9759797,17577256,7817459
1604,2021-03-31,639,Value,0,-9759797,17577256,7817459
1604,2021-06-30,639,Value,0,-9759797,17577256,7817459
1604,2021-09-30,639,Value,0,-9759797,17577256,7817459
1604,2021-12-31,639,Value,0,-9759797,17577256,7817459
1605,2021-12-31,639,Value,0,-11041183,9293043,-1748140
1609,2020-03-31,643,Value,531570,-13630000,17566343,3936343
1609,2020-06-30,643,Value,531570,-13630000,17566343,3936343
1609,2020-09-30,643,Value,531570,-13630000,17566343,3936343
1609,2020-12-31,643,Value,531570,-13630000,17566343,3936343
1609,2021-03-31,643,Value,531570,-13630000,17566343,3936343
1609,2021-06-30,643,Value,531570,-13630000,17566343,3936343
1609,2021-09-30,643,Value,531570,-13630000,17566343,3936343
1609,2021-12-31,643,Value,531570,-13630000,17566343,3936343
1624,2020-03-31,652,Value,0,-10000000,12744000,2744000
1624,2020-06-30,652,Value,0,-10000000,12744000,2744000
1624,2020-09-30,652,Value,0,-10000000,12744000,2744000
1624,2020-12-31,652,Value,0,-10000000,12744000,2744000
1624,2021-03-31,652,Value,0,-10000000,12744000,2744000
1624,2021-06-30,652,Value,0,-10000000,12744000,2744000
1624,2021-09-30,652,Value,0,-10000000,12744000,2744000
1624,2021-12-31,652,Value,0,-10000000,12744000,2744000
1625,2020-03-31,652,Value,0,-10000000,14124476,4124476
1625,2020-06-30,652,Value,0,-10000000,14124476,4124476
1625,2020-09-30,652,Value,0,-10000000,14124476,4124476
1625,2020-12-31,652,Value,0,-10000000,14124476,4124476
1625,2021-03-31,652,Value,0,-10000000,14124476,4124476
1625,2021-06-30,652,Value,0,-10000000,14124476,4124476
1625,2021-09-30,652,Value,0,-10000000,14124476,4124476
1625,2021-12-31,652,Value,0,-10000000,14124476,4124476
1633,2020-03-31,589,Value,0,-10000000,29600001,19600001
1633,2020-06-30,589,Value,0,-10000000,29600001,19600001
1633,2020-09-30,589,Value,0,-10000000,29600001,19600001
1633,2020-12-31,589,Value,0,-10000000,29600001,19600001
1633,2021-03-31,589,Value,0,-10000000,29600001,19600001
1633,2021-06-30,589,Value,0,-10000000,29600001,19600001
1633,2021-09-30,589,Value,0,-10000000,29600001,19600001
1633,2021-12-31,589,Value,0,-10000000,29600001,19600001
1638,2020-02-15,5937,Distribution,48691,-10000000,13384769,3384769
1638,2020-03-31,5937,Value,0,-10000000,13384769,3384769
1638,2020-12-31,5937,Value,0,-10000000,13384769,3384769
1638,2021-03-31,5937,Value,0,-10000000,13384769,3384769
1638,2021-06-30,5937,Value,0,-10000000,13384769,3384769
1638,2021-09-30,5937,Value,0,-10000000,13384769,3384769
1638,2021-12-31,5937,Value,0,-10000000,13384769,3384769
1639,2020-03-31,5937,Value,1125760,-10000000,13428440,3428440
1639,2020-06-30,5937,Value,1094380,-10000000,13428440,3428440
1639,2020-09-30,5937,Value,1186340,-10000000,13428440,3428440
1639,2020-12-31,5937,Value,1396710,-10000000,13428440,3428440
1639,2021-03-31,5937,Value,1419590,-10000000,13428440,3428440
1639,2021-06-30,5937,Value,1371520,-10000000,13428440,3428440
1641,2020-03-31,658,Value,0,-10009438,6921306,-3088132
1641,2020-06-30,658,Value,0,-10009438,6921306,-3088132
1641,2020-09-30,658,Value,0,-10009438,6921306,-3088132
1641,2020-12-31,658,Value,0,-10009438,6921306,-3088132
1641,2021-03-31,658,Value,0,-10009438,6921306,-3088132
1641,2021-06-30,658,Value,0,-10009438,6921306,-3088132
1641,2021-09-30,658,Value,0,-10009438,6921306,-3088132
1641,2021-12-31,658,Value,0,-10009438,6921306,-3088132
1645,2020-03-31,660,Value,0,-9539999,21369600,11829601
1645,2020-06-30,660,Value,0,-9539999,21369600,11829601
1645,2020-09-30,660,Value,0,-9539999,21369600,11829601
1645,2020-12-31,660,Value,0,-9539999,21369600,11829601
1645,2021-03-31,660,Value,0,-9539999,21369600,11829601
1645,2021-06-30,660,Value,0,-9539999,21369600,11829601
1645,2021-09-30,660,Value,0,-9539999,21369600,11829601
1645,2021-12-31,660,Value,0,-9539999,21369600,11829601
1652,2020-03-31,663,Value,0,-9500001,5057030,-4442971
1652,2020-06-30,663,Value,0,-9500001,5057030,-4442971
1652,2020-09-30,663,Value,0,-9500001,5057030,-4442971
1652,2020-12-31,663,Value,0,-9500001,5057030,-4442971
1652,2021-03-31,663,Value,0,-9500001,5057030,-4442971
1652,2021-06-30,663,Value,0,-9500001,5057030,-4442971
1652,2021-09-30,663,Value,0,-9500001,5057030,-4442971
1652,2021-12-31,663,Value,0,-9500001,5057030,-4442971
1653,2020-03-31,663,Value,0,-10000000,14289310,4289310
1653,2020-06-30,663,Value,0,-10000000,14289310,4289310
1653,2020-09-30,663,Value,0,-10000000,14289310,4289310
1653,2020-12-31,663,Value,0,-10000000,14289310,4289310
1653,2021-03-31,663,Value,0,-10000000,14289310,4289310
1653,2021-06-30,663,Value,0,-10000000,14289310,4289310
1653,2021-09-30,663,Value,0,-10000000,14289310,4289310
1653,2021-12-31,663,Value,0,-10000000,14289310,4289310
1663,2020-03-31,666,Value,0,-10064095,102498740,92434645
1663,2020-06-30,666,Value,0,-10064095,102498740,92434645
1663,2020-09-30,666,Value,0,-10064095,102498740,92434645
1663,2020-12-31,666,Value,0,-10064095,102498740,92434645
1663,2021-03-31,666,Value,0,-10064095,102498740,92434645
1663,2021-06-30,666,Value,0,-10064095,102498740,92434645
1663,2021-09-30,666,Value,0,-10064095,102498740,92434645
1663,2021-12-31,666,Value,0,-10064095,102498740,92434645
1664,2020-03-31,666,Value,0,-10029497,11068441,1038944
1664,2020-06-30,666,Value,0,-10029497,11068441,1038944
1664,2020-09-30,666,Value,0,-10029497,11068441,1038944
1664,2020-12-31,666,Value,0,-10029497,11068441,1038944
1664,2021-03-31,666,Value,0,-10029497,11068441,1038944
1664,2021-06-30,666,Value,0,-10029497,11068441,1038944
1664,2021-09-30,666,Value,0,-10029497,11068441,1038944
1664,2021-12-31,666,Value,0,-10029497,11068441,1038944
1665,2020-03-31,666,Value,0,-10000000,18400000,8400000
1665,2020-06-30,666,Value,0,-10000000,18400000,8400000
1665,2020-09-30,666,Value,0,-10000000,18400000,8400000
1665,2020-12-31,666,Value,0,-10000000,18400000,8400000
1665,2021-03-31,666,Value,0,-10000000,18400000,8400000
1665,2021-06-30,666,Value,0,-10000000,18400000,8400000
1665,2021-09-30,666,Value,0,-10000000,18400000,8400000
1665,2021-12-31,666,Value,0,-10000000,18400000,8400000
1666,2020-03-31,666,Value,0,-9900000,2100001,-7799999
1666,2020-06-30,666,Value,0,-9900000,2100001,-7799999
1666,2020-09-30,666,Value,0,-9900000,2100001,-7799999
1666,2020-12-31,666,Value,0,-9900000,2100001,-7799999
1666,2021-03-31,666,Value,0,-9900000,2100001,-7799999
1666,2021-06-30,666,Value,0,-9900000,2100001,-7799999
1666,2021-09-30,666,Value,0,-9900000,2100001,-7799999
1666,2021-12-31,666,Value,0,-9900000,2100001,-7799999
1667,2020-03-31,666,Value,46050,-9850000,11336210,1486210
1667,2020-06-30,666,Value,45990,-9850000,11336210,1486210
1667,2020-09-30,666,Value,57240,-9850000,11336210,1486210
1667,2020-11-15,666,Distribution,57246,-9850000,11393456,1543456
1667,2020-12-31,666,Value,0,-9850000,11393456,1543456
1667,2021-06-30,666,Value,0,-9850000,11393456,1543456
1667,2021-09-30,666,Value,0,-9850000,11393456,1543456
1667,2021-12-31,666,Value,0,-9850000,11393456,1543456
1674,2020-03-31,670,Value,0,-10000000,42534843,32534843
1674,2020-06-30,670,Value,0,-10000000,42534843,32534843
1674,2020-09-30,670,Value,0,-10000000,42534843,32534843
1674,2020-12-31,670,Value,0,-10000000,42534843,32534843
1674,2021-03-31,670,Value,0,-10000000,42534843,32534843
1674,2021-06-30,670,Value,0,-10000000,42534843,32534843
1674,2021-09-30,670,Value,0,-10000000,42534843,32534843
1674,2021-12-31,670,Value,0,-10000000,42534843,32534843
1677,2020-03-31,670,Value,7620,-10000002,7818254,-2181748
1677,2020-06-30,670,Value,7760,-10000002,7818254,-2181748
1677,2020-08-15,670,Distribution,7437,-10000002,7825691,-2174311
1677,2020-09-30,670,Value,0,-10000002,7825691,-2174311
1677,2021-03-31,670,Value,0,-10000002,7825691,-2174311
1677,2021-06-30,670,Value,0,-10000002,7825691,-2174311
1677,2021-09-30,670,Value,0,-10000002,7825691,-2174311
1677,2021-12-31,670,Value,0,-10000002,7825691,-2174311
1681,2020-03-31,674,Value,0,-10486673,23018913,12532240
1681,2020-06-30,674,Value,0,-10486673,23018913,12532240
1681,2020-09-30,674,Value,0,-10486673,23018913,12532240
1681,2020-12-31,674,Value,0,-10486673,23018913,12532240
1681,2021-12-31,674,Value,0,-10486673,23018913,12532240
1684,2020-08-31,49,Value,0,-9089831,10400041,1310210
1684,2020-11-30,49,Value,0,-9089831,10400041,1310210
1684,2021-02-28,49,Value,0,-9089831,10400041,1310210
1684,2021-08-31,49,Value,0,-9089831,10400041,1310210
1684,2021-10-16,49,Distribution,0,-9089831,10400041,1310210
1684,2021-12-31,49,Value,0,-9089831,10400041,1310210
1687,2021-12-31,678,Value,0,-9320000,1520000,-7800000
1716,2020-03-31,689,Value,0,-9995275,5342475,-4652800
1716,2020-06-30,689,Value,0,-9995275,5342475,-4652800
1716,2020-09-30,689,Value,0,-9995275,5342475,-4652800
1716,2020-12-31,689,Value,0,-9995275,5342475,-4652800
1716,2021-03-31,689,Value,0,-9995275,5342475,-4652800
1716,2021-06-30,689,Value,0,-9995275,5342475,-4652800
1716,2021-09-30,689,Value,0,-9995275,5342475,-4652800
1716,2021-12-31,689,Value,0,-9995275,5342475,-4652800
1726,2020-03-31,690,Value,0,-9700000,12945577,3245577
1726,2020-06-30,690,Value,0,-9700000,12945577,3245577
1726,2020-09-30,690,Value,0,-9700000,12945577,3245577
1726,2020-12-31,690,Value,0,-9700000,12945577,3245577
1726,2021-03-31,690,Value,0,-9700000,12945577,3245577
1726,2021-06-30,690,Value,0,-9700000,12945577,3245577
1726,2021-09-30,690,Value,0,-9700000,12945577,3245577
1726,2021-12-31,690,Value,0,-9700000,12945577,3245577
1730,2020-03-31,696,Value,0,-10015963,14232001,4216038
1730,2020-06-30,696,Value,0,-10015963,14232001,4216038
1730,2020-09-30,696,Value,0,-10015963,14232001,4216038
1730,2020-12-31,696,Value,0,-10015963,14232001,4216038
1730,2021-03-31,696,Value,0,-10015963,14232001,4216038
1730,2021-06-30,696,Value,0,-10015963,14232001,4216038
1730,2021-12-31,696,Value,0,-10015963,14232001,4216038
1731,2020-03-31,696,Value,0,-10000000,21403000,11403000
1731,2020-06-30,696,Value,0,-10000000,21403000,11403000
1731,2020-09-30,696,Value,0,-10000000,21403000,11403000
1731,2020-12-31,696,Value,0,-10000000,21403000,11403000
1731,2021-03-31,696,Value,0,-10000000,21403000,11403000
1731,2021-06-30,696,Value,0,-10000000,21403000,11403000
1731,2021-09-30,696,Value,0,-10000000,21403000,11403000
1731,2021-12-31,696,Value,0,-10000000,21403000,11403000
1732,2020-03-31,696,Value,0,-10000000,26691637,16691637
1732,2020-06-30,696,Value,0,-10000000,26691637,16691637
1732,2020-09-30,696,Value,0,-10000000,26691637,16691637
1732,2020-12-31,696,Value,0,-10000000,26691637,16691637
1732,2021-03-31,696,Value,0,-10000000,26691637,16691637
1732,2021-06-30,696,Value,0,-10000000,26691637,16691637
1732,2021-09-30,696,Value,0,-10000000,26691637,16691637
1732,2021-12-31,696,Value,0,-10000000,26691637,16691637
1733,2020-03-31,696,Value,0,-10000000,9441260,-558740
1733,2020-06-30,696,Value,0,-10000000,9441260,-558740
1733,2020-09-30,696,Value,0,-10000000,9441260,-558740
1733,2020-12-31,696,Value,0,-10000000,9441260,-558740
1733,2021-03-31,696,Value,0,-10000000,9441260,-558740
1733,2021-06-30,696,Value,0,-10000000,9441260,-558740
1733,2021-09-30,696,Value,0,-10000000,9441260,-558740
1733,2021-12-31,696,Value,0,-10000000,9441260,-558740
1734,2020-03-31,696,Value,0,-10000000,18750000,8750000
1734,2020-06-30,696,Value,0,-10000000,18750000,8750000
1734,2020-09-30,696,Value,0,-10000000,18750000,8750000
1734,2020-12-31,696,Value,0,-10000000,18750000,8750000
1734,2021-03-31,696,Value,0,-10000000,18750000,8750000
1734,2021-06-30,696,Value,0,-10000000,18750000,8750000
1734,2021-09-30,696,Value,0,-10000000,18750000,8750000
1734,2021-12-31,696,Value,0,-10000000,18750000,8750000
1735,2020-03-31,696,Value,0,-10000000,19792937,9792937
1735,2020-06-30,696,Value,0,-10000000,19792937,9792937
1735,2020-09-30,696,Value,0,-10000000,19792937,9792937
1735,2020-12-31,696,Value,0,-10000000,19792937,9792937
1735,2021-03-31,696,Value,0,-10000000,19792937,9792937
1735,2021-06-30,696,Value,0,-10000000,19792937,9792937
1735,2021-09-30,696,Value,0,-10000000,19792937,9792937
1735,2021-12-31,696,Value,0,-10000000,19792937,9792937
1744,2020-03-31,705,Value,0,-11040000,9720000,-1320000
1744,2020-06-30,705,Value,0,-11040000,9720000,-1320000
1744,2020-09-30,705,Value,0,-11040000,9720000,-1320000
1744,2020-12-31,705,Value,0,-11040000,9720000,-1320000
1744,2021-03-31,705,Value,0,-11040000,9720000,-1320000
1744,2021-06-30,705,Value,0,-11040000,9720000,-1320000
1744,2021-09-30,705,Value,0,-11040000,9720000,-1320000
1744,2021-12-31,705,Value,0,-11040000,9720000,-1320000
1747,2020-02-15,710,Distribution,406060,-9450000,16972913,7522913
1747,2020-03-31,710,Value,0,-9450000,16972913,7522913
1747,2020-09-30,710,Value,0,-9450000,16972913,7522913
1747,2020-12-31,710,Value,0,-9450000,16972913,7522913
1747,2021-03-31,710,Value,0,-9450000,16972913,7522913
1747,2021-06-30,710,Value,0,-9450000,16972913,7522913
1747,2021-09-30,710,Value,0,-9450000,16972913,7522913
1747,2021-12-31,710,Value,0,-9450000,16972913,7522913
1752,2020-03-31,710,Value,0,-9000000,32504399,23504399
1752,2020-06-30,710,Value,0,-9000000,32504399,23504399
1752,2020-09-30,710,Value,0,-9000000,32504399,23504399
1752,2020-12-31,710,Value,0,-9000000,32504399,23504399
1752,2021-03-31,710,Value,0,-9000000,32504399,23504399
1752,2021-06-30,710,Value,0,-9000000,32504399,23504399
1752,2021-09-30,710,Value,0,-9000000,32504399,23504399
1752,2021-12-31,710,Value,0,-9000000,32504399,23504399
1753,2020-03-31,710,Value,0,-9699999,74099661,64399662
1753,2020-06-30,710,Value,0,-9699999,74099661,64399662
1753,2020-09-30,710,Value,0,-9699999,74099661,64399662
1753,2020-12-31,710,Value,0,-9699999,74099661,64399662
1753,2021-03-31,710,Value,0,-9699999,74099661,64399662
1753,2021-06-30,710,Value,0,-9699999,74099661,64399662
1753,2021-09-30,710,Value,0,-9699999,74099661,64399662
1753,2021-12-31,710,Value,0,-9699999,74099661,64399662
1754,2020-03-31,710,Value,0,-9650000,13288165,3638165
1754,2020-06-30,710,Value,0,-9650000,13288165,3638165
1754,2020-09-30,710,Value,0,-9650000,13288165,3638165
1754,2020-12-31,710,Value,0,-9650000,13288165,3638165
1754,2021-03-31,710,Value,0,-9650000,13288165,3638165
1754,2021-06-30,710,Value,0,-9650000,13288165,3638165
1754,2021-09-30,710,Value,0,-9650000,13288165,3638165
1754,2021-12-31,710,Value,0,-9650000,13288165,3638165
1755,2020-03-31,710,Value,144000,-10000000,21562665,11562665
1755,2020-06-30,710,Value,144000,-10000000,21562665,11562665
1755,2020-09-30,710,Value,144000,-10000000,21562665,11562665
1755,2020-12-31,710,Value,148000,-10000000,21562665,11562665
1755,2021-02-14,710,Distribution,70667,-10000000,21633332,11633332
1755,2021-03-31,710,Value,78660,-10000000,21633332,11633332
1755,2021-06-30,710,Value,78660,-10000000,21633332,11633332
1759,2021-12-31,712,Value,0,-9863876,2916314,-6947562
1771,2020-03-31,733,Value,0,-9839575,30160429,20320854
1771,2020-06-30,733,Value,0,-9839575,30160429,20320854
1771,2020-09-30,733,Value,0,-9839575,30160429,20320854
1771,2020-12-31,733,Value,0,-9839575,30160429,20320854
1771,2021-03-31,733,Value,0,-9839575,30160429,20320854
1771,2021-06-30,733,Value,0,-9839575,30160429,20320854
1771,2021-09-30,733,Value,0,-9839575,30160429,20320854
1771,2021-12-31,733,Value,0,-9839575,30160429,20320854
1773,2020-03-31,718,Value,0,-9700000,23489334,13789334
1773,2020-06-30,718,Value,0,-9700000,23489334,13789334
1773,2020-09-30,718,Value,0,-9700000,23489334,13789334
1773,2020-12-31,718,Value,0,-9700000,23489334,13789334
1773,2021-03-31,718,Value,0,-9700000,23489334,13789334
1773,2021-06-30,718,Value,0,-9700000,23489334,13789334
1773,2021-09-30,718,Value,0,-9700000,23489334,13789334
1773,2021-12-31,718,Value,0,-9700000,23489334,13789334
1775,2020-03-31,718,Value,0,-9799998,22385687,12585689
1775,2020-06-30,718,Value,0,-9799998,22385687,12585689
1775,2020-09-30,718,Value,0,-9799998,22385687,12585689
1775,2020-12-31,718,Value,0,-9799998,22385687,12585689
1775,2021-03-31,718,Value,0,-9799998,22385687,12585689
1775,2021-06-30,718,Value,0,-9799998,22385687,12585689
1775,2021-09-30,718,Value,0,-9799998,22385687,12585689
1775,2021-12-31,718,Value,0,-9799998,22385687,12585689
1781,2020-03-31,722,Value,0,-11638553,2951909,-8686644
1781,2020-06-30,722,Value,0,-11638553,2951909,-8686644
1781,2020-09-30,722,Value,0,-11638553,2951909,-8686644
1781,2020-12-31,722,Value,0,-11638553,2951909,-8686644
1781,2021-03-31,722,Value,0,-11638553,2951909,-8686644
1781,2021-06-30,722,Value,0,-11638553,2951909,-8686644
1781,2021-09-30,722,Value,0,-11638553,2951909,-8686644
1781,2021-12-31,722,Value,0,-11638553,2951909,-8686644
1783,2021-12-31,722,Value,0,-10000000,12463298,2463298
1784,2020-03-31,722,Value,0,-9776256,13116410,3340154
1784,2020-06-30,722,Value,0,-9776256,13116410,3340154
1784,2020-09-30,722,Value,0,-9776256,13116410,3340154
1784,2020-12-31,722,Value,0,-9776256,13116410,3340154
1784,2021-03-31,722,Value,0,-9776256,13116410,3340154
1784,2021-06-30,722,Value,0,-9776256,13116410,3340154
1784,2021-09-30,722,Value,0,-9776256,13116410,3340154
1784,2021-12-31,722,Value,0,-9776256,13116410,3340154
1790,2020-03-31,722,Value,0,-10000000,12906691,2906691
1790,2020-06-30,722,Value,0,-10000000,12906691,2906691
1790,2020-09-30,722,Value,0,-10000000,12906691,2906691
1790,2020-12-31,722,Value,0,-10000000,12906691,2906691
1790,2021-03-31,722,Value,0,-10000000,12906691,2906691
1790,2021-06-30,722,Value,0,-10000000,12906691,2906691
1790,2021-09-30,722,Value,0,-10000000,12906691,2906691
1790,2021-12-31,722,Value,0,-10000000,12906691,2906691
1791,2020-03-31,722,Value,0,-10000000,15959999,5959999
1791,2020-06-30,722,Value,0,-10000000,15959999,5959999
1791,2020-09-30,722,Value,0,-10000000,15959999,5959999
1791,2020-12-31,722,Value,0,-10000000,15959999,5959999
1791,2021-03-31,722,Value,0,-10000000,15959999,5959999
1791,2021-06-30,722,Value,0,-10000000,15959999,5959999
1791,2021-09-30,722,Value,0,-10000000,15959999,5959999
1791,2021-12-31,722,Value,0,-10000000,15959999,5959999
1796,2020-03-31,725,Value,0,-11199999,14560000,3360001
1796,2020-06-30,725,Value,0,-11199999,14560000,3360001
1796,2020-09-30,725,Value,0,-11199999,14560000,3360001
1796,2020-12-31,725,Value,0,-11199999,14560000,3360001
1796,2021-03-31,725,Value,0,-11199999,14560000,3360001
1796,2021-06-30,725,Value,0,-11199999,14560000,3360001
1796,2021-09-30,725,Value,0,-11199999,14560000,3360001
1796,2021-11-15,725,Capital Call,1200000,-9999999,14560000,4560001
1796,2021-12-31,725,Value,0,-9999999,14560000,4560001
1797,2021-12-31,725,Value,0,-9760001,15711858,5951857
1800,2021-12-31,750,Value,0,-10000000,13359201,3359201
1801,2021-12-31,750,Value,0,-10000000,5743909,-4256091
1802,2021-12-31,750,Value,0,-10000000,4077000,-5923000
1803,2020-03-31,726,Value,0,-10000000,13899021,3899021
1803,2020-06-30,726,Value,0,-10000000,13899021,3899021
1803,2020-09-30,726,Value,0,-10000000,13899021,3899021
1803,2020-12-31,726,Value,0,-10000000,13899021,3899021
1803,2021-03-31,726,Value,0,-10000000,13899021,3899021
1803,2021-06-30,726,Value,0,-10000000,13899021,3899021
1803,2021-09-30,726,Value,0,-10000000,13899021,3899021
1803,2021-12-31,726,Value,0,-10000000,13899021,3899021
1804,2020-03-31,726,Value,0,-12154937,6341741,-5813196
1804,2020-06-30,726,Value,0,-12154937,6341741,-5813196
1804,2020-09-30,726,Value,0,-12154937,6341741,-5813196
1804,2020-12-31,726,Value,0,-12154937,6341741,-5813196
1804,2021-03-31,726,Value,0,-12154937,6341741,-5813196
1804,2021-06-30,726,Value,0,-12154937,6341741,-5813196
1804,2021-09-30,726,Value,0,-12154937,6341741,-5813196
1804,2021-12-31,726,Value,0,-12154937,6341741,-5813196
1805,2020-09-30,726,Value,0,-10000000,3833333,-6166667
1805,2020-12-31,726,Value,0,-10000000,3833333,-6166667
1805,2021-03-31,726,Value,0,-10000000,3833333,-6166667
1805,2021-06-30,726,Value,0,-10000000,3833333,-6166667
1805,2021-09-30,726,Value,0,-10000000,3833333,-6166667
1805,2021-12-31,726,Value,0,-10000000,3833333,-6166667
1811,2020-03-31,1627,Value,0,-10000000,581239,-9418761
1811,2020-06-30,1627,Value,0,-10000000,581239,-9418761
1811,2020-09-30,1627,Value,0,-10000000,581239,-9418761
1811,2020-12-31,1627,Value,0,-10000000,581239,-9418761
1811,2021-03-31,1627,Value,0,-10000000,581239,-9418761
1811,2021-06-30,1627,Value,0,-10000000,581239,-9418761
1811,2021-09-30,1627,Value,0,-10000000,581239,-9418761
1811,2021-12-31,1627,Value,0,-10000000,581239,-9418761
1812,2020-03-31,1627,Value,0,-9176471,973603,-8202868
1812,2020-06-30,1627,Value,0,-9176471,973603,-8202868
1812,2020-09-30,1627,Value,0,-9176471,973603,-8202868
1812,2020-12-31,1627,Value,0,-9176471,973603,-8202868
1812,2021-03-31,1627,Value,0,-9176471,973603,-8202868
1812,2021-06-30,1627,Value,0,-9176471,973603,-8202868
1812,2021-09-30,1627,Value,0,-9176471,973603,-8202868
1812,2021-12-31,1627,Value,0,-9176471,973603,-8202868
1814,2020-03-31,1628,Value,0,-8997000,22875772,13878772
1814,2020-06-30,1628,Value,0,-8997000,22875772,13878772
1814,2020-09-30,1628,Value,0,-8997000,22875772,13878772
1814,2020-12-31,1628,Value,0,-8997000,22875772,13878772
1814,2021-03-31,1628,Value,0,-8997000,22875772,13878772
1814,2021-06-30,1628,Value,0,-8997000,22875772,13878772
1814,2021-09-30,1628,Value,0,-8997000,22875772,13878772
1814,2021-12-31,1628,Value,0,-8997000,22875772,13878772
1815,2020-03-31,1628,Value,0,-6338000,3973927,-2364073
1815,2020-06-30,1628,Value,0,-6338000,3973927,-2364073
1815,2020-09-30,1628,Value,0,-6338000,3973927,-2364073
1815,2020-12-31,1628,Value,0,-6338000,3973927,-2364073
1815,2021-03-31,1628,Value,0,-6338000,3973927,-2364073
1815,2021-06-30,1628,Value,0,-6338000,3973927,-2364073
1815,2021-09-30,1628,Value,0,-6338000,3973927,-2364073
1815,2021-12-31,1628,Value,0,-6338000,3973927,-2364073
1817,2020-03-31,733,Value,0,-10260000,36217800,25957800
1817,2020-06-30,733,Value,0,-10260000,36217800,25957800
1817,2020-09-30,733,Value,0,-10260000,36217800,25957800
1817,2020-12-31,733,Value,0,-10260000,36217800,25957800
1817,2021-03-31,733,Value,0,-10260000,36217800,25957800
1817,2021-06-30,733,Value,0,-10260000,36217800,25957800
1817,2021-09-30,733,Value,0,-10260000,36217800,25957800
1817,2021-12-31,733,Value,0,-10260000,36217800,25957800
1818,2020-03-31,733,Value,0,-10910003,18547003,7637000
1818,2020-06-30,733,Value,0,-10910003,18547003,7637000
1818,2020-09-30,733,Value,0,-10910003,18547003,7637000
1818,2020-12-31,733,Value,0,-10910003,18547003,7637000
1818,2021-03-31,733,Value,0,-10910003,18547003,7637000
1818,2021-06-30,733,Value,0,-10910003,18547003,7637000
1818,2021-09-30,733,Value,0,-10910003,18547003,7637000
1818,2021-12-31,733,Value,0,-10910003,18547003,7637000
1819,2020-03-31,733,Value,13350,-9593396,23235490,13642094
1819,2020-06-30,733,Value,13210,-9593396,23235490,13642094
1819,2020-09-30,733,Value,13020,-9593396,23235490,13642094
1819,2020-11-15,733,Distribution,13137,-9593396,23248627,13655231
1819,2020-12-31,733,Value,0,-9593396,23248627,13655231
1819,2021-12-31,733,Value,0,-9593396,23248627,13655231
1823,2020-03-31,469,Value,0,-8654113,20271421,11617308
1823,2020-06-30,469,Value,0,-8654113,20271421,11617308
1823,2020-09-30,469,Value,0,-8654113,20271421,11617308
1823,2020-12-31,469,Value,0,-8654113,20271421,11617308
1823,2021-03-31,469,Value,0,-8654113,20271421,11617308
1823,2021-06-30,469,Value,0,-8654113,20271421,11617308
1823,2021-09-30,469,Value,0,-8654113,20271421,11617308
1823,2021-12-31,469,Value,0,-8654113,20271421,11617308
1827,2020-03-31,416,Value,0,-10175334,24794666,14619332
1827,2020-06-30,416,Value,0,-10175334,24794666,14619332
1827,2020-09-30,416,Value,0,-10175334,24794666,14619332
1827,2020-12-31,416,Value,0,-10175334,24794666,14619332
1827,2021-03-31,416,Value,0,-10175334,24794666,14619332
1827,2021-06-30,416,Value,0,-10175334,24794666,14619332
1827,2021-12-31,416,Value,0,-10175334,24794666,14619332
1828,2020-03-31,1632,Value,0,-9690000,9990390,300390
1828,2020-06-30,1632,Value,0,-9690000,9990390,300390
1828,2020-09-30,1632,Value,0,-9690000,9990390,300390
1828,2020-12-31,1632,Value,0,-9690000,9990390,300390
1828,2021-03-31,1632,Value,0,-9690000,9990390,300390
1828,2021-06-30,1632,Value,0,-9690000,9990390,300390
1828,2021-09-30,1632,Value,0,-9690000,9990390,300390
1828,2021-12-31,1632,Value,0,-9690000,9990390,300390
1829,2020-03-31,1632,Value,80000,-10000000,21408997,11408997
1829,2020-06-30,1632,Value,79000,-10000000,21408997,11408997
1829,2020-09-30,1632,Value,48000,-10000000,21408997,11408997
1829,2020-12-31,1632,Value,77000,-10000000,21408997,11408997
1829,2021-03-31,1632,Value,76000,-10000000,21408997,11408997
1829,2021-06-30,1632,Value,76000,-10000000,21408997,11408997
1829,2021-09-30,1632,Value,75000,-10000000,21408997,11408997
1832,2021-12-31,743,Value,0,-7735695,14317405,6581710
1833,2020-03-31,743,Value,0,-9021371,7834457,-1186914
1833,2020-06-30,743,Value,0,-9021371,7834457,-1186914
1833,2020-09-30,743,Value,0,-9021371,7834457,-1186914
1833,2020-12-31,743,Value,0,-9021371,7834457,-1186914
1833,2021-03-31,743,Value,0,-9021371,7834457,-1186914
1833,2021-06-30,743,Value,0,-9021371,7834457,-1186914
1833,2021-09-30,743,Value,0,-9021371,7834457,-1186914
1833,2021-12-31,743,Value,0,-9021371,7834457,-1186914
1835,2020-03-31,743,Value,0,-10475999,17551492,7075493
1835,2020-06-30,743,Value,0,-10475999,17551492,7075493
1835,2020-09-30,743,Value,0,-10475999,17551492,7075493
1835,2020-12-31,743,Value,0,-10475999,17551492,7075493
1835,2021-03-31,743,Value,0,-10475999,17551492,7075493
1835,2021-06-30,743,Value,0,-10475999,17551492,7075493
1835,2021-09-30,743,Value,0,-10475999,17551492,7075493
1835,2021-12-31,743,Value,0,-10475999,17551492,7075493
1839,2021-12-31,1637,Value,0,-9750138,8414799,-1335339
1842,2021-12-31,1637,Value,0,-9791413,16026420,6235007
1843,2020-03-31,747,Value,0,-9999998,20282722,10282724
1843,2020-06-30,747,Value,0,-9999998,20282722,10282724
1843,2020-09-30,747,Value,0,-9999998,20282722,10282724
1843,2020-12-31,747,Value,0,-9999998,20282722,10282724
1843,2021-03-31,747,Value,0,-9999998,20282722,10282724
1843,2021-06-30,747,Value,0,-9999998,20282722,10282724
1843,2021-09-30,747,Value,0,-9999998,20282722,10282724
1843,2021-12-31,747,Value,0,-9999998,20282722,10282724
1848,2020-03-31,17285,Value,0,-10141288,12358175,2216887
1848,2020-06-30,17285,Value,0,-10141288,12358175,2216887
1848,2020-09-30,17285,Value,0,-10141288,12358175,2216887
1848,2020-12-31,17285,Value,0,-10141288,12358175,2216887
1848,2021-03-31,17285,Value,0,-10141288,12358175,2216887
1848,2021-06-30,17285,Value,0,-10141288,12358175,2216887
1848,2021-09-30,17285,Value,0,-10141288,12358175,2216887
1848,2021-12-31,17285,Value,0,-10141288,12358175,2216887
1851,2020-02-15,753,Capital Call,149,-13223998,22532143,9308145
1851,2020-02-15,753,Distribution,-789241,-13223998,21742902,8518904
1851,2020-03-31,753,Value,335880,-13223998,21742902,8518904
1851,2020-05-16,753,Distribution,273737,-13223998,22016639,8792641
1851,2020-06-30,753,Value,60830,-13223998,22016639,8792641
1851,2020-09-30,753,Capital Call,-149,-13224147,22016639,8792492
1851,2020-09-30,753,Distribution,723422,-13224147,22740061,9515914
1851,2020-12-31,753,Value,0,-13224147,22740061,9515914
1851,2021-06-30,753,Value,0,-13224147,22740061,9515914
1851,2021-09-30,753,Value,0,-13224147,22740061,9515914
1851,2021-12-31,753,Value,0,-13224147,22740061,9515914
1854,2020-03-31,1642,Value,0,-9900000,8738729,-1161271
1854,2020-06-30,1642,Value,0,-9900000,8738729,-1161271
1854,2020-09-30,1642,Value,0,-9900000,8738729,-1161271
1854,2020-12-31,1642,Value,0,-9900000,8738729,-1161271
1854,2021-03-31,1642,Value,0,-9900000,8738729,-1161271
1854,2021-06-30,1642,Value,0,-9900000,8738729,-1161271
1854,2021-09-30,1642,Value,0,-9900000,8738729,-1161271
1854,2021-12-31,1642,Value,0,-9900000,8738729,-1161271
1855,2020-03-31,1642,Value,0,-10000001,10442789,442788
1855,2020-06-30,1642,Value,0,-10000001,10442789,442788
1855,2020-09-30,1642,Value,0,-10000001,10442789,442788
1855,2020-12-31,1642,Value,0,-10000001,10442789,442788
1855,2021-03-31,1642,Value,0,-10000001,10442789,442788
1855,2021-06-30,1642,Value,0,-10000001,10442789,442788
1855,2021-09-30,1642,Value,0,-10000001,10442789,442788
1855,2021-12-31,1642,Value,0,-10000001,10442789,442788
1858,2020-03-31,1629,Value,0,-11554469,13716050,2161581
1858,2020-06-30,1629,Value,0,-11554469,13716050,2161581
1858,2020-09-30,1629,Value,0,-11554469,13716050,2161581
1858,2020-12-31,1629,Value,0,-11554469,13716050,2161581
1858,2021-03-31,1629,Value,0,-11554469,13716050,2161581
1858,2021-06-30,1629,Value,0,-11554469,13716050,2161581
1858,2021-09-30,1629,Value,0,-11554469,13716050,2161581
1858,2021-12-31,1629,Value,0,-11554469,13716050,2161581
1863,2020-03-31,1427,Value,0,-9675796,6310771,-3365025
1863,2020-06-30,1427,Value,0,-9675796,6310771,-3365025
1863,2020-09-30,1427,Value,0,-9675796,6310771,-3365025
1863,2020-12-31,1427,Value,0,-9675796,6310771,-3365025
1863,2021-03-31,1427,Value,0,-9675796,6310771,-3365025
1863,2021-06-30,1427,Value,0,-9675796,6310771,-3365025
1863,2021-09-30,1427,Value,0,-9675796,6310771,-3365025
1863,2021-12-31,1427,Value,0,-9675796,6310771,-3365025
1864,2020-03-31,1427,Value,0,-10639998,6040001,-4599997
1864,2020-06-30,1427,Value,0,-10639998,6040001,-4599997
1864,2020-09-30,1427,Value,0,-10639998,6040001,-4599997
1864,2020-12-31,1427,Value,0,-10639998,6040001,-4599997
1864,2021-03-31,1427,Value,0,-10639998,6040001,-4599997
1864,2021-06-30,1427,Value,0,-10639998,6040001,-4599997
1864,2021-09-30,1427,Value,0,-10639998,6040001,-4599997
1864,2021-12-31,1427,Value,0,-10639998,6040001,-4599997
1870,2020-03-31,727,Value,0,-10000000,21597499,11597499
1870,2020-06-30,727,Value,0,-10000000,21597499,11597499
1870,2020-09-30,727,Value,0,-10000000,21597499,11597499
1870,2020-12-31,727,Value,0,-10000000,21597499,11597499
1870,2021-03-31,727,Value,0,-10000000,21597499,11597499
1870,2021-06-30,727,Value,0,-10000000,21597499,11597499
1870,2021-09-30,727,Value,0,-10000000,21597499,11597499
1870,2021-12-31,727,Value,0,-10000000,21597499,11597499
1871,2020-03-31,727,Value,0,-9999999,36685834,26685835
1871,2020-06-30,727,Value,0,-9999999,36685834,26685835
1871,2020-09-30,727,Value,0,-9999999,36685834,26685835
1871,2020-12-31,727,Value,0,-9999999,36685834,26685835
1871,2021-03-31,727,Value,0,-9999999,36685834,26685835
1871,2021-06-30,727,Value,0,-9999999,36685834,26685835
1871,2021-09-30,727,Value,0,-9999999,36685834,26685835
1871,2021-12-31,727,Value,0,-9999999,36685834,26685835
1882,2020-03-31,767,Value,0,-10000000,22620002,12620002
1882,2020-06-30,767,Value,0,-10000000,22620002,12620002
1882,2020-09-30,767,Value,0,-10000000,22620002,12620002
1882,2020-12-31,767,Value,0,-10000000,22620002,12620002
1882,2021-03-31,767,Value,0,-10000000,22620002,12620002
1882,2021-06-30,767,Value,0,-10000000,22620002,12620002
1882,2021-09-30,767,Value,0,-10000000,22620002,12620002
1882,2021-12-31,767,Value,0,-10000000,22620002,12620002
1883,2020-03-31,767,Value,0,-10000000,12296248,2296248
1883,2020-06-30,767,Value,0,-10000000,12296248,2296248
1883,2020-09-30,767,Value,0,-10000000,12296248,2296248
1883,2020-12-31,767,Value,0,-10000000,12296248,2296248
1883,2021-03-31,767,Value,0,-10000000,12296248,2296248
1883,2021-06-30,767,Value,0,-10000000,12296248,2296248
1883,2021-09-30,767,Value,0,-10000000,12296248,2296248
1883,2021-12-31,767,Value,0,-10000000,12296248,2296248
1884,2020-03-31,767,Value,566140,-10000000,3678414,-6321586
1884,2020-06-30,767,Value,565850,-10000000,3678414,-6321586
1884,2020-09-30,767,Value,565850,-10000000,3678414,-6321586
1884,2020-12-31,767,Value,2448860,-10000000,3678414,-6321586
1884,2021-03-31,767,Value,6150660,-10000000,3678414,-6321586
1884,2021-06-30,767,Value,4854270,-10000000,3678414,-6321586
1885,2020-03-31,767,Value,47940,-9840000,12703201,2863201
1885,2020-06-30,767,Value,55800,-9840000,12703201,2863201
1885,2020-09-30,767,Value,55730,-9840000,12703201,2863201
1885,2020-11-15,767,Distribution,55304,-9840000,12758505,2918505
1885,2020-12-31,767,Value,0,-9840000,12758505,2918505
1885,2021-03-31,767,Value,0,-9840000,12758505,2918505
1885,2021-06-30,767,Value,0,-9840000,12758505,2918505
1885,2021-09-30,767,Value,0,-9840000,12758505,2918505
1885,2021-12-31,767,Value,0,-9840000,12758505,2918505
1893,2020-03-31,770,Value,0,-10000000,3935098,-6064902
1893,2020-06-30,770,Value,0,-10000000,3935098,-6064902
1893,2020-09-30,770,Value,0,-10000000,3935098,-6064902
1893,2020-12-31,770,Value,0,-10000000,3935098,-6064902
1893,2021-03-31,770,Value,0,-10000000,3935098,-6064902
1893,2021-06-30,770,Value,0,-10000000,3935098,-6064902
1893,2021-09-30,770,Value,0,-10000000,3935098,-6064902
1893,2021-12-31,770,Value,0,-10000000,3935098,-6064902
1894,2020-02-15,770,Distribution,0,-10000000,8778841,-1221159
1894,2020-03-31,770,Value,614740,-10000000,8778841,-1221159
1894,2020-06-30,770,Value,636260,-10000000,8778841,-1221159
1894,2020-09-30,770,Value,651970,-10000000,8778841,-1221159
1909,2020-03-31,777,Value,0,-7120000,23046728,15926728
1909,2020-06-30,777,Value,0,-7120000,23046728,15926728
1909,2020-09-30,777,Value,0,-7120000,23046728,15926728
1909,2020-12-31,777,Value,0,-7120000,23046728,15926728
1909,2021-03-31,777,Value,0,-7120000,23046728,15926728
1909,2021-06-30,777,Value,0,-7120000,23046728,15926728
1909,2021-09-30,777,Value,0,-7120000,23046728,15926728
1909,2021-12-31,777,Value,0,-7120000,23046728,15926728
1914,2021-12-31,778,Value,0,-9790000,6910520,-2879480
1919,2020-03-31,783,Value,107670,-10000000,21960740,11960740
1919,2020-06-30,783,Value,90580,-10000000,21960740,11960740
1919,2020-09-30,783,Value,51040,-10000000,21960740,11960740
1919,2020-12-31,783,Value,27750,-10000000,21960740,11960740
1920,2020-03-31,783,Value,494880,-10000000,13943324,3943324
1920,2020-06-30,783,Value,435630,-10000000,13943324,3943324
1920,2020-09-30,783,Value,460130,-10000000,13943324,3943324
1920,2020-12-31,783,Value,604510,-10000000,13943324,3943324
1920,2021-03-31,783,Value,657040,-10000000,13943324,3943324
1923,2020-03-31,785,Value,0,-9799998,11160004,1360006
1923,2020-06-30,785,Value,0,-9799998,11160004,1360006
1923,2020-09-30,785,Value,0,-9799998,11160004,1360006
1923,2020-12-31,785,Value,0,-9799998,11160004,1360006
1923,2021-03-31,785,Value,0,-9799998,11160004,1360006
1923,2021-06-30,785,Value,0,-9799998,11160004,1360006
1923,2021-09-30,785,Value,0,-9799998,11160004,1360006
1923,2021-12-31,785,Value,0,-9799998,11160004,1360006
1924,2020-03-31,785,Value,59990,-9929998,17409998,7480000
1924,2020-06-30,785,Value,59990,-9929998,17409998,7480000
1924,2020-09-30,785,Value,69990,-9929998,17409998,7480000
1924,2020-12-31,785,Value,69990,-9929998,17409998,7480000
1924,2021-03-31,785,Value,69990,-9929998,17409998,7480000
1924,2021-06-30,785,Value,69990,-9929998,17409998,7480000
1924,2021-09-30,785,Value,69990,-9929998,17409998,7480000
1925,2021-12-31,785,Value,0,-8500000,29875000,21375000
1929,2020-03-31,8818,Value,0,-10000000,14378334,4378334
1929,2020-06-30,8818,Value,0,-10000000,14378334,4378334
1929,2020-09-30,8818,Value,0,-10000000,14378334,4378334
1929,2020-12-31,8818,Value,0,-10000000,14378334,4378334
1929,2021-03-31,8818,Value,0,-10000000,14378334,4378334
1929,2021-06-30,8818,Value,0,-10000000,14378334,4378334
1929,2021-09-30,8818,Value,0,-10000000,14378334,4378334
1929,2021-12-31,8818,Value,0,-10000000,14378334,4378334
1933,2021-12-31,782,Value,0,-9086000,25329000,16243000
1935,2020-03-31,782,Value,408100,-9978000,13716757,3738757
1935,2021-12-31,782,Value,0,-9978000,13716757,3738757
1941,2020-03-31,795,Value,0,-9999999,16500003,6500004
1941,2020-06-30,795,Value,0,-9999999,16500003,6500004
1941,2020-09-30,795,Value,0,-9999999,16500003,6500004
1941,2020-12-31,795,Value,0,-9999999,16500003,6500004
1941,2021-03-31,795,Value,0,-9999999,16500003,6500004
1941,2021-06-30,795,Value,0,-9999999,16500003,6500004
1941,2021-09-30,795,Value,0,-9999999,16500003,6500004
1941,2021-12-31,795,Value,0,-9999999,16500003,6500004
1942,2020-03-31,795,Value,118720,-10637336,19292532,8655196
1942,2020-06-30,795,Value,123560,-10637336,19292532,8655196
1942,2020-09-30,795,Value,117100,-10637336,19292532,8655196
1942,2020-11-15,795,Distribution,117374,-10637336,19409906,8772570
1942,2020-12-31,795,Value,0,-10637336,19409906,8772570
1942,2021-12-31,795,Value,0,-10637336,19409906,8772570
1943,2020-03-31,795,Value,0,-10000000,24000002,14000002
1943,2020-06-30,795,Value,0,-10000000,24000002,14000002
1943,2020-09-30,795,Value,0,-10000000,24000002,14000002
1943,2020-12-31,795,Value,0,-10000000,24000002,14000002
1943,2021-03-31,795,Value,0,-10000000,24000002,14000002
1943,2021-06-30,795,Value,0,-10000000,24000002,14000002
1943,2021-09-30,795,Value,0,-10000000,24000002,14000002
1943,2021-12-31,795,Value,0,-10000000,24000002,14000002
1944,2020-01-15,795,Capital Call,0,-10075713,22942562,12866849
1944,2020-01-15,795,Distribution,0,-10075713,22942562,12866849
1944,2020-02-29,795,Value,36160,-10075713,22942562,12866849
1944,2020-04-15,795,Capital Call,0,-10075713,22942562,12866849
1944,2020-04-15,795,Distribution,0,-10075713,22942562,12866849
1944,2020-05-31,795,Value,37050,-10075713,22942562,12866849
1944,2020-08-31,795,Value,39310,-10075713,22942562,12866849
1944,2020-10-16,795,Distribution,39431,-10075713,22981993,12906280
1944,2020-11-30,795,Value,0,-10075713,22981993,12906280
1944,2021-02-28,795,Value,0,-10075713,22981993,12906280
1944,2021-12-31,795,Value,0,-10075713,22981993,12906280
1958,2020-03-31,802,Value,0,-9900000,16451821,6551821
1958,2020-06-30,802,Value,0,-9900000,16451821,6551821
1958,2020-09-30,802,Value,0,-9900000,16451821,6551821
1958,2020-12-31,802,Value,0,-9900000,16451821,6551821
1958,2021-03-31,802,Value,0,-9900000,16451821,6551821
1958,2021-06-30,802,Value,0,-9900000,16451821,6551821
1958,2021-09-30,802,Value,0,-9900000,16451821,6551821
1958,2021-12-31,802,Value,0,-9900000,16451821,6551821
1959,2020-03-31,802,Value,0,-10000000,20708003,10708003
1959,2020-06-30,802,Value,0,-10000000,20708003,10708003
1959,2020-09-30,802,Value,0,-10000000,20708003,10708003
1959,2020-12-31,802,Value,0,-10000000,20708003,10708003
1959,2021-03-31,802,Value,0,-10000000,20708003,10708003
1959,2021-06-30,802,Value,0,-10000000,20708003,10708003
1959,2021-09-30,802,Value,0,-10000000,20708003,10708003
1959,2021-12-31,802,Value,0,-10000000,20708003,10708003
1960,2020-03-31,802,Value,0,-10000000,21722998,11722998
1960,2020-06-30,802,Value,0,-10000000,21722998,11722998
1960,2020-09-30,802,Value,0,-10000000,21722998,11722998
1960,2020-12-31,802,Value,0,-10000000,21722998,11722998
1960,2021-03-31,802,Value,0,-10000000,21722998,11722998
1960,2021-06-30,802,Value,0,-10000000,21722998,11722998
1960,2021-09-30,802,Value,0,-10000000,21722998,11722998
1960,2021-12-31,802,Value,0,-10000000,21722998,11722998
1961,2021-12-31,802,Value,0,-10000000,12866923,2866923
1965,2020-03-31,801,Value,0,-10959998,22680000,11720002
1965,2020-06-30,801,Value,0,-10959998,22680000,11720002
1965,2020-09-30,801,Value,0,-10959998,22680000,11720002
1965,2020-12-31,801,Value,0,-10959998,22680000,11720002
1965,2021-03-31,801,Value,0,-10959998,22680000,11720002
1965,2021-06-30,801,Value,0,-10959998,22680000,11720002
1965,2021-09-30,801,Value,0,-10959998,22680000,11720002
1965,2021-12-31,801,Value,0,-10959998,22680000,11720002
1967,2020-03-31,804,Value,0,-8500000,20655000,12155000
1967,2020-06-30,804,Value,0,-8500000,20655000,12155000
1967,2020-09-30,804,Value,0,-8500000,20655000,12155000
1967,2020-12-31,804,Value,0,-8500000,20655000,12155000
1967,2021-03-31,804,Value,0,-8500000,20655000,12155000
1967,2021-06-30,804,Value,0,-8500000,20655000,12155000
1967,2021-09-30,804,Value,0,-8500000,20655000,12155000
1967,2021-12-31,804,Value,0,-8500000,20655000,12155000
1968,2020-03-31,804,Value,0,-9139999,10419600,1279601
1968,2020-06-30,804,Value,0,-9139999,10419600,1279601
1968,2020-09-30,804,Value,0,-9139999,10419600,1279601
1968,2020-12-31,804,Value,0,-9139999,10419600,1279601
1968,2021-03-31,804,Value,0,-9139999,10419600,1279601
1968,2021-06-30,804,Value,0,-9139999,10419600,1279601
1968,2021-09-30,804,Value,0,-9139999,10419600,1279601
1968,2021-12-31,804,Value,0,-9139999,10419600,1279601
1969,2021-12-31,804,Value,0,-9840992,11513969,1672977
1972,2020-03-31,807,Value,0,-10023029,5865654,-4157375
1972,2020-06-30,807,Value,0,-10023029,5865654,-4157375
1972,2020-09-30,807,Value,0,-10023029,5865654,-4157375
1972,2020-12-31,807,Value,0,-10023029,5865654,-4157375
1972,2021-03-31,807,Value,0,-10023029,5865654,-4157375
1972,2021-06-30,807,Value,0,-10023029,5865654,-4157375
1972,2021-09-30,807,Value,0,-10023029,5865654,-4157375
1972,2021-12-31,807,Value,0,-10023029,5865654,-4157375
1973,2020-03-31,808,Value,0,-10000003,23551448,13551445
1973,2020-06-30,808,Value,0,-10000003,23551448,13551445
1973,2020-09-30,808,Value,0,-10000003,23551448,13551445
1973,2020-12-31,808,Value,0,-10000003,23551448,13551445
1973,2021-03-31,808,Value,0,-10000003,23551448,13551445
1973,2021-06-30,808,Value,0,-10000003,23551448,13551445
1973,2021-09-30,808,Value,0,-10000003,23551448,13551445
1973,2021-12-31,808,Value,0,-10000003,23551448,13551445
1979,2020-03-31,808,Value,0,-11558159,22375756,10817597
1979,2020-06-30,808,Value,0,-11558159,22375756,10817597
1979,2020-09-30,808,Value,0,-11558159,22375756,10817597
1979,2020-12-31,808,Value,0,-11558159,22375756,10817597
1979,2021-03-31,808,Value,0,-11558159,22375756,10817597
1979,2021-06-30,808,Value,0,-11558159,22375756,10817597
1979,2021-09-30,808,Value,0,-11558159,22375756,10817597
1979,2021-12-31,808,Value,0,-11558159,22375756,10817597
1980,2020-03-31,809,Value,0,-10167095,13174109,3007014
1980,2020-06-30,809,Value,0,-10167095,13174109,3007014
1980,2020-09-30,809,Value,0,-10167095,13174109,3007014
1980,2020-12-31,809,Value,0,-10167095,13174109,3007014
1980,2021-03-31,809,Value,0,-10167095,13174109,3007014
1980,2021-06-30,809,Value,0,-10167095,13174109,3007014
1980,2021-09-30,809,Value,0,-10167095,13174109,3007014
1980,2021-12-31,809,Value,0,-10167095,13174109,3007014
1981,2020-03-31,793,Value,0,-9103528,2995256,-6108272
1981,2020-06-30,793,Value,0,-9103528,2995256,-6108272
1981,2020-09-30,793,Value,0,-9103528,2995256,-6108272
1981,2020-12-31,793,Value,0,-9103528,2995256,-6108272
1981,2021-03-31,793,Value,0,-9103528,2995256,-6108272
1981,2021-06-30,793,Value,0,-9103528,2995256,-6108272
1981,2021-09-30,793,Value,0,-9103528,2995256,-6108272
1981,2021-12-31,793,Value,0,-9103528,2995256,-6108272
1983,2020-03-31,810,Value,0,-9630000,13597003,3967003
1983,2020-06-30,810,Value,0,-9630000,13597003,3967003
1983,2020-09-30,810,Value,0,-9630000,13597003,3967003
1983,2020-12-31,810,Value,0,-9630000,13597003,3967003
1983,2021-03-31,810,Value,0,-9630000,13597003,3967003
1983,2021-06-30,810,Value,0,-9630000,13597003,3967003
1983,2021-09-30,810,Value,0,-9630000,13597003,3967003
1983,2021-12-31,810,Value,0,-9630000,13597003,3967003
1988,2020-03-31,811,Value,0,-10000002,24279002,14279000
1988,2020-06-30,811,Value,0,-10000002,24279002,14279000
1988,2020-09-30,811,Value,0,-10000002,24279002,14279000
1988,2020-12-31,811,Value,0,-10000002,24279002,14279000
1988,2021-03-31,811,Value,0,-10000002,24279002,14279000
1988,2021-06-30,811,Value,0,-10000002,24279002,14279000
1988,2021-09-30,811,Value,0,-10000002,24279002,14279000
1988,2021-12-31,811,Value,0,-10000002,24279002,14279000
1989,2020-03-31,811,Value,0,-9977377,5872263,-4105114
1989,2020-06-30,811,Value,0,-9977377,5872263,-4105114
1989,2020-09-30,811,Value,0,-9977377,5872263,-4105114
1989,2020-12-31,811,Value,0,-9977377,5872263,-4105114
1989,2021-03-31,811,Value,0,-9977377,5872263,-4105114
1989,2021-06-30,811,Value,0,-9977377,5872263,-4105114
1989,2021-09-30,811,Value,0,-9977377,5872263,-4105114
1989,2021-12-31,811,Value,0,-9977377,5872263,-4105114
1990,2020-03-31,811,Value,0,-10633554,10689840,56286
1990,2020-06-30,811,Value,0,-10633554,10689840,56286
1990,2020-09-30,811,Value,0,-10633554,10689840,56286
1990,2020-12-31,811,Value,0,-10633554,10689840,56286
1990,2021-03-31,811,Value,0,-10633554,10689840,56286
1990,2021-06-30,811,Value,0,-10633554,10689840,56286
1990,2021-09-30,811,Value,0,-10633554,10689840,56286
1990,2021-12-31,811,Value,0,-10633554,10689840,56286
1992,2020-03-31,812,Value,168360,-9150504,17032752,7882248
1992,2020-05-16,812,Distribution,-427,-9150504,17032325,7881821
1992,2020-06-30,812,Value,168680,-9150504,17032325,7881821
1992,2020-09-30,812,Value,168680,-9150504,17032325,7881821
1992,2020-12-31,812,Value,167670,-9150504,17032325,7881821
1992,2021-03-31,812,Value,167670,-9150504,17032325,7881821
1992,2021-06-30,812,Value,167670,-9150504,17032325,7881821
1993,2020-03-31,814,Value,0,-10000000,32189999,22189999
1993,2020-06-30,814,Value,0,-10000000,32189999,22189999
1993,2020-09-30,814,Value,0,-10000000,32189999,22189999
1993,2020-12-31,814,Value,0,-10000000,32189999,22189999
1993,2021-03-31,814,Value,0,-10000000,32189999,22189999
1993,2021-06-30,814,Value,0,-10000000,32189999,22189999
1993,2021-09-30,814,Value,0,-10000000,32189999,22189999
1993,2021-12-31,814,Value,0,-10000000,32189999,22189999
1995,2020-03-31,814,Value,0,-9692000,19856000,10164000
1995,2020-06-30,814,Value,0,-9692000,19856000,10164000
1995,2020-09-30,814,Value,0,-9692000,19856000,10164000
1995,2020-12-31,814,Value,0,-9692000,19856000,10164000
1995,2021-03-31,814,Value,0,-9692000,19856000,10164000
1995,2021-06-30,814,Value,0,-9692000,19856000,10164000
1995,2021-09-30,814,Value,0,-9692000,19856000,10164000
1995,2021-12-31,814,Value,0,-9692000,19856000,10164000
1996,2020-03-31,814,Value,1075570,-11806122,13296579,1490457
1996,2020-06-30,814,Value,982900,-11806122,13296579,1490457
1996,2020-09-30,814,Value,514590,-11806122,13296579,1490457
1996,2020-12-31,814,Value,196520,-11806122,13296579,1490457
1996,2021-03-31,814,Value,200410,-11806122,13296579,1490457
1998,2020-03-31,816,Value,0,-7994570,12575668,4581098
1998,2020-06-30,816,Value,0,-7994570,12575668,4581098
1998,2020-09-30,816,Value,0,-7994570,12575668,4581098
1998,2020-12-31,816,Value,0,-7994570,12575668,4581098
1998,2021-03-31,816,Value,0,-7994570,12575668,4581098
1998,2021-06-30,816,Value,0,-7994570,12575668,4581098
1998,2021-09-30,816,Value,0,-7994570,12575668,4581098
1998,2021-12-31,816,Value,0,-7994570,12575668,4581098
2001,2020-03-31,819,Value,0,-10000000,37926168,27926168
2001,2020-06-30,819,Value,0,-10000000,37926168,27926168
2001,2020-09-30,819,Value,0,-10000000,37926168,27926168
2001,2020-12-31,819,Value,0,-10000000,37926168,27926168
2001,2021-03-31,819,Value,0,-10000000,37926168,27926168
2001,2021-06-30,819,Value,0,-10000000,37926168,27926168
2001,2021-09-30,819,Value,0,-10000000,37926168,27926168
2001,2021-12-31,819,Value,0,-10000000,37926168,27926168
2002,2020-03-31,819,Value,0,-10000000,16813474,6813474
2002,2020-06-30,819,Value,0,-10000000,16813474,6813474
2002,2020-09-30,819,Value,0,-10000000,16813474,6813474
2002,2020-12-31,819,Value,0,-10000000,16813474,6813474
2002,2021-03-31,819,Value,0,-10000000,16813474,6813474
2002,2021-06-30,819,Value,0,-10000000,16813474,6813474
2002,2021-09-30,819,Value,0,-10000000,16813474,6813474
2002,2021-12-31,819,Value,0,-10000000,16813474,6813474
2003,2020-03-31,819,Value,0,-10000000,1532976,-8467024
2003,2020-06-30,819,Value,0,-10000000,1532976,-8467024
2003,2020-09-30,819,Value,0,-10000000,1532976,-8467024
2003,2020-12-31,819,Value,0,-10000000,1532976,-8467024
2003,2021-03-31,819,Value,0,-10000000,1532976,-8467024
2003,2021-06-30,819,Value,0,-10000000,1532976,-8467024
2003,2021-09-30,819,Value,0,-10000000,1532976,-8467024
2003,2021-12-31,819,Value,0,-10000000,1532976,-8467024
2006,2020-03-31,799,Value,0,-9669546,6333758,-3335788
2006,2020-06-30,799,Value,0,-9669546,6333758,-3335788
2006,2020-09-30,799,Value,0,-9669546,6333758,-3335788
2006,2020-12-31,799,Value,0,-9669546,6333758,-3335788
2006,2021-03-31,799,Value,0,-9669546,6333758,-3335788
2006,2021-06-30,799,Value,0,-9669546,6333758,-3335788
2006,2021-09-30,799,Value,0,-9669546,6333758,-3335788
2006,2021-12-31,799,Value,0,-9669546,6333758,-3335788
2007,2020-03-31,799,Value,0,-10000000,16616827,6616827
2007,2020-06-30,799,Value,0,-10000000,16616827,6616827
2007,2020-09-30,799,Value,0,-10000000,16616827,6616827
2007,2020-12-31,799,Value,0,-10000000,16616827,6616827
2007,2021-03-31,799,Value,0,-10000000,16616827,6616827
2007,2021-06-30,799,Value,0,-10000000,16616827,6616827
2007,2021-09-30,799,Value,0,-10000000,16616827,6616827
2007,2021-12-31,799,Value,0,-10000000,16616827,6616827
2008,2020-03-31,799,Value,0,-9738310,60871011,51132701
2008,2020-06-30,799,Value,0,-9738310,60871011,51132701
2008,2020-09-30,799,Value,0,-9738310,60871011,51132701
2008,2020-12-31,799,Value,0,-9738310,60871011,51132701
2008,2021-03-31,799,Value,0,-9738310,60871011,51132701
2008,2021-06-30,799,Value,0,-9738310,60871011,51132701
2008,2021-09-30,799,Value,0,-9738310,60871011,51132701
2008,2021-12-31,799,Value,0,-9738310,60871011,51132701
2009,2020-03-31,799,Value,0,-10000000,39687157,29687157
2009,2020-06-30,799,Value,0,-10000000,39687157,29687157
2009,2020-09-30,799,Value,0,-10000000,39687157,29687157
2009,2020-12-31,799,Value,0,-10000000,39687157,29687157
2009,2021-03-31,799,Value,0,-10000000,39687157,29687157
2009,2021-06-30,799,Value,0,-10000000,39687157,29687157
2009,2021-09-30,799,Value,0,-10000000,39687157,29687157
2009,2021-12-31,799,Value,0,-10000000,39687157,29687157
2011,2020-03-31,461,Value,0,-9903437,6438710,-3464727
2011,2020-06-30,461,Value,0,-9903437,6438710,-3464727
2011,2020-09-30,461,Value,0,-9903437,6438710,-3464727
2011,2020-12-31,461,Value,0,-9903437,6438710,-3464727
2011,2021-03-31,461,Value,0,-9903437,6438710,-3464727
2011,2021-06-30,461,Value,0,-9903437,6438710,-3464727
2011,2021-09-30,461,Value,0,-9903437,6438710,-3464727
2011,2021-12-31,461,Value,0,-9903437,6438710,-3464727
2012,2020-03-31,461,Value,0,-9175226,8732146,-443080
2012,2020-06-30,461,Value,0,-9175226,8732146,-443080
2012,2020-09-30,461,Value,0,-9175226,8732146,-443080
2012,2020-12-31,461,Value,0,-9175226,8732146,-443080
2012,2021-03-31,461,Value,0,-9175226,8732146,-443080
2012,2021-06-30,461,Value,0,-9175226,8732146,-443080
2012,2021-09-30,461,Value,0,-9175226,8732146,-443080
2012,2021-12-31,461,Value,0,-9175226,8732146,-443080
2056,2021-12-31,32667,Value,0,-10621151,14001670,3380519
2057,2020-03-31,32667,Value,0,-10000001,12496998,2496997
2057,2020-06-30,32667,Value,0,-10000001,12496998,2496997
2057,2020-09-30,32667,Value,0,-10000001,12496998,2496997
2057,2020-12-31,32667,Value,0,-10000001,12496998,2496997
2057,2021-03-31,32667,Value,0,-10000001,12496998,2496997
2057,2021-06-30,32667,Value,0,-10000001,12496998,2496997
2057,2021-09-30,32667,Value,0,-10000001,12496998,2496997
2057,2021-12-31,32667,Value,0,-10000001,12496998,2496997
2058,2020-03-31,386,Value,0,-8364164,15948647,7584483
2058,2020-06-30,386,Value,0,-8364164,15948647,7584483
2058,2020-09-30,386,Value,0,-8364164,15948647,7584483
2058,2020-12-31,386,Value,0,-8364164,15948647,7584483
2058,2021-03-31,386,Value,0,-8364164,15948647,7584483
2058,2021-06-30,386,Value,0,-8364164,15948647,7584483
2058,2021-09-30,386,Value,0,-8364164,15948647,7584483
2058,2021-12-31,386,Value,0,-8364164,15948647,7584483
2066,2020-03-31,736,Value,0,-10000000,12074838,2074838
2066,2020-06-30,736,Value,0,-10000000,12074838,2074838
2066,2020-09-30,736,Value,0,-10000000,12074838,2074838
2066,2020-12-31,736,Value,0,-10000000,12074838,2074838
2066,2021-03-31,736,Value,0,-10000000,12074838,2074838
2066,2021-06-30,736,Value,0,-10000000,12074838,2074838
2066,2021-09-30,736,Value,0,-10000000,12074838,2074838
2066,2021-12-31,736,Value,0,-10000000,12074838,2074838
2070,2021-12-31,838,Value,0,-10000001,2698000,-7302001
2071,2020-06-30,398,Value,3854280,-10000000,9138571,-861429
2093,2020-03-31,140,Value,0,-10454559,28542492,18087933
2093,2020-06-30,140,Value,0,-10454559,28542492,18087933
2093,2020-09-30,140,Value,0,-10454559,28542492,18087933
2093,2020-12-31,140,Value,0,-10454559,28542492,18087933
2093,2021-03-31,140,Value,0,-10454559,28542492,18087933
2093,2021-06-30,140,Value,0,-10454559,28542492,18087933
2093,2021-09-30,140,Value,0,-10454559,28542492,18087933
2093,2021-12-31,140,Value,0,-10454559,28542492,18087933
2106,2020-02-15,910,Distribution,56325,-11502714,13329971,1827257
2106,2020-03-31,910,Value,14060,-11502714,13329971,1827257
2106,2020-05-16,910,Capital Call,-459,-11503173,13329971,1826798
2106,2020-05-16,910,Distribution,5878,-11503173,13335849,1832676
2106,2020-06-30,910,Value,0,-11503173,13335849,1832676
2106,2020-09-30,910,Value,0,-11503173,13335849,1832676
2106,2020-11-15,910,Capital Call,-778,-11503951,13335849,1831898
2106,2020-11-15,910,Distribution,902,-11503951,13336751,1832800
2106,2020-12-31,910,Value,0,-11503951,13336751,1832800
2106,2021-03-31,910,Value,0,-11503951,13336751,1832800
2106,2021-06-30,910,Value,0,-11503951,13336751,1832800
2106,2021-09-30,910,Value,0,-11503951,13336751,1832800
2106,2021-12-31,910,Value,0,-11503951,13336751,1832800
2107,2020-02-15,910,Capital Call,-95782,-10479274,12580465,2101191
2107,2020-02-15,910,Distribution,127752,-10479274,12708217,2228943
2107,2020-03-31,910,Value,178140,-10479274,12708217,2228943
2107,2020-05-16,910,Capital Call,-1009,-10480283,12708217,2227934
2107,2020-05-16,910,Distribution,3320,-10480283,12711537,2231254
2107,2020-06-30,910,Value,184450,-10480283,12711537,2231254
2107,2020-08-15,910,Capital Call,96551,-10383732,12711537,2327805
2107,2020-08-15,910,Distribution,-117103,-10383732,12594434,2210702
2107,2020-09-30,910,Value,193130,-10383732,12594434,2210702
2108,2020-02-15,51099,Capital Call,-3576,-10546786,16622498,6075712
2108,2020-03-31,51099,Value,14230,-10546786,16622498,6075712
2108,2020-05-16,51099,Capital Call,-8331,-10555117,16622498,6067381
2108,2020-06-30,51099,Value,17590,-10555117,16622498,6067381
2108,2021-12-31,51099,Value,0,-10555117,16622498,6067381
2110,2020-03-31,1390,Value,0,-11407922,18754286,7346364
2110,2020-06-30,1390,Value,0,-11407922,18754286,7346364
2110,2020-09-30,1390,Value,0,-11407922,18754286,7346364
2110,2020-12-31,1390,Value,0,-11407922,18754286,7346364
2110,2021-03-31,1390,Value,0,-11407922,18754286,7346364
2110,2021-06-30,1390,Value,0,-11407922,18754286,7346364
2110,2021-09-30,1390,Value,0,-11407922,18754286,7346364
2110,2021-12-31,1390,Value,0,-11407922,18754286,7346364
2111,2020-03-31,649,Value,1214740,-10000000,4401959,-5598041
2111,2020-06-30,649,Value,1341610,-10000000,4401959,-5598041
2111,2020-09-30,649,Value,1314270,-10000000,4401959,-5598041
2111,2020-12-31,649,Value,1314270,-10000000,4401959,-5598041
2111,2021-03-31,649,Value,964470,-10000000,4401959,-5598041
2111,2021-06-30,649,Value,912570,-10000000,4401959,-5598041
2124,2020-03-31,44,Value,0,-7944052,19382145,11438093
2124,2020-06-30,44,Value,0,-7944052,19382145,11438093
2124,2020-09-30,44,Value,0,-7944052,19382145,11438093
2124,2020-12-31,44,Value,0,-7944052,19382145,11438093
2124,2021-03-31,44,Value,0,-7944052,19382145,11438093
2124,2021-06-30,44,Value,0,-7944052,19382145,11438093
2124,2021-09-30,44,Value,0,-7944052,19382145,11438093
2124,2021-12-31,44,Value,0,-7944052,19382145,11438093
2125,2020-03-31,45,Value,0,-10001413,12109078,2107665
2125,2020-06-30,45,Value,0,-10001413,12109078,2107665
2125,2020-09-30,45,Value,0,-10001413,12109078,2107665
2125,2020-12-31,45,Value,0,-10001413,12109078,2107665
2125,2021-03-31,45,Value,0,-10001413,12109078,2107665
2125,2021-06-30,45,Value,0,-10001413,12109078,2107665
2125,2021-09-30,45,Value,0,-10001413,12109078,2107665
2125,2021-12-31,45,Value,0,-10001413,12109078,2107665
2126,2020-03-31,847,Value,0,-10121550,889830,-9231720
2126,2020-06-30,847,Value,0,-10121550,889830,-9231720
2126,2020-09-30,847,Value,0,-10121550,889830,-9231720
2126,2020-12-31,847,Value,0,-10121550,889830,-9231720
2126,2021-03-31,847,Value,0,-10121550,889830,-9231720
2126,2021-06-30,847,Value,0,-10121550,889830,-9231720
2126,2021-09-30,847,Value,0,-10121550,889830,-9231720
2126,2021-12-31,847,Value,0,-10121550,889830,-9231720
2127,2020-03-31,121,Value,0,-10469404,8175075,-2294329
2127,2020-06-30,121,Value,0,-10469404,8175075,-2294329
2127,2020-09-30,121,Value,0,-10469404,8175075,-2294329
2127,2020-12-31,121,Value,0,-10469404,8175075,-2294329
2127,2021-03-31,121,Value,0,-10469404,8175075,-2294329
2127,2021-06-30,121,Value,0,-10469404,8175075,-2294329
2127,2021-09-30,121,Value,0,-10469404,8175075,-2294329
2127,2021-12-31,121,Value,0,-10469404,8175075,-2294329
2128,2020-03-31,848,Value,0,-10000001,20377549,10377548
2128,2020-06-30,848,Value,0,-10000001,20377549,10377548
2128,2020-09-30,848,Value,0,-10000001,20377549,10377548
2128,2020-12-31,848,Value,0,-10000001,20377549,10377548
2128,2021-03-31,848,Value,0,-10000001,20377549,10377548
2128,2021-06-30,848,Value,0,-10000001,20377549,10377548
2128,2021-09-30,848,Value,0,-10000001,20377549,10377548
2128,2021-12-31,848,Value,0,-10000001,20377549,10377548
2129,2020-03-31,849,Value,0,-9634328,58575959,48941631
2129,2020-06-30,849,Value,0,-9634328,58575959,48941631
2129,2020-09-30,849,Value,0,-9634328,58575959,48941631
2129,2020-12-31,849,Value,0,-9634328,58575959,48941631
2129,2021-03-31,849,Value,0,-9634328,58575959,48941631
2129,2021-06-30,849,Value,0,-9634328,58575959,48941631
2129,2021-09-30,849,Value,0,-9634328,58575959,48941631
2129,2021-12-31,849,Value,0,-9634328,58575959,48941631
2130,2020-03-31,849,Value,0,-8415157,16493709,8078552
2130,2020-06-30,849,Value,0,-8415157,16493709,8078552
2130,2020-09-30,849,Value,0,-8415157,16493709,8078552
2130,2020-12-31,849,Value,0,-8415157,16493709,8078552
2130,2021-03-31,849,Value,0,-8415157,16493709,8078552
2130,2021-06-30,849,Value,0,-8415157,16493709,8078552
2130,2021-09-30,849,Value,0,-8415157,16493709,8078552
2130,2021-12-31,849,Value,0,-8415157,16493709,8078552
2131,2020-03-31,849,Value,0,-8798644,28829332,20030688
2131,2020-06-30,849,Value,0,-8798644,28829332,20030688
2131,2020-09-30,849,Value,0,-8798644,28829332,20030688
2131,2020-12-31,849,Value,0,-8798644,28829332,20030688
2131,2021-03-31,849,Value,0,-8798644,28829332,20030688
2131,2021-06-30,849,Value,0,-8798644,28829332,20030688
2131,2021-09-30,849,Value,0,-8798644,28829332,20030688
2131,2021-12-31,849,Value,0,-8798644,28829332,20030688
2132,2020-03-31,352,Value,0,-10223971,10855211,631240
2132,2020-06-30,352,Value,0,-10223971,10855211,631240
2132,2020-09-30,352,Value,0,-10223971,10855211,631240
2132,2020-12-31,352,Value,0,-10223971,10855211,631240
2132,2021-03-31,352,Value,0,-10223971,10855211,631240
2132,2021-06-30,352,Value,0,-10223971,10855211,631240
2132,2021-09-30,352,Value,0,-10223971,10855211,631240
2132,2021-12-31,352,Value,0,-10223971,10855211,631240
2134,2020-03-31,850,Value,0,-10000000,41121002,31121002
2134,2020-06-30,850,Value,0,-10000000,41121002,31121002
2134,2020-09-30,850,Value,0,-10000000,41121002,31121002
2134,2020-12-31,850,Value,0,-10000000,41121002,31121002
2134,2021-03-31,850,Value,0,-10000000,41121002,31121002
2134,2021-06-30,850,Value,0,-10000000,41121002,31121002
2134,2021-09-30,850,Value,0,-10000000,41121002,31121002
2134,2021-12-31,850,Value,0,-10000000,41121002,31121002
2136,2020-01-15,851,Distribution,0,-9385391,8399925,-985466
2136,2020-02-29,851,Value,485650,-9385391,8399925,-985466
2136,2020-04-15,851,Distribution,0,-9385391,8399925,-985466
2136,2020-05-31,851,Value,300320,-9385391,8399925,-985466
2136,2020-08-31,851,Value,297390,-9385391,8399925,-985466
2136,2020-10-16,851,Distribution,262296,-9385391,8662221,-723170
2136,2020-11-30,851,Value,633860,-9385391,8662221,-723170
2136,2021-01-14,851,Distribution,630869,-9385391,9293090,-92301
2136,2021-02-28,851,Value,0,-9385391,9293090,-92301
2136,2021-05-31,851,Value,0,-9385391,9293090,-92301
2136,2021-08-31,851,Value,0,-9385391,9293090,-92301
2138,2020-03-31,852,Value,0,-10000000,11181444,1181444
2138,2020-06-30,852,Value,0,-10000000,11181444,1181444
2138,2020-09-30,852,Value,0,-10000000,11181444,1181444
2138,2020-12-31,852,Value,0,-10000000,11181444,1181444
2138,2021-03-31,852,Value,0,-10000000,11181444,1181444
2138,2021-06-30,852,Value,0,-10000000,11181444,1181444
2138,2021-09-30,852,Value,0,-10000000,11181444,1181444
2138,2021-12-31,852,Value,0,-10000000,11181444,1181444
2139,2020-01-15,268,Capital Call,-1,-10014757,5150823,-4863934
2139,2020-01-15,268,Distribution,1,-10014757,5150824,-4863933
2139,2020-02-29,268,Value,349600,-10014757,5150824,-4863933
2139,2020-04-15,268,Capital Call,1,-10014756,5150824,-4863932
2139,2020-04-15,268,Distribution,-1,-10014756,5150823,-4863933
2139,2020-05-31,268,Value,349600,-10014756,5150823,-4863933
2139,2020-08-31,268,Value,349600,-10014756,5150823,-4863933
2139,2020-11-30,268,Value,0,-10014756,5150823,-4863933
2139,2021-02-28,268,Value,0,-10014756,5150823,-4863933
2139,2021-05-31,268,Value,0,-10014756,5150823,-4863933
2139,2021-08-31,268,Value,0,-10014756,5150823,-4863933
2139,2021-12-31,268,Value,0,-10014756,5150823,-4863933
2141,2020-03-31,853,Value,0,-10000000,15448128,5448128
2141,2020-06-30,853,Value,0,-10000000,15448128,5448128
2141,2020-09-30,853,Value,0,-10000000,15448128,5448128
2141,2020-12-31,853,Value,0,-10000000,15448128,5448128
2141,2021-03-31,853,Value,0,-10000000,15448128,5448128
2141,2021-06-30,853,Value,0,-10000000,15448128,5448128
2141,2021-09-30,853,Value,0,-10000000,15448128,5448128
2141,2021-12-31,853,Value,0,-10000000,15448128,5448128
2144,2020-01-15,854,Capital Call,0,-10002439,9227570,-774869
2144,2020-01-15,854,Distribution,0,-10002439,9227570,-774869
2144,2020-02-29,854,Value,412690,-10002439,9227570,-774869
2144,2020-04-15,854,Capital Call,0,-10002439,9227570,-774869
2144,2020-04-15,854,Distribution,0,-10002439,9227570,-774869
2144,2020-05-31,854,Value,412320,-10002439,9227570,-774869
2144,2020-08-31,854,Value,412240,-10002439,9227570,-774869
2144,2020-10-16,854,Distribution,420168,-10002439,9647738,-354701
2144,2020-11-30,854,Value,30230,-10002439,9647738,-354701
2144,2021-02-28,854,Value,1320,-10002439,9647738,-354701
2144,2021-05-31,854,Value,740,-10002439,9647738,-354701
2144,2021-08-31,854,Value,30670,-10002439,9647738,-354701
2144,2021-10-16,854,Capital Call,0,-10002439,9647738,-354701
2144,2021-10-16,854,Distribution,0,-10002439,9647738,-354701
2144,2021-11-30,854,Value,32030,-10002439,9647738,-354701
2151,2020-03-31,464,Value,0,-10000001,19752318,9752317
2151,2020-06-30,464,Value,0,-10000001,19752318,9752317
2151,2020-09-30,464,Value,0,-10000001,19752318,9752317
2151,2020-12-31,464,Value,0,-10000001,19752318,9752317
2151,2021-03-31,464,Value,0,-10000001,19752318,9752317
2151,2021-12-31,464,Value,0,-10000001,19752318,9752317
2155,2020-03-31,355,Value,0,-10000000,17628750,7628750
2155,2020-06-30,355,Value,0,-10000000,17628750,7628750
2155,2020-09-30,355,Value,0,-10000000,17628750,7628750
2155,2020-12-31,355,Value,0,-10000000,17628750,7628750
2155,2021-03-31,355,Value,0,-10000000,17628750,7628750
2155,2021-06-30,355,Value,0,-10000000,17628750,7628750
2155,2021-09-30,355,Value,0,-10000000,17628750,7628750
2155,2021-12-31,355,Value,0,-10000000,17628750,7628750
2164,2020-03-31,131,Value,0,-10000000,17703504,7703504
2164,2020-06-30,131,Value,0,-10000000,17703504,7703504
2164,2020-09-30,131,Value,0,-10000000,17703504,7703504
2164,2020-12-31,131,Value,0,-10000000,17703504,7703504
2164,2021-03-31,131,Value,0,-10000000,17703504,7703504
2164,2021-06-30,131,Value,0,-10000000,17703504,7703504
2164,2021-09-30,131,Value,0,-10000000,17703504,7703504
2164,2021-12-31,131,Value,0,-10000000,17703504,7703504
2168,2020-03-31,856,Value,0,-9255687,7092215,-2163472
2168,2020-06-30,856,Value,0,-9255687,7092215,-2163472
2168,2020-09-30,856,Value,0,-9255687,7092215,-2163472
2168,2020-12-31,856,Value,0,-9255687,7092215,-2163472
2168,2021-03-31,856,Value,0,-9255687,7092215,-2163472
2168,2021-06-30,856,Value,0,-9255687,7092215,-2163472
2168,2021-09-30,856,Value,0,-9255687,7092215,-2163472
2168,2021-12-31,856,Value,0,-9255687,7092215,-2163472
2170,2020-03-31,252,Value,0,-9986445,13199648,3213203
2170,2020-06-30,252,Value,0,-9986445,13199648,3213203
2170,2020-09-30,252,Value,0,-9986445,13199648,3213203
2170,2020-12-31,252,Value,0,-9986445,13199648,3213203
2170,2021-03-31,252,Value,0,-9986445,13199648,3213203
2170,2021-06-30,252,Value,0,-9986445,13199648,3213203
2170,2021-09-30,252,Value,0,-9986445,13199648,3213203
2170,2021-12-31,252,Value,0,-9986445,13199648,3213203
2175,2020-02-29,2589,Value,0,-7521414,8966783,1445369
2175,2020-05-31,2589,Value,0,-7521414,8966783,1445369
2175,2020-08-31,2589,Value,0,-7521414,8966783,1445369
2175,2020-11-30,2589,Value,0,-7521414,8966783,1445369
2175,2021-02-28,2589,Value,0,-7521414,8966783,1445369
2175,2021-05-31,2589,Value,0,-7521414,8966783,1445369
2175,2021-08-31,2589,Value,0,-7521414,8966783,1445369
2175,2021-10-16,2589,Capital Call,0,-7521414,8966783,1445369
2175,2021-10-16,2589,Distribution,0,-7521414,8966783,1445369
2175,2021-12-31,2589,Value,0,-7521414,8966783,1445369
2176,2020-03-31,2589,Value,0,-9540259,11726096,2185837
2176,2020-06-30,2589,Value,0,-9540259,11726096,2185837
2176,2020-09-30,2589,Value,0,-9540259,11726096,2185837
2176,2020-12-31,2589,Value,0,-9540259,11726096,2185837
2176,2021-03-31,2589,Value,0,-9540259,11726096,2185837
2176,2021-06-30,2589,Value,0,-9540259,11726096,2185837
2176,2021-09-30,2589,Value,0,-9540259,11726096,2185837
2176,2021-12-31,2589,Value,0,-9540259,11726096,2185837
2177,2020-03-31,863,Value,0,-9639607,960104,-8679503
2177,2020-06-30,863,Value,0,-9639607,960104,-8679503
2177,2020-09-30,863,Value,0,-9639607,960104,-8679503
2177,2020-12-31,863,Value,0,-9639607,960104,-8679503
2177,2021-03-31,863,Value,0,-9639607,960104,-8679503
2177,2021-06-30,863,Value,0,-9639607,960104,-8679503
2177,2021-09-30,863,Value,0,-9639607,960104,-8679503
2177,2021-12-31,863,Value,0,-9639607,960104,-8679503
2180,2020-03-31,865,Value,0,-10000000,8998371,-1001629
2180,2020-06-30,865,Value,0,-10000000,8998371,-1001629
2180,2020-09-30,865,Value,0,-10000000,8998371,-1001629
2180,2020-12-31,865,Value,0,-10000000,8998371,-1001629
2180,2021-03-31,865,Value,0,-10000000,8998371,-1001629
2180,2021-06-30,865,Value,0,-10000000,8998371,-1001629
2180,2021-09-30,865,Value,0,-10000000,8998371,-1001629
2180,2021-12-31,865,Value,0,-10000000,8998371,-1001629
2182,2020-03-31,856,Value,0,-10152937,4043975,-6108962
2182,2020-06-30,856,Value,0,-10152937,4043975,-6108962
2182,2020-09-30,856,Value,0,-10152937,4043975,-6108962
2182,2020-12-31,856,Value,0,-10152937,4043975,-6108962
2182,2021-03-31,856,Value,0,-10152937,4043975,-6108962
2182,2021-06-30,856,Value,0,-10152937,4043975,-6108962
2182,2021-09-30,856,Value,0,-10152937,4043975,-6108962
2182,2021-12-31,856,Value,0,-10152937,4043975,-6108962
2183,2020-03-31,866,Value,0,-10002278,10000002,-2276
2183,2020-06-30,866,Value,0,-10002278,10000002,-2276
2183,2020-09-30,866,Value,0,-10002278,10000002,-2276
2183,2020-12-31,866,Value,0,-10002278,10000002,-2276
2183,2021-03-31,866,Value,0,-10002278,10000002,-2276
2183,2021-06-30,866,Value,0,-10002278,10000002,-2276
2183,2021-09-30,866,Value,0,-10002278,10000002,-2276
2183,2021-12-31,866,Value,0,-10002278,10000002,-2276
2185,2020-03-31,868,Value,0,-10002975,6827964,-3175011
2185,2020-06-30,868,Value,0,-10002975,6827964,-3175011
2185,2020-09-30,868,Value,0,-10002975,6827964,-3175011
2185,2020-12-31,868,Value,0,-10002975,6827964,-3175011
2185,2021-03-31,868,Value,0,-10002975,6827964,-3175011
2185,2021-06-30,868,Value,0,-10002975,6827964,-3175011
2185,2021-09-30,868,Value,0,-10002975,6827964,-3175011
2185,2021-12-31,868,Value,0,-10002975,6827964,-3175011
2215,2020-06-30,594,Value,0,-13168273,28443944,15275671
2215,2021-12-31,594,Value,0,-13168273,28443944,15275671
2222,2020-06-30,893,Value,0,-10000001,14592989,4592988
2222,2020-09-30,893,Value,0,-10000001,14592989,4592988
2222,2020-12-31,893,Value,0,-10000001,14592989,4592988
2222,2021-03-31,893,Value,0,-10000001,14592989,4592988
2222,2021-06-30,893,Value,0,-10000001,14592989,4592988
2222,2021-09-30,893,Value,0,-10000001,14592989,4592988
2222,2021-12-31,893,Value,0,-10000001,14592989,4592988
2225,2021-12-31,40,Value,0,-9500000,13531973,4031973
2243,2020-03-31,4,Value,0,-9519002,10851660,1332658
2243,2020-06-30,4,Value,0,-9519002,10851660,1332658
2243,2020-09-30,4,Value,0,-9519002,10851660,1332658
2243,2020-12-31,4,Value,0,-9519002,10851660,1332658
2243,2021-03-31,4,Value,0,-9519002,10851660,1332658
2243,2021-06-30,4,Value,0,-9519002,10851660,1332658
2243,2021-09-30,4,Value,0,-9519002,10851660,1332658
2243,2021-12-31,4,Value,0,-9519002,10851660,1332658
2248,2021-12-31,12961,Value,0,-17399035,27832033,10432998
2256,2020-03-31,902,Value,695160,-10000001,10898373,898372
2256,2020-06-30,902,Value,733900,-10000001,10898373,898372
2256,2020-09-30,902,Value,678130,-10000001,10898373,898372
2256,2020-11-15,902,Distribution,92093,-10000001,10990466,990465
2256,2020-12-31,902,Value,945920,-10000001,10990466,990465
2256,2021-03-31,902,Value,942960,-10000001,10990466,990465
2256,2021-06-30,902,Value,942050,-10000001,10990466,990465
2262,2020-03-31,758,Value,0,-9700001,6857902,-2842099
2262,2020-06-30,758,Value,0,-9700001,6857902,-2842099
2262,2020-09-30,758,Value,0,-9700001,6857902,-2842099
2262,2020-12-31,758,Value,0,-9700001,6857902,-2842099
2262,2021-03-31,758,Value,0,-9700001,6857902,-2842099
2262,2021-06-30,758,Value,0,-9700001,6857902,-2842099
2262,2021-09-30,758,Value,0,-9700001,6857902,-2842099
2262,2021-12-31,758,Value,0,-9700001,6857902,-2842099
2273,2020-03-31,189,Value,0,-10000000,11059538,1059538
2273,2020-06-30,189,Value,0,-10000000,11059538,1059538
2273,2020-09-30,189,Value,0,-10000000,11059538,1059538
2273,2020-12-31,189,Value,0,-10000000,11059538,1059538
2273,2021-03-31,189,Value,0,-10000000,11059538,1059538
2273,2021-06-30,189,Value,0,-10000000,11059538,1059538
2273,2021-09-30,189,Value,0,-10000000,11059538,1059538
2273,2021-12-31,189,Value,0,-10000000,11059538,1059538
2275,2020-03-31,906,Value,0,-9750000,10081036,331036
2275,2020-06-30,906,Value,0,-9750000,10081036,331036
2275,2020-09-30,906,Value,0,-9750000,10081036,331036
2275,2020-12-31,906,Value,0,-9750000,10081036,331036
2275,2021-03-31,906,Value,0,-9750000,10081036,331036
2275,2021-06-30,906,Value,0,-9750000,10081036,331036
2275,2021-09-30,906,Value,0,-9750000,10081036,331036
2275,2021-12-31,906,Value,0,-9750000,10081036,331036
2276,2020-02-15,906,Distribution,119957,-9350001,23220415,13870414
2276,2020-03-31,906,Value,0,-9350001,23220415,13870414
2276,2020-09-30,906,Value,0,-9350001,23220415,13870414
2276,2020-12-31,906,Value,0,-9350001,23220415,13870414
2276,2021-03-31,906,Value,0,-9350001,23220415,13870414
2276,2021-06-30,906,Value,0,-9350001,23220415,13870414
2276,2021-09-30,906,Value,0,-9350001,23220415,13870414
2276,2021-12-31,906,Value,0,-9350001,23220415,13870414
2280,2020-03-31,589,Value,0,-9999999,14696001,4696002
2280,2020-06-30,589,Value,0,-9999999,14696001,4696002
2280,2020-09-30,589,Value,0,-9999999,14696001,4696002
2280,2020-12-31,589,Value,0,-9999999,14696001,4696002
2280,2021-03-31,589,Value,0,-9999999,14696001,4696002
2280,2021-06-30,589,Value,0,-9999999,14696001,4696002
2280,2021-09-30,589,Value,0,-9999999,14696001,4696002
2280,2021-12-31,589,Value,0,-9999999,14696001,4696002
2283,2020-03-31,920,Value,269990,-14432787,10984340,-3448447
2283,2020-06-30,920,Value,269050,-14432787,10984340,-3448447
2283,2020-09-30,920,Value,268610,-14432787,10984340,-3448447
2283,2020-12-31,920,Value,263690,-14432787,10984340,-3448447
2283,2021-03-31,920,Value,263390,-14432787,10984340,-3448447
2283,2021-06-30,920,Value,302840,-14432787,10984340,-3448447
2283,2021-12-31,920,Value,0,-14432787,10984340,-3448447
2285,2021-12-31,17285,Value,0,-10673578,17006976,6333398
2290,2020-03-31,923,Value,0,-8868158,2395288,-6472870
2290,2020-06-30,923,Value,0,-8868158,2395288,-6472870
2290,2020-09-30,923,Value,0,-8868158,2395288,-6472870
2290,2020-12-31,923,Value,0,-8868158,2395288,-6472870
2290,2021-03-31,923,Value,0,-8868158,2395288,-6472870
2290,2021-06-30,923,Value,0,-8868158,2395288,-6472870
2290,2021-09-30,923,Value,0,-8868158,2395288,-6472870
2290,2021-12-31,923,Value,0,-8868158,2395288,-6472870
2293,2020-02-15,910,Capital Call,-89191,-12255129,16267822,4012693
2293,2020-02-15,910,Distribution,92339,-12255129,16360161,4105032
2293,2020-03-31,910,Value,722360,-12255129,16360161,4105032
2293,2020-05-16,910,Capital Call,-3116,-12258245,16360161,4101916
2293,2020-05-16,910,Distribution,2972,-12258245,16363133,4104888
2293,2020-06-30,910,Value,781390,-12258245,16363133,4104888
2293,2020-08-15,910,Capital Call,-1456,-12259701,16363133,4103432
2293,2020-08-15,910,Distribution,68733,-12259701,16431866,4172165
2293,2020-09-30,910,Value,752160,-12259701,16431866,4172165
2297,2020-03-31,218,Value,0,-8745676,6844001,-1901675
2297,2020-06-30,218,Value,0,-8745676,6844001,-1901675
2297,2020-09-30,218,Value,0,-8745676,6844001,-1901675
2297,2020-12-31,218,Value,0,-8745676,6844001,-1901675
2297,2021-03-31,218,Value,0,-8745676,6844001,-1901675
2297,2021-06-30,218,Value,0,-8745676,6844001,-1901675
2297,2021-09-30,218,Value,0,-8745676,6844001,-1901675
2297,2021-12-31,218,Value,0,-8745676,6844001,-1901675
2301,2021-12-31,716,Value,0,-9866665,6933333,-2933332
2302,2020-03-31,716,Value,0,-10000000,22219111,12219111
2302,2020-06-30,716,Value,0,-10000000,22219111,12219111
2302,2020-09-30,716,Value,0,-10000000,22219111,12219111
2302,2020-12-31,716,Value,0,-10000000,22219111,12219111
2302,2021-03-31,716,Value,0,-10000000,22219111,12219111
2302,2021-06-30,716,Value,0,-10000000,22219111,12219111
2302,2021-09-30,716,Value,0,-10000000,22219111,12219111
2302,2021-12-31,716,Value,0,-10000000,22219111,12219111
2306,2020-01-15,454,Capital Call,0,-10362366,20319996,9957630
2306,2020-01-15,454,Distribution,10998,-10362366,20330994,9968628
2306,2020-02-29,454,Value,0,-10362366,20330994,9968628
2306,2020-04-15,454,Capital Call,0,-10362366,20330994,9968628
2306,2020-04-15,454,Distribution,0,-10362366,20330994,9968628
2306,2020-05-31,454,Value,0,-10362366,20330994,9968628
2306,2020-08-31,454,Value,0,-10362366,20330994,9968628
2306,2020-11-30,454,Value,0,-10362366,20330994,9968628
2306,2021-02-28,454,Value,0,-10362366,20330994,9968628
2306,2021-05-31,454,Value,0,-10362366,20330994,9968628
2306,2021-08-31,454,Value,0,-10362366,20330994,9968628
2306,2021-10-16,454,Capital Call,0,-10362366,20330994,9968628
2306,2021-10-16,454,Distribution,0,-10362366,20330994,9968628
2306,2021-12-31,454,Value,0,-10362366,20330994,9968628
2324,2020-03-31,3620,Value,5049000,-9954000,7730000,-2224000
2324,2020-05-16,3620,Distribution,652000,-9954000,8382000,-1572000
2324,2020-06-30,3620,Value,3413000,-9954000,8382000,-1572000
2324,2020-08-15,3620,Distribution,82000,-9954000,8464000,-1490000
2324,2020-09-30,3620,Value,3482000,-9954000,8464000,-1490000
2324,2020-12-31,3620,Value,3792000,-9954000,8464000,-1490000
2326,2020-03-31,934,Value,0,-9850000,6452735,-3397265
2326,2020-06-30,934,Value,0,-9850000,6452735,-3397265
2326,2020-09-30,934,Value,0,-9850000,6452735,-3397265
2326,2020-12-31,934,Value,0,-9850000,6452735,-3397265
2326,2021-03-31,934,Value,0,-9850000,6452735,-3397265
2326,2021-06-30,934,Value,0,-9850000,6452735,-3397265
2326,2021-09-30,934,Value,0,-9850000,6452735,-3397265
2326,2021-12-31,934,Value,0,-9850000,6452735,-3397265
2327,2021-12-31,934,Value,0,-10000000,7701197,-2298803
2390,2020-03-31,1383,Value,0,-9370000,15741600,6371600
2390,2020-06-30,1383,Value,0,-9370000,15741600,6371600
2390,2020-09-30,1383,Value,0,-9370000,15741600,6371600
2390,2020-12-31,1383,Value,0,-9370000,15741600,6371600
2390,2021-03-31,1383,Value,0,-9370000,15741600,6371600
2390,2021-06-30,1383,Value,0,-9370000,15741600,6371600
2390,2021-09-30,1383,Value,0,-9370000,15741600,6371600
2390,2021-12-31,1383,Value,0,-9370000,15741600,6371600
2397,2021-12-31,1366,Value,0,-9650000,11510000,1860000
2406,2021-12-31,1389,Value,0,-11185182,9037037,-2148145
2407,2020-03-31,938,Value,0,-9899998,15666668,5766670
2407,2020-06-30,938,Value,0,-9899998,15666668,5766670
2407,2020-09-30,938,Value,0,-9899998,15666668,5766670
2407,2020-12-31,938,Value,0,-9899998,15666668,5766670
2407,2021-03-31,938,Value,0,-9899998,15666668,5766670
2407,2021-06-30,938,Value,0,-9899998,15666668,5766670
2407,2021-09-30,938,Value,0,-9899998,15666668,5766670
2407,2021-12-31,938,Value,0,-9899998,15666668,5766670
2408,2020-02-15,11277,Capital Call,-10417,-9677084,12843750,3166666
2408,2020-02-15,11277,Distribution,41667,-9677084,12885417,3208333
2408,2020-03-31,11277,Value,885410,-9677084,12885417,3208333
2408,2020-06-30,11277,Value,875000,-9677084,12885417,3208333
2408,2020-09-30,11277,Value,875000,-9677084,12885417,3208333
2408,2021-12-31,11277,Value,0,-9677084,12885417,3208333
2411,2020-03-31,745,Value,0,-9200000,10160000,960000
2411,2020-06-30,745,Value,0,-9200000,10160000,960000
2411,2020-09-30,745,Value,0,-9200000,10160000,960000
2411,2020-12-31,745,Value,0,-9200000,10160000,960000
2411,2021-03-31,745,Value,0,-9200000,10160000,960000
2411,2021-06-30,745,Value,0,-9200000,10160000,960000
2411,2021-09-30,745,Value,0,-9200000,10160000,960000
2411,2021-12-31,745,Value,0,-9200000,10160000,960000
2447,2021-12-31,1412,Value,0,-10000000,3300000,-6700000
2449,2020-03-31,563,Value,0,-9933333,4271333,-5662000
2449,2020-06-30,563,Value,0,-9933333,4271333,-5662000
2449,2020-09-30,563,Value,0,-9933333,4271333,-5662000
2449,2020-12-31,563,Value,0,-9933333,4271333,-5662000
2449,2021-03-31,563,Value,0,-9933333,4271333,-5662000
2449,2021-06-30,563,Value,0,-9933333,4271333,-5662000
2449,2021-09-30,563,Value,0,-9933333,4271333,-5662000
2449,2021-12-31,563,Value,0,-9933333,4271333,-5662000
2483,2020-03-31,1447,Value,0,-9700000,7231096,-2468904
2483,2020-06-30,1447,Value,0,-9700000,7231096,-2468904
2483,2020-09-30,1447,Value,0,-9700000,7231096,-2468904
2483,2020-12-31,1447,Value,0,-9700000,7231096,-2468904
2483,2021-03-31,1447,Value,0,-9700000,7231096,-2468904
2483,2021-06-30,1447,Value,0,-9700000,7231096,-2468904
2483,2021-09-30,1447,Value,0,-9700000,7231096,-2468904
2483,2021-12-31,1447,Value,0,-9700000,7231096,-2468904
2514,2020-03-31,94982,Value,0,-9994001,3704777,-6289224
2514,2020-06-30,94982,Value,0,-9994001,3704777,-6289224
2514,2020-09-30,94982,Value,0,-9994001,3704777,-6289224
2514,2020-12-31,94982,Value,0,-9994001,3704777,-6289224
2514,2021-03-31,94982,Value,0,-9994001,3704777,-6289224
2514,2021-06-30,94982,Value,0,-9994001,3704777,-6289224
2514,2021-09-30,94982,Value,0,-9994001,3704777,-6289224
2514,2021-12-31,94982,Value,0,-9994001,3704777,-6289224
2535,2020-03-31,832,Value,0,-9754999,15632387,5877388
2535,2020-06-30,832,Value,0,-9754999,15632387,5877388
2535,2020-09-30,832,Value,0,-9754999,15632387,5877388
2535,2020-12-31,832,Value,0,-9754999,15632387,5877388
2535,2021-03-31,832,Value,0,-9754999,15632387,5877388
2535,2021-06-30,832,Value,0,-9754999,15632387,5877388
2535,2021-09-30,832,Value,0,-9754999,15632387,5877388
2535,2021-12-31,832,Value,0,-9754999,15632387,5877388
2553,2020-03-31,1480,Value,0,-9999998,10174001,174003
2553,2020-06-30,1480,Value,0,-9999998,10174001,174003
2553,2020-09-30,1480,Value,0,-9999998,10174001,174003
2553,2020-12-31,1480,Value,0,-9999998,10174001,174003
2553,2021-03-31,1480,Value,0,-9999998,10174001,174003
2553,2021-06-30,1480,Value,0,-9999998,10174001,174003
2553,2021-09-30,1480,Value,0,-9999998,10174001,174003
2553,2021-12-31,1480,Value,0,-9999998,10174001,174003
2554,2020-03-31,1480,Value,0,-10000002,17220004,7220002
2554,2020-05-16,1480,Distribution,-2000,-10000002,17218004,7218002
2554,2020-06-30,1480,Value,0,-10000002,17218004,7218002
2554,2020-09-30,1480,Value,0,-10000002,17218004,7218002
2554,2020-12-31,1480,Value,0,-10000002,17218004,7218002
2554,2021-03-31,1480,Value,0,-10000002,17218004,7218002
2554,2021-06-30,1480,Value,0,-10000002,17218004,7218002
2554,2021-09-30,1480,Value,0,-10000002,17218004,7218002
2554,2021-12-31,1480,Value,0,-10000002,17218004,7218002
2556,2020-03-31,1481,Value,0,-10000000,4234492,-5765508
2556,2020-06-30,1481,Value,0,-10000000,4234492,-5765508
2556,2020-09-30,1481,Value,0,-10000000,4234492,-5765508
2556,2020-12-31,1481,Value,0,-10000000,4234492,-5765508
2556,2021-03-31,1481,Value,0,-10000000,4234492,-5765508
2556,2021-06-30,1481,Value,0,-10000000,4234492,-5765508
2556,2021-09-30,1481,Value,0,-10000000,4234492,-5765508
2556,2021-12-31,1481,Value,0,-10000000,4234492,-5765508
2563,2020-03-31,1484,Value,0,-10053856,23236461,13182605
2563,2020-06-30,1484,Value,0,-10053856,23236461,13182605
2563,2020-09-30,1484,Value,0,-10053856,23236461,13182605
2563,2020-12-31,1484,Value,0,-10053856,23236461,13182605
2563,2021-03-31,1484,Value,0,-10053856,23236461,13182605
2563,2021-06-30,1484,Value,0,-10053856,23236461,13182605
2563,2021-09-30,1484,Value,0,-10053856,23236461,13182605
2563,2021-12-31,1484,Value,0,-10053856,23236461,13182605
2569,2020-03-31,1488,Value,1479190,-10000000,7703680,-2296320
2569,2020-06-30,1488,Value,1445740,-10000000,7703680,-2296320
2569,2020-09-30,1488,Value,1443220,-10000000,7703680,-2296320
2569,2020-12-31,1488,Value,1457670,-10000000,7703680,-2296320
2569,2021-03-31,1488,Value,1459140,-10000000,7703680,-2296320
2569,2021-06-30,1488,Value,1420920,-10000000,7703680,-2296320
2573,2020-03-31,47529,Value,0,-10000000,11980806,1980806
2573,2020-06-30,47529,Value,0,-10000000,11980806,1980806
2573,2020-09-30,47529,Value,0,-10000000,11980806,1980806
2573,2020-12-31,47529,Value,0,-10000000,11980806,1980806
2573,2021-03-31,47529,Value,0,-10000000,11980806,1980806
2573,2021-06-30,47529,Value,0,-10000000,11980806,1980806
2573,2021-09-30,47529,Value,0,-10000000,11980806,1980806
2573,2021-12-31,47529,Value,0,-10000000,11980806,1980806
2647,2021-12-31,400,Value,0,-10000000,29011428,19011428
2659,2021-12-31,1561,Value,0,-10000000,5604461,-4395539
2662,2021-12-31,920,Value,0,-10000000,9400547,-599453
2670,2020-01-15,895,Capital Call,0,-10934412,8612689,-2321723
2670,2020-01-15,895,Distribution,0,-10934412,8612689,-2321723
2670,2020-02-29,895,Value,2249490,-10934412,8612689,-2321723
2670,2020-04-15,895,Capital Call,0,-10934412,8612689,-2321723
2670,2020-04-15,895,Distribution,0,-10934412,8612689,-2321723
2670,2020-05-31,895,Value,1746190,-10934412,8612689,-2321723
2670,2020-08-31,895,Value,1682960,-10934412,8612689,-2321723
2670,2020-10-16,895,Capital Call,-81914,-11016326,8612689,-2403637
2670,2020-11-30,895,Value,1754160,-11016326,8612689,-2403637
2670,2021-02-28,895,Value,1754160,-11016326,8612689,-2403637
2670,2021-05-31,895,Value,2015150,-11016326,8612689,-2403637
2670,2021-08-31,895,Value,2055010,-11016326,8612689,-2403637
2670,2021-10-16,895,Capital Call,0,-11016326,8612689,-2403637
2670,2021-10-16,895,Distribution,0,-11016326,8612689,-2403637
2670,2021-11-30,895,Value,2289070,-11016326,8612689,-2403637
2924,2020-03-31,450,Value,0,-9600001,20662080,11062079
2924,2020-06-30,450,Value,0,-9600001,20662080,11062079
2924,2020-09-30,450,Value,0,-9600001,20662080,11062079
2924,2020-12-31,450,Value,0,-9600001,20662080,11062079
2924,2021-03-31,450,Value,0,-9600001,20662080,11062079
2924,2021-06-30,450,Value,0,-9600001,20662080,11062079
2924,2021-09-30,450,Value,0,-9600001,20662080,11062079
2924,2021-12-31,450,Value,0,-9600001,20662080,11062079
2937,2020-02-15,545,Capital Call,0,-11250919,30059407,18808488
2937,2020-02-15,545,Distribution,0,-11250919,30059407,18808488
2937,2020-03-31,545,Value,86420,-11250919,30059407,18808488
2937,2020-06-30,545,Value,86440,-11250919,30059407,18808488
2937,2020-09-30,545,Value,84100,-11250919,30059407,18808488
2937,2020-12-31,545,Value,82690,-11250919,30059407,18808488
2937,2021-03-31,545,Value,82340,-11250919,30059407,18808488
2937,2021-05-16,545,Distribution,42309,-11250919,30101716,18850797
2937,2021-06-30,545,Value,36560,-11250919,30101716,18850797
2937,2021-09-30,545,Value,43250,-11250919,30101716,18850797
2937,2021-12-31,545,Value,42790,-11250919,30101716,18850797
2941,2020-03-31,1886,Value,459110,-9308273,15266655,5958382
2941,2020-06-30,1886,Value,459110,-9308273,15266655,5958382
2941,2020-08-15,1886,Capital Call,273,-9308000,15266655,5958655
2941,2020-08-15,1886,Distribution,-604,-9308000,15266051,5958051
2941,2020-09-30,1886,Value,449490,-9308000,15266051,5958051
2941,2020-11-15,1886,Capital Call,-170,-9308170,15266051,5957881
2941,2020-11-15,1886,Distribution,434,-9308170,15266485,5958315
2941,2020-12-31,1886,Value,454700,-9308170,15266485,5958315
2941,2021-02-14,1886,Capital Call,-176,-9308346,15266485,5958139
2941,2021-02-14,1886,Distribution,134,-9308346,15266619,5958273
2941,2021-03-31,1886,Value,529490,-9308346,15266619,5958273
2941,2021-05-16,1886,Capital Call,176,-9308170,15266619,5958449
2941,2021-05-16,1886,Distribution,-133,-9308170,15266486,5958316
2941,2021-06-30,1886,Value,523720,-9308170,15266486,5958316
2941,2021-08-15,1886,Capital Call,170,-9308000,15266486,5958486
2941,2021-08-15,1886,Distribution,-435,-9308000,15266051,5958051
2941,2021-09-30,1886,Value,574300,-9308000,15266051,5958051
2942,2020-03-31,1986,Value,0,-8875600,10331820,1456220
2942,2020-06-30,1986,Value,0,-8875600,10331820,1456220
2942,2020-09-30,1986,Value,0,-8875600,10331820,1456220
2942,2020-12-31,1986,Value,0,-8875600,10331820,1456220
2942,2021-03-31,1986,Value,0,-8875600,10331820,1456220
2942,2021-06-30,1986,Value,0,-8875600,10331820,1456220
2942,2021-09-30,1986,Value,0,-8875600,10331820,1456220
2942,2021-12-31,1986,Value,0,-8875600,10331820,1456220
2944,2020-03-31,1986,Value,0,-9999999,7880544,-2119455
2944,2020-06-30,1986,Value,0,-9999999,7880544,-2119455
2944,2020-09-30,1986,Value,0,-9999999,7880544,-2119455
2944,2020-12-31,1986,Value,0,-9999999,7880544,-2119455
2944,2021-03-31,1986,Value,0,-9999999,7880544,-2119455
2944,2021-06-30,1986,Value,0,-9999999,7880544,-2119455
2944,2021-09-30,1986,Value,0,-9999999,7880544,-2119455
2944,2021-12-31,1986,Value,0,-9999999,7880544,-2119455
2945,2020-03-31,1099,Value,0,-10000000,2731194,-7268806
2945,2020-06-30,1099,Value,0,-10000000,2731194,-7268806
2945,2020-09-30,1099,Value,0,-10000000,2731194,-7268806
2945,2020-12-31,1099,Value,0,-10000000,2731194,-7268806
2945,2021-03-31,1099,Value,0,-10000000,2731194,-7268806
2945,2021-06-30,1099,Value,0,-10000000,2731194,-7268806
2945,2021-09-30,1099,Value,0,-10000000,2731194,-7268806
2945,2021-12-31,1099,Value,0,-10000000,2731194,-7268806
2946,2020-03-31,291,Value,159470,-10000000,14311934,4311934
2946,2020-06-30,291,Value,159470,-10000000,14311934,4311934
2946,2020-09-30,291,Value,159470,-10000000,14311934,4311934
2946,2020-12-31,291,Value,159470,-10000000,14311934,4311934
2946,2021-03-31,291,Value,159470,-10000000,14311934,4311934
2946,2021-06-30,291,Value,159470,-10000000,14311934,4311934
2947,2020-03-31,59,Value,0,-10000000,12954454,2954454
2947,2020-06-30,59,Value,0,-10000000,12954454,2954454
2947,2020-09-30,59,Value,0,-10000000,12954454,2954454
2947,2020-12-31,59,Value,0,-10000000,12954454,2954454
2947,2021-03-31,59,Value,0,-10000000,12954454,2954454
2947,2021-06-30,59,Value,0,-10000000,12954454,2954454
2947,2021-09-30,59,Value,0,-10000000,12954454,2954454
2947,2021-12-31,59,Value,0,-10000000,12954454,2954454
2949,2020-03-31,1992,Value,3736500,-10000000,7316920,-2683080
2949,2020-06-30,1992,Value,1734910,-10000000,7316920,-2683080
2949,2020-09-30,1992,Value,1739510,-10000000,7316920,-2683080
2949,2020-12-31,1992,Value,2332280,-10000000,7316920,-2683080
2949,2021-03-31,1992,Value,2332280,-10000000,7316920,-2683080
2949,2021-06-30,1992,Value,2615540,-10000000,7316920,-2683080
2950,2020-03-31,2505,Value,0,-8140000,1415624,-6724376
2950,2020-06-30,2505,Value,0,-8140000,1415624,-6724376
2950,2020-09-30,2505,Value,0,-8140000,1415624,-6724376
2950,2020-12-31,2505,Value,0,-8140000,1415624,-6724376
2950,2021-03-31,2505,Value,0,-8140000,1415624,-6724376
2950,2021-06-30,2505,Value,0,-8140000,1415624,-6724376
2950,2021-09-30,2505,Value,0,-8140000,1415624,-6724376
2950,2021-12-31,2505,Value,0,-8140000,1415624,-6724376
2952,2020-03-31,1994,Value,0,-8902986,9026758,123772
2952,2020-06-30,1994,Value,0,-8902986,9026758,123772
2952,2020-09-30,1994,Value,0,-8902986,9026758,123772
2952,2020-12-31,1994,Value,0,-8902986,9026758,123772
2952,2021-03-31,1994,Value,0,-8902986,9026758,123772
2952,2021-06-30,1994,Value,0,-8902986,9026758,123772
2952,2021-09-30,1994,Value,0,-8902986,9026758,123772
2952,2021-12-31,1994,Value,0,-8902986,9026758,123772
2956,2020-02-15,1488,Distribution,294038,-10000000,8936526,-1063474
2956,2020-03-31,1488,Value,0,-10000000,8936526,-1063474
2956,2020-09-30,1488,Value,0,-10000000,8936526,-1063474
2956,2020-12-31,1488,Value,0,-10000000,8936526,-1063474
2956,2021-03-31,1488,Value,0,-10000000,8936526,-1063474
2956,2021-06-30,1488,Value,0,-10000000,8936526,-1063474
2956,2021-09-30,1488,Value,0,-10000000,8936526,-1063474
2956,2021-12-31,1488,Value,0,-10000000,8936526,-1063474
2958,2020-03-31,1997,Value,0,-10000001,9078877,-921124
2958,2020-06-30,1997,Value,0,-10000001,9078877,-921124
2958,2020-09-30,1997,Value,0,-10000001,9078877,-921124
2958,2020-12-31,1997,Value,0,-10000001,9078877,-921124
2958,2021-03-31,1997,Value,0,-10000001,9078877,-921124
2958,2021-06-30,1997,Value,0,-10000001,9078877,-921124
2958,2021-09-30,1997,Value,0,-10000001,9078877,-921124
2958,2021-12-31,1997,Value,0,-10000001,9078877,-921124
2959,2020-12-31,1998,Value,676600,-9950000,9114200,-835800
2961,2020-03-31,1252,Value,0,-9999999,7790141,-2209858
2961,2020-06-30,1252,Value,0,-9999999,7790141,-2209858
2961,2020-09-30,1252,Value,0,-9999999,7790141,-2209858
2961,2020-12-31,1252,Value,0,-9999999,7790141,-2209858
2961,2021-03-31,1252,Value,0,-9999999,7790141,-2209858
2961,2021-06-30,1252,Value,0,-9999999,7790141,-2209858
2961,2021-09-30,1252,Value,0,-9999999,7790141,-2209858
2961,2021-12-31,1252,Value,0,-9999999,7790141,-2209858
2964,2020-03-31,2001,Value,0,-10000000,2629270,-7370730
2964,2020-06-30,2001,Value,0,-10000000,2629270,-7370730
2964,2020-09-30,2001,Value,0,-10000000,2629270,-7370730
2964,2020-12-31,2001,Value,0,-10000000,2629270,-7370730
2964,2021-03-31,2001,Value,0,-10000000,2629270,-7370730
2964,2021-06-30,2001,Value,0,-10000000,2629270,-7370730
2964,2021-09-30,2001,Value,0,-10000000,2629270,-7370730
2964,2021-12-31,2001,Value,0,-10000000,2629270,-7370730
2968,2020-03-31,2004,Value,0,-10000001,13792866,3792865
2968,2020-06-30,2004,Value,0,-10000001,13792866,3792865
2968,2020-09-30,2004,Value,0,-10000001,13792866,3792865
2968,2020-12-31,2004,Value,0,-10000001,13792866,3792865
2968,2021-03-31,2004,Value,0,-10000001,13792866,3792865
2968,2021-06-30,2004,Value,0,-10000001,13792866,3792865
2968,2021-09-30,2004,Value,0,-10000001,13792866,3792865
2968,2021-12-31,2004,Value,0,-10000001,13792866,3792865
2972,2021-12-31,2007,Value,0,-9590000,33651310,24061310
2973,2020-03-31,2008,Value,0,-9999999,9969999,-30000
2973,2020-06-30,2008,Value,0,-9999999,9969999,-30000
2973,2020-09-30,2008,Value,0,-9999999,9969999,-30000
2973,2020-12-31,2008,Value,0,-9999999,9969999,-30000
2973,2021-03-31,2008,Value,0,-9999999,9969999,-30000
2973,2021-06-30,2008,Value,0,-9999999,9969999,-30000
2973,2021-09-30,2008,Value,0,-9999999,9969999,-30000
2973,2021-12-31,2008,Value,0,-9999999,9969999,-30000
2974,2020-03-31,2009,Value,0,-10000000,58000,-9942000
2974,2020-06-30,2009,Value,0,-10000000,58000,-9942000
2974,2020-09-30,2009,Value,0,-10000000,58000,-9942000
2974,2020-12-31,2009,Value,0,-10000000,58000,-9942000
2974,2021-03-31,2009,Value,0,-10000000,58000,-9942000
2974,2021-06-30,2009,Value,0,-10000000,58000,-9942000
2974,2021-09-30,2009,Value,0,-10000000,58000,-9942000
2974,2021-12-31,2009,Value,0,-10000000,58000,-9942000
2977,2020-02-03,515145,Distribution,818331,-9100000,11859807,2759807
2977,2020-03-31,515145,Value,466150,-9100000,11859807,2759807
2977,2020-05-16,515145,Capital Call,1354,-9098646,11859807,2761161
2977,2020-05-16,515145,Distribution,-1542,-9098646,11858265,2759619
2977,2020-06-30,515145,Value,482540,-9098646,11858265,2759619
2977,2020-08-15,515145,Capital Call,-1354,-9100000,11858265,2758265
2977,2020-08-15,515145,Distribution,1542,-9100000,11859807,2759807
2977,2020-09-30,515145,Value,505480,-9100000,11859807,2759807
2977,2021-02-14,515145,Capital Call,0,-9100000,11859807,2759807
2977,2021-02-14,515145,Distribution,253203,-9100000,12113010,3013010
2977,2021-06-30,515145,Value,236600,-9100000,12113010,3013010
2977,2021-08-15,515145,Distribution,200200,-9100000,12313210,3213210
2977,2021-09-30,515145,Value,30940,-9100000,12313210,3213210
2985,2020-02-15,2017,Distribution,120124,-9290702,25463682,16172980
2985,2020-03-31,2017,Value,0,-9290702,25463682,16172980
2985,2020-09-30,2017,Value,0,-9290702,25463682,16172980
2985,2020-12-31,2017,Value,0,-9290702,25463682,16172980
2985,2021-03-31,2017,Value,0,-9290702,25463682,16172980
2985,2021-06-30,2017,Value,0,-9290702,25463682,16172980
2985,2021-09-30,2017,Value,0,-9290702,25463682,16172980
2985,2021-12-31,2017,Value,0,-9290702,25463682,16172980
3044,2020-03-31,1886,Value,0,-10000002,4824325,-5175677
3044,2020-06-30,1886,Value,0,-10000002,4824325,-5175677
3044,2020-09-30,1886,Value,0,-10000002,4824325,-5175677
3044,2020-12-31,1886,Value,0,-10000002,4824325,-5175677
3044,2021-03-31,1886,Value,0,-10000002,4824325,-5175677
3044,2021-06-30,1886,Value,0,-10000002,4824325,-5175677
3044,2021-09-30,1886,Value,0,-10000002,4824325,-5175677
3044,2021-12-31,1886,Value,0,-10000002,4824325,-5175677
3067,2021-12-31,2068,Value,0,-10000999,9492950,-508049
3101,2020-02-15,596,Distribution,958128,-10000000,9811048,-188952
3101,2020-03-31,596,Value,0,-10000000,9811048,-188952
3101,2020-09-30,596,Value,0,-10000000,9811048,-188952
3101,2020-12-31,596,Value,0,-10000000,9811048,-188952
3101,2021-03-31,596,Value,0,-10000000,9811048,-188952
3101,2021-06-30,596,Value,0,-10000000,9811048,-188952
3101,2021-09-30,596,Value,0,-10000000,9811048,-188952
3101,2021-12-31,596,Value,0,-10000000,9811048,-188952
3117,2020-03-31,2115,Value,0,-9412727,12193030,2780303
3117,2020-06-30,2115,Value,0,-9412727,12193030,2780303
3117,2020-09-30,2115,Value,0,-9412727,12193030,2780303
3117,2020-12-31,2115,Value,0,-9412727,12193030,2780303
3117,2021-03-31,2115,Value,0,-9412727,12193030,2780303
3117,2021-06-30,2115,Value,0,-9412727,12193030,2780303
3117,2021-09-30,2115,Value,0,-9412727,12193030,2780303
3117,2021-12-31,2115,Value,0,-9412727,12193030,2780303
3167,2021-12-31,444,Value,0,-9506330,14610646,5104316
3176,2020-03-31,429,Value,76770,-9194801,7242571,-1952230
3176,2020-05-16,429,Distribution,76031,-9194801,7318602,-1876199
3176,2020-06-30,429,Value,0,-9194801,7318602,-1876199
3176,2021-12-31,429,Value,0,-9194801,7318602,-1876199
3179,2020-03-31,2152,Value,1246890,-10000000,5029048,-4970952
3179,2020-06-30,2152,Value,1144700,-10000000,5029048,-4970952
3179,2020-09-30,2152,Value,1143630,-10000000,5029048,-4970952
3179,2020-11-15,2152,Distribution,0,-10000000,5029048,-4970952
3179,2020-12-31,2152,Value,913410,-10000000,5029048,-4970952
3179,2021-02-14,2152,Distribution,0,-10000000,5029048,-4970952
3179,2021-03-31,2152,Value,1078250,-10000000,5029048,-4970952
3179,2021-06-30,2152,Value,1061400,-10000000,5029048,-4970952
3179,2021-09-30,2152,Value,1009420,-10000000,5029048,-4970952
3194,2020-02-15,589,Distribution,11056,-10094568,17187083,7092515
3194,2020-03-31,589,Value,24290,-10094568,17187083,7092515
3194,2020-06-30,589,Value,24820,-10094568,17187083,7092515
3194,2020-09-30,589,Value,25680,-10094568,17187083,7092515
3194,2020-12-31,589,Value,26620,-10094568,17187083,7092515
3194,2021-03-31,589,Value,35290,-10094568,17187083,7092515
3194,2021-06-30,589,Value,40120,-10094568,17187083,7092515
3194,2021-09-30,589,Value,39040,-10094568,17187083,7092515
3194,2021-12-31,589,Value,0,-10094568,17187083,7092515
3217,2020-03-31,2198,Value,0,-9850000,11855463,2005463
3217,2020-06-30,2198,Value,0,-9850000,11855463,2005463
3217,2020-09-30,2198,Value,0,-9850000,11855463,2005463
3217,2020-12-31,2198,Value,0,-9850000,11855463,2005463
3217,2021-03-31,2198,Value,0,-9850000,11855463,2005463
3217,2021-06-30,2198,Value,0,-9850000,11855463,2005463
3217,2021-09-30,2198,Value,0,-9850000,11855463,2005463
3217,2021-12-31,2198,Value,0,-9850000,11855463,2005463
3223,2020-03-31,332,Value,417300,-10794112,15182227,4388115
3223,2020-06-30,332,Value,417300,-10794112,15182227,4388115
3223,2020-08-15,332,Capital Call,-7634,-10801746,15182227,4380481
3223,2020-08-15,332,Distribution,81497,-10801746,15263724,4461978
3223,2020-09-30,332,Value,201860,-10801746,15263724,4461978
3223,2020-12-31,332,Value,201860,-10801746,15263724,4461978
3223,2021-03-31,332,Value,206890,-10801746,15263724,4461978
3223,2021-05-16,332,Capital Call,192024,-10609722,15263724,4654002
3223,2021-06-30,332,Value,206890,-10609722,15263724,4654002
3257,2021-12-31,715,Value,0,-9049866,16811599,7761733
3270,2020-03-31,2240,Value,0,-9548318,12893556,3345238
3270,2020-06-30,2240,Value,0,-9548318,12893556,3345238
3270,2020-09-30,2240,Value,0,-9548318,12893556,3345238
3270,2020-12-31,2240,Value,0,-9548318,12893556,3345238
3270,2021-03-31,2240,Value,0,-9548318,12893556,3345238
3270,2021-06-30,2240,Value,0,-9548318,12893556,3345238
3270,2021-09-30,2240,Value,0,-9548318,12893556,3345238
3270,2021-12-31,2240,Value,0,-9548318,12893556,3345238
3283,2020-03-31,334,Value,354010,-9933928,16176246,6242318
3283,2020-05-16,334,Distribution,262402,-9933928,16438648,6504720
3283,2020-06-30,334,Value,86990,-9933928,16438648,6504720
3283,2020-09-30,334,Value,72020,-9933928,16438648,6504720
3283,2020-12-31,334,Value,87020,-9933928,16438648,6504720
3283,2021-03-31,334,Value,93560,-9933928,16438648,6504720
3283,2021-05-16,334,Capital Call,-23070,-9956998,16438648,6481650
3283,2021-05-16,334,Distribution,85006,-9956998,16523654,6566656
3283,2021-06-30,334,Value,31620,-9956998,16523654,6566656
3329,2021-12-31,2304,Value,0,-9691437,17246045,7554608
3331,2021-12-31,466,Value,0,-9999999,16209001,6209002
3347,2020-03-31,308,Value,4662100,-11622648,13705687,2083039
3347,2020-06-30,308,Value,5548210,-11622648,13705687,2083039
3347,2020-09-30,308,Value,6309740,-11622648,13705687,2083039
3347,2020-12-31,308,Value,6309740,-11622648,13705687,2083039
3363,2020-03-31,1314,Value,0,-9843712,19817362,9973650
3363,2020-05-16,1314,Capital Call,15711,-9828001,19817362,9989361
3363,2020-05-16,1314,Distribution,-31630,-9828001,19785732,9957731
3363,2020-06-30,1314,Value,0,-9828001,19785732,9957731
3363,2020-09-30,1314,Value,0,-9828001,19785732,9957731
3363,2020-12-31,1314,Value,0,-9828001,19785732,9957731
3363,2021-03-31,1314,Value,0,-9828001,19785732,9957731
3363,2021-06-30,1314,Value,0,-9828001,19785732,9957731
3363,2021-09-30,1314,Value,0,-9828001,19785732,9957731
3363,2021-12-31,1314,Value,0,-9828001,19785732,9957731
3392,2020-02-15,18,Capital Call,351,-9500000,14249705,4749705
3392,2020-02-15,18,Distribution,-526,-9500000,14249179,4749179
3392,2020-03-31,18,Value,1073260,-9500000,14249179,4749179
3392,2020-06-30,18,Value,1210330,-9500000,14249179,4749179
3392,2020-09-30,18,Value,1287550,-9500000,14249179,4749179
3392,2020-11-15,18,Distribution,313309,-9500000,14562488,5062488
3392,2020-12-31,18,Value,1189200,-9500000,14562488,5062488
3392,2021-03-31,18,Value,1163050,-9500000,14562488,5062488
3392,2021-05-16,18,Capital Call,53,-9499947,14562488,5062541
3392,2021-05-16,18,Distribution,317478,-9499947,14879966,5380019
3392,2021-06-30,18,Value,912290,-9499947,14879966,5380019
3392,2021-08-15,18,Capital Call,-53,-9500000,14879966,5379966
3392,2021-08-15,18,Distribution,-116,-9500000,14879850,5379850
3392,2021-09-30,18,Value,705840,-9500000,14879850,5379850
3396,2020-01-15,52,Capital Call,0,-10001428,8586653,-1414775
3396,2020-01-15,52,Distribution,41124,-10001428,8627777,-1373651
3396,2020-02-29,52,Value,2629740,-10001428,8627777,-1373651
3396,2020-04-15,52,Capital Call,0,-10001428,8627777,-1373651
3396,2020-04-15,52,Distribution,0,-10001428,8627777,-1373651
3396,2020-05-31,52,Value,2392210,-10001428,8627777,-1373651
3396,2020-07-16,52,Distribution,662807,-10001428,9290584,-710844
3396,2020-08-31,52,Value,2451980,-10001428,9290584,-710844
3396,2020-10-16,52,Distribution,663102,-10001428,9953686,-47742
3396,2020-11-30,52,Value,2270040,-10001428,9953686,-47742
3396,2021-01-14,52,Distribution,46677,-10001428,10000363,-1065
3396,2021-02-28,52,Value,2223360,-10001428,10000363,-1065
3396,2021-04-15,52,Distribution,1407580,-10001428,11407943,1406515
3396,2021-05-31,52,Value,1367760,-10001428,11407943,1406515
3396,2021-07-16,52,Distribution,440400,-10001428,11848343,1846915
3396,2021-08-31,52,Value,914080,-10001428,11848343,1846915
3396,2021-10-16,52,Capital Call,0,-10001428,11848343,1846915
3396,2021-10-16,52,Distribution,526090,-10001428,12374433,2373005
3396,2021-11-30,52,Value,334710,-10001428,12374433,2373005
3402,2020-03-31,2258,Value,0,-10000000,1833000,-8167000
3402,2020-06-30,2258,Value,0,-10000000,1833000,-8167000
3402,2020-09-30,2258,Value,0,-10000000,1833000,-8167000
3402,2020-12-31,2258,Value,0,-10000000,1833000,-8167000
3402,2021-03-31,2258,Value,0,-10000000,1833000,-8167000
3402,2021-06-30,2258,Value,0,-10000000,1833000,-8167000
3402,2021-09-30,2258,Value,0,-10000000,1833000,-8167000
3402,2021-12-31,2258,Value,0,-10000000,1833000,-8167000
3478,2020-03-31,293,Value,0,-10000000,5424999,-4575001
3478,2020-06-30,293,Value,0,-10000000,5424999,-4575001
3478,2020-09-30,293,Value,0,-10000000,5424999,-4575001
3478,2020-12-31,293,Value,0,-10000000,5424999,-4575001
3478,2021-03-31,293,Value,0,-10000000,5424999,-4575001
3478,2021-06-30,293,Value,0,-10000000,5424999,-4575001
3478,2021-09-30,293,Value,0,-10000000,5424999,-4575001
3478,2021-12-31,293,Value,0,-10000000,5424999,-4575001
3488,2020-03-31,355,Value,175050,-9400000,13596630,4196630
3488,2020-06-30,355,Value,180720,-9400000,13596630,4196630
3488,2020-09-30,355,Value,182420,-9400000,13596630,4196630
3488,2020-11-15,355,Distribution,28010,-9400000,13624640,4224640
3488,2020-12-31,355,Value,145260,-9400000,13624640,4224640
3488,2021-02-14,355,Distribution,70020,-9400000,13694660,4294660
3488,2021-03-31,355,Value,74890,-9400000,13694660,4294660
3488,2021-06-30,355,Value,74190,-9400000,13694660,4294660
3489,2020-03-31,2514,Value,0,-10758401,10709191,-49210
3489,2020-06-30,2514,Value,0,-10758401,10709191,-49210
3489,2020-09-30,2514,Value,0,-10758401,10709191,-49210
3489,2020-12-31,2514,Value,0,-10758401,10709191,-49210
3489,2021-03-31,2514,Value,0,-10758401,10709191,-49210
3489,2021-06-30,2514,Value,0,-10758401,10709191,-49210
3489,2021-09-30,2514,Value,0,-10758401,10709191,-49210
3489,2021-12-31,2514,Value,0,-10758401,10709191,-49210
3490,2020-03-31,9,Value,323950,-9850000,11776930,1926930
3490,2020-06-30,9,Value,328590,-9850000,11776930,1926930
3490,2020-09-30,9,Value,325050,-9850000,11776930,1926930
3490,2020-12-31,9,Value,297250,-9850000,11776930,1926930
3490,2021-03-31,9,Value,348810,-9850000,11776930,1926930
3490,2021-06-30,9,Value,316720,-9850000,11776930,1926930
3491,2020-03-31,2515,Value,812500,-10070046,10509192,439146
3498,2021-12-31,2007,Value,0,-9999999,51100001,41100002
3499,2020-03-31,6468,Value,0,-10069708,10168099,98391
3499,2020-06-30,6468,Value,0,-10069708,10168099,98391
3499,2020-09-30,6468,Value,0,-10069708,10168099,98391
3499,2020-12-31,6468,Value,0,-10069708,10168099,98391
3499,2021-03-31,6468,Value,0,-10069708,10168099,98391
3499,2021-06-30,6468,Value,0,-10069708,10168099,98391
3499,2021-09-30,6468,Value,0,-10069708,10168099,98391
3499,2021-12-31,6468,Value,0,-10069708,10168099,98391
3515,2020-03-31,424,Value,16130,-10121900,16254653,6132753
3515,2020-06-30,424,Value,15910,-10121900,16254653,6132753
3515,2020-09-30,424,Value,15850,-10121900,16254653,6132753
3515,2020-12-31,424,Value,15480,-10121900,16254653,6132753
3515,2021-03-31,424,Value,15010,-10121900,16254653,6132753
3515,2021-06-30,424,Value,14810,-10121900,16254653,6132753
3515,2021-09-30,424,Value,14810,-10121900,16254653,6132753
3515,2021-12-31,424,Value,0,-10121900,16254653,6132753
3528,2020-02-15,733,Distribution,10000,-10850000,20780000,9930000
3528,2020-03-31,733,Value,309990,-10850000,20780000,9930000
3528,2020-06-30,733,Value,309990,-10850000,20780000,9930000
3528,2020-09-30,733,Value,289990,-10850000,20780000,9930000
3528,2020-12-31,733,Value,120000,-10850000,20780000,9930000
3528,2021-02-14,733,Distribution,100000,-10850000,20880000,10030000
3528,2021-03-31,733,Value,120000,-10850000,20880000,10030000
3528,2021-06-30,733,Value,120000,-10850000,20880000,10030000
3528,2021-08-15,733,Capital Call,-4000,-10854000,20880000,10026000
3528,2021-08-15,733,Distribution,2000,-10854000,20882000,10028000
3528,2021-09-30,733,Value,121000,-10854000,20882000,10028000
3570,2020-02-15,18,Capital Call,0,-9500113,13425560,3925447
3570,2020-02-15,18,Distribution,-68,-9500113,13425492,3925379
3570,2020-03-31,18,Value,1233600,-9500113,13425492,3925379
3570,2020-06-30,18,Value,1393920,-9500113,13425492,3925379
3570,2020-09-30,18,Value,1493000,-9500113,13425492,3925379
3570,2020-11-15,18,Distribution,342012,-9500113,13767504,4267391
3570,2020-12-31,18,Value,1495370,-9500113,13767504,4267391
3570,2021-03-31,18,Value,1575130,-9500113,13767504,4267391
3570,2021-05-16,18,Capital Call,113,-9500000,13767504,4267504
3570,2021-05-16,18,Distribution,329309,-9500000,14096813,4596813
3570,2021-06-30,18,Value,1320760,-9500000,14096813,4596813
3570,2021-09-30,18,Value,1158860,-9500000,14096813,4596813
3586,2020-03-31,395,Value,0,-10000000,15246273,5246273
3586,2020-06-30,395,Value,0,-10000000,15246273,5246273
3586,2020-09-30,395,Value,0,-10000000,15246273,5246273
3586,2020-12-31,395,Value,0,-10000000,15246273,5246273
3586,2021-03-31,395,Value,0,-10000000,15246273,5246273
3586,2021-06-30,395,Value,0,-10000000,15246273,5246273
3586,2021-09-30,395,Value,0,-10000000,15246273,5246273
3586,2021-12-31,395,Value,0,-10000000,15246273,5246273
3601,2020-03-31,336,Value,0,-10000001,15329591,5329590
3601,2020-06-30,336,Value,0,-10000001,15329591,5329590
3601,2020-09-30,336,Value,0,-10000001,15329591,5329590
3601,2020-12-31,336,Value,0,-10000001,15329591,5329590
3601,2021-12-31,336,Value,0,-10000001,15329591,5329590
3608,2020-03-31,121,Value,0,-10000002,23799997,13799995
3608,2020-06-30,121,Value,0,-10000002,23799997,13799995
3608,2020-09-30,121,Value,0,-10000002,23799997,13799995
3608,2020-12-31,121,Value,0,-10000002,23799997,13799995
3608,2021-03-31,121,Value,0,-10000002,23799997,13799995
3608,2021-06-30,121,Value,0,-10000002,23799997,13799995
3608,2021-09-30,121,Value,0,-10000002,23799997,13799995
3608,2021-12-31,121,Value,0,-10000002,23799997,13799995
3609,2020-02-15,18,Capital Call,0,-9550462,14248333,4697871
3609,2020-02-15,18,Distribution,73,-9550462,14248406,4697944
3609,2020-03-31,18,Value,1033780,-9550462,14248406,4697944
3609,2020-06-30,18,Value,1059590,-9550462,14248406,4697944
3609,2020-09-30,18,Value,1090080,-9550462,14248406,4697944
3609,2020-11-15,18,Distribution,223703,-9550462,14472109,4921647
3609,2020-12-31,18,Value,964890,-9550462,14472109,4921647
3609,2021-03-31,18,Value,980140,-9550462,14472109,4921647
3609,2021-05-16,18,Capital Call,462,-9550000,14472109,4922109
3609,2021-05-16,18,Distribution,-700,-9550000,14471409,4921409
3609,2021-06-30,18,Value,1019710,-9550000,14471409,4921409
3609,2021-09-30,18,Value,956430,-9550000,14471409,4921409
3610,2020-02-15,18,Capital Call,933,-9531002,12291869,2760867
3610,2020-02-15,18,Distribution,-1203,-9531002,12290666,2759664
3610,2020-03-31,18,Value,1195020,-9531002,12290666,2759664
3610,2020-06-30,18,Value,1224240,-9531002,12290666,2759664
3610,2020-09-30,18,Value,1265670,-9531002,12290666,2759664
3610,2020-12-31,18,Value,1386050,-9531002,12290666,2759664
3610,2021-03-31,18,Value,1402870,-9531002,12290666,2759664
3610,2021-05-16,18,Capital Call,1,-9531001,12290666,2759665
3610,2021-05-16,18,Distribution,340718,-9531001,12631384,3100383
3610,2021-06-30,18,Value,1109620,-9531001,12631384,3100383
3610,2021-09-30,18,Value,1021530,-9531001,12631384,3100383
3633,2021-12-31,2250,Value,0,-9465000,6941065,-2523935
3643,2020-02-15,674,Distribution,44852,-10855909,19005507,8149598
3643,2020-03-31,674,Value,8730,-10855909,19005507,8149598
3643,2020-06-30,674,Value,8680,-10855909,19005507,8149598
3643,2020-09-30,674,Value,8610,-10855909,19005507,8149598
3643,2020-12-31,674,Value,8530,-10855909,19005507,8149598
3643,2021-03-31,674,Value,4500,-10855909,19005507,8149598
3643,2021-06-30,674,Value,4440,-10855909,19005507,8149598
3646,2020-03-31,557,Value,0,-11082000,16999788,5917788
3646,2020-06-30,557,Value,0,-11082000,16999788,5917788
3646,2020-09-30,557,Value,0,-11082000,16999788,5917788
3646,2020-12-31,557,Value,0,-11082000,16999788,5917788
3646,2021-03-31,557,Value,0,-11082000,16999788,5917788
3646,2021-06-30,557,Value,0,-11082000,16999788,5917788
3646,2021-09-30,557,Value,0,-11082000,16999788,5917788
3646,2021-12-31,557,Value,0,-11082000,16999788,5917788
3648,2021-12-31,147,Value,0,-10138611,14045170,3906559
3650,2021-12-31,2616,Value,0,-9750000,2550000,-7200000
3669,2020-03-31,70,Value,0,-10000001,1651768,-8348233
3669,2020-06-30,70,Value,0,-10000001,1651768,-8348233
3669,2020-09-30,70,Value,0,-10000001,1651768,-8348233
3669,2020-12-31,70,Value,0,-10000001,1651768,-8348233
3669,2021-03-31,70,Value,0,-10000001,1651768,-8348233
3669,2021-06-30,70,Value,0,-10000001,1651768,-8348233
3669,2021-09-30,70,Value,0,-10000001,1651768,-8348233
3669,2021-12-31,70,Value,0,-10000001,1651768,-8348233
3723,2020-03-31,14411,Value,0,-9751911,13029527,3277616
3723,2020-06-30,14411,Value,0,-9751911,13029527,3277616
3723,2020-09-30,14411,Value,0,-9751911,13029527,3277616
3723,2020-12-31,14411,Value,0,-9751911,13029527,3277616
3723,2021-03-31,14411,Value,0,-9751911,13029527,3277616
3723,2021-06-30,14411,Value,0,-9751911,13029527,3277616
3723,2021-09-30,14411,Value,0,-9751911,13029527,3277616
3723,2021-12-31,14411,Value,0,-9751911,13029527,3277616
3724,2021-12-31,289,Value,0,-10000000,18242900,8242900
3733,2020-03-31,802,Value,0,-10000000,26619000,16619000
3733,2020-06-30,802,Value,0,-10000000,26619000,16619000
3733,2020-09-30,802,Value,0,-10000000,26619000,16619000
3733,2020-12-31,802,Value,0,-10000000,26619000,16619000
3733,2021-03-31,802,Value,0,-10000000,26619000,16619000
3733,2021-06-30,802,Value,0,-10000000,26619000,16619000
3733,2021-09-30,802,Value,0,-10000000,26619000,16619000
3733,2021-12-31,802,Value,0,-10000000,26619000,16619000
3735,2020-03-31,400,Value,0,-10020000,17424782,7404782
3735,2020-06-30,400,Value,0,-10020000,17424782,7404782
3735,2020-09-30,400,Value,0,-10020000,17424782,7404782
3735,2020-12-31,400,Value,0,-10020000,17424782,7404782
3735,2021-03-31,400,Value,0,-10020000,17424782,7404782
3735,2021-06-30,400,Value,0,-10020000,17424782,7404782
3735,2021-09-30,400,Value,0,-10020000,17424782,7404782
3735,2021-12-31,400,Value,0,-10020000,17424782,7404782
3736,2020-03-31,487,Value,0,-9999999,13028571,3028572
3736,2020-06-30,487,Value,0,-9999999,13028571,3028572
3736,2020-09-30,487,Value,0,-9999999,13028571,3028572
3736,2020-12-31,487,Value,0,-9999999,13028571,3028572
3736,2021-03-31,487,Value,0,-9999999,13028571,3028572
3736,2021-06-30,487,Value,0,-9999999,13028571,3028572
3736,2021-09-30,487,Value,0,-9999999,13028571,3028572
3736,2021-12-31,487,Value,0,-9999999,13028571,3028572
3737,2020-03-31,395,Value,0,-10000000,21461250,11461250
3737,2020-06-30,395,Value,0,-10000000,21461250,11461250
3737,2020-09-30,395,Value,0,-10000000,21461250,11461250
3737,2020-12-31,395,Value,0,-10000000,21461250,11461250
3737,2021-03-31,395,Value,0,-10000000,21461250,11461250
3737,2021-06-30,395,Value,0,-10000000,21461250,11461250
3737,2021-09-30,395,Value,0,-10000000,21461250,11461250
3737,2021-12-31,395,Value,0,-10000000,21461250,11461250
3738,2020-03-31,9177,Value,0,-10000000,17666668,7666668
3738,2020-06-30,9177,Value,0,-10000000,17666668,7666668
3738,2020-09-30,9177,Value,0,-10000000,17666668,7666668
3738,2020-12-31,9177,Value,0,-10000000,17666668,7666668
3738,2021-03-31,9177,Value,0,-10000000,17666668,7666668
3738,2021-06-30,9177,Value,0,-10000000,17666668,7666668
3738,2021-09-30,9177,Value,0,-10000000,17666668,7666668
3738,2021-12-31,9177,Value,0,-10000000,17666668,7666668
3739,2020-03-31,9177,Value,0,-10000000,22183332,12183332
3739,2020-06-30,9177,Value,0,-10000000,22183332,12183332
3739,2020-09-30,9177,Value,0,-10000000,22183332,12183332
3739,2020-12-31,9177,Value,0,-10000000,22183332,12183332
3739,2021-03-31,9177,Value,0,-10000000,22183332,12183332
3739,2021-06-30,9177,Value,0,-10000000,22183332,12183332
3739,2021-09-30,9177,Value,0,-10000000,22183332,12183332
3739,2021-12-31,9177,Value,0,-10000000,22183332,12183332
3755,2020-02-15,434,Distribution,483333,-9133333,10283638,1150305
3755,2020-03-31,434,Value,4658880,-9133333,10283638,1150305
3755,2020-05-16,434,Distribution,236667,-9133333,10520305,1386972
3755,2020-06-30,434,Value,4405850,-9133333,10520305,1386972
3755,2020-07-31,434,Capital Call,0,-9133333,10520305,1386972
3755,2020-07-31,434,Distribution,-1,-9133333,10520304,1386971
3755,2020-08-31,434,Value,4906010,-9133333,10520304,1386971
3755,2020-10-16,434,Distribution,460000,-9133333,10980304,1846971
3755,2020-11-30,434,Value,4446010,-9133333,10980304,1846971
3755,2021-01-14,434,Distribution,953333,-9133333,11933637,2800304
3755,2021-02-28,434,Value,4971890,-9133333,11933637,2800304
3755,2021-04-15,434,Distribution,326667,-9133333,12260304,3126971
3755,2021-05-31,434,Value,4645230,-9133333,12260304,3126971
3755,2021-07-16,434,Distribution,740000,-9133333,13000304,3866971
3755,2021-08-31,434,Value,6047900,-9133333,13000304,3866971
3755,2021-10-16,434,Distribution,1246667,-9133333,14246971,5113638
3755,2021-11-30,434,Value,4801230,-9133333,14246971,5113638
3766,2020-03-31,22872,Value,1240000,-11000000,15079999,4079999
3766,2020-06-30,22872,Value,1240000,-11000000,15079999,4079999
3766,2020-09-30,22872,Value,1240000,-11000000,15079999,4079999
3766,2020-12-31,22872,Value,746660,-11000000,15079999,4079999
3766,2021-03-31,22872,Value,746660,-11000000,15079999,4079999
3766,2021-06-30,22872,Value,746660,-11000000,15079999,4079999
3766,2021-08-15,22872,Capital Call,-4000,-11004000,15079999,4075999
3766,2021-08-15,22872,Distribution,5333,-11004000,15085332,4081332
3766,2021-09-30,22872,Value,751990,-11004000,15085332,4081332
3771,2020-03-31,1637,Value,0,-9525000,11708928,2183928
3771,2020-06-30,1637,Value,0,-9525000,11708928,2183928
3771,2020-09-30,1637,Value,0,-9525000,11708928,2183928
3771,2020-12-31,1637,Value,0,-9525000,11708928,2183928
3771,2021-03-31,1637,Value,0,-9525000,11708928,2183928
3771,2021-06-30,1637,Value,0,-9525000,11708928,2183928
3771,2021-09-30,1637,Value,0,-9525000,11708928,2183928
3771,2021-12-31,1637,Value,0,-9525000,11708928,2183928
3774,2020-03-31,6322,Value,0,-9220000,32460001,23240001
3774,2020-06-30,6322,Value,0,-9220000,32460001,23240001
3774,2020-09-30,6322,Value,0,-9220000,32460001,23240001
3774,2020-12-31,6322,Value,0,-9220000,32460001,23240001
3774,2021-03-31,6322,Value,0,-9220000,32460001,23240001
3774,2021-06-30,6322,Value,0,-9220000,32460001,23240001
3774,2021-09-30,6322,Value,0,-9220000,32460001,23240001
3774,2021-12-31,6322,Value,0,-9220000,32460001,23240001
3786,2020-03-31,15554,Value,50440,-19576001,51539484,31963483
3786,2020-05-14,15554,Distribution,81408,-19576001,51620892,32044891
3786,2021-06-30,15554,Value,11200,-19576001,51620892,32044891
3786,2021-12-31,15554,Value,13810,-19576001,51620892,32044891
3802,2021-12-31,1463,Value,0,-10000000,7083242,-2916758
3804,2020-03-31,2238,Value,0,-9822275,30304839,20482564
3804,2020-06-30,2238,Value,0,-9822275,30304839,20482564
3804,2020-09-30,2238,Value,0,-9822275,30304839,20482564
3804,2020-12-31,2238,Value,0,-9822275,30304839,20482564
3804,2021-03-31,2238,Value,0,-9822275,30304839,20482564
3804,2021-06-30,2238,Value,0,-9822275,30304839,20482564
3804,2021-09-30,2238,Value,0,-9822275,30304839,20482564
3804,2021-12-31,2238,Value,0,-9822275,30304839,20482564
3830,2020-02-15,1314,Distribution,25288,-9726001,15491576,5765575
3830,2020-03-31,1314,Value,1077640,-9726001,15491576,5765575
3830,2020-05-16,1314,Distribution,74890,-9726001,15566466,5840465
3830,2020-06-30,1314,Value,974540,-9726001,15566466,5840465
3830,2020-09-30,1314,Value,1081530,-9726001,15566466,5840465
3830,2020-12-31,1314,Value,1154470,-9726001,15566466,5840465
3830,2021-02-14,1314,Distribution,118657,-9726001,15685123,5959122
3830,2021-03-31,1314,Value,1050400,-9726001,15685123,5959122
3830,2021-05-16,1314,Distribution,49603,-9726001,15734726,6008725
3830,2021-06-30,1314,Value,1002750,-9726001,15734726,6008725
3831,2020-03-31,3731,Value,0,-10000001,9242888,-757113
3831,2020-06-30,3731,Value,0,-10000001,9242888,-757113
3831,2020-09-30,3731,Value,0,-10000001,9242888,-757113
3831,2020-12-31,3731,Value,0,-10000001,9242888,-757113
3831,2021-03-31,3731,Value,0,-10000001,9242888,-757113
3831,2021-06-30,3731,Value,0,-10000001,9242888,-757113
3831,2021-09-30,3731,Value,0,-10000001,9242888,-757113
3831,2021-12-31,3731,Value,0,-10000001,9242888,-757113
3836,2021-12-31,1252,Value,0,-8420000,420000,-8000000
3851,2020-02-15,1886,Distribution,320000,-9700000,15293661,5593661
3851,2020-03-31,1886,Value,1167330,-9700000,15293661,5593661
3851,2020-06-30,1886,Value,1278180,-9700000,15293661,5593661
3851,2020-09-30,1886,Value,1368850,-9700000,15293661,5593661
3851,2020-11-15,1886,Capital Call,52,-9699948,15293661,5593713
3851,2020-11-15,1886,Distribution,-81,-9699948,15293580,5593632
3851,2020-12-31,1886,Value,1368840,-9699948,15293580,5593632
3851,2021-02-14,1886,Capital Call,-52,-9700000,15293580,5593580
3851,2021-02-14,1886,Distribution,225057,-9700000,15518637,5818637
3851,2021-03-31,1886,Value,1270450,-9700000,15518637,5818637
3851,2021-05-16,1886,Capital Call,51,-9699949,15518637,5818688
3851,2021-05-16,1886,Distribution,295404,-9699949,15814041,6114092
3851,2021-06-30,1886,Value,437690,-9699949,15814041,6114092
3851,2021-08-15,1886,Capital Call,-51,-9700000,15814041,6114041
3851,2021-08-15,1886,Distribution,84,-9700000,15814125,6114125
3851,2021-09-30,1886,Value,347300,-9700000,15814125,6114125
3852,2020-02-15,1886,Distribution,400000,-9700000,16319409,6619409
3852,2020-03-31,1886,Value,1123280,-9700000,16319409,6619409
3852,2020-06-30,1886,Value,1123280,-9700000,16319409,6619409
3852,2020-09-30,1886,Value,1202780,-9700000,16319409,6619409
3852,2020-11-15,1886,Capital Call,108,-9699892,16319409,6619517
3852,2020-11-15,1886,Distribution,-183,-9699892,16319226,6619334
3852,2020-12-31,1886,Value,1234990,-9699892,16319226,6619334
3852,2021-02-14,1886,Capital Call,-108,-9700000,16319226,6619226
3852,2021-02-14,1886,Distribution,210,-9700000,16319436,6619436
3852,2021-03-31,1886,Value,1278870,-9700000,16319436,6619436
3852,2021-05-16,1886,Capital Call,108,-9699892,16319436,6619544
3852,2021-05-16,1886,Distribution,-209,-9699892,16319227,6619335
3852,2021-06-30,1886,Value,1432490,-9699892,16319227,6619335
3852,2021-08-15,1886,Capital Call,-108,-9700000,16319227,6619227
3852,2021-08-15,1886,Distribution,182,-9700000,16319409,6619409
3852,2021-09-30,1886,Value,1432500,-9700000,16319409,6619409
3854,2020-03-31,1886,Value,0,-10000000,14755906,4755906
3854,2020-06-30,1886,Value,0,-10000000,14755906,4755906
3854,2020-09-30,1886,Value,0,-10000000,14755906,4755906
3854,2020-12-31,1886,Value,0,-10000000,14755906,4755906
3854,2021-03-31,1886,Value,0,-10000000,14755906,4755906
3854,2021-06-30,1886,Value,0,-10000000,14755906,4755906
3854,2021-09-30,1886,Value,0,-10000000,14755906,4755906
3854,2021-12-31,1886,Value,0,-10000000,14755906,4755906
3855,2020-03-31,1886,Value,675670,-9620000,13668149,4048149
3855,2020-06-30,1886,Value,658360,-9620000,13668149,4048149
3855,2020-09-30,1886,Value,668630,-9620000,13668149,4048149
3855,2020-11-15,1886,Capital Call,53,-9619947,13668149,4048202
3855,2020-11-15,1886,Distribution,-74,-9619947,13668075,4048128
3855,2020-12-31,1886,Value,667830,-9619947,13668075,4048128
3855,2021-02-14,1886,Capital Call,-53,-9620000,13668075,4048075
3855,2021-02-14,1886,Distribution,139,-9620000,13668214,4048214
3855,2021-03-31,1886,Value,695000,-9620000,13668214,4048214
3855,2021-05-16,1886,Capital Call,51,-9619949,13668214,4048265
3855,2021-05-16,1886,Distribution,198181,-9619949,13866395,4246446
3855,2021-06-30,1886,Value,348960,-9619949,13866395,4246446
3855,2021-08-15,1886,Capital Call,-51,-9620000,13866395,4246395
3855,2021-08-15,1886,Distribution,73,-9620000,13866468,4246468
3855,2021-09-30,1886,Value,165160,-9620000,13866468,4246468
3879,2020-09-30,832,Value,2000,-10000001,15672001,5672000
3879,2021-03-31,832,Value,0,-10000001,15672001,5672000
3879,2021-06-30,832,Value,0,-10000001,15672001,5672000
3879,2021-09-30,832,Value,0,-10000001,15672001,5672000
3879,2021-12-31,832,Value,0,-10000001,15672001,5672000
3880,2020-03-31,832,Value,0,-10000001,19414998,9414997
3880,2020-06-30,832,Value,0,-10000001,19414998,9414997
3880,2020-09-30,832,Value,0,-10000001,19414998,9414997
3880,2020-12-31,832,Value,0,-10000001,19414998,9414997
3880,2021-03-31,832,Value,0,-10000001,19414998,9414997
3880,2021-06-30,832,Value,0,-10000001,19414998,9414997
3880,2021-09-30,832,Value,0,-10000001,19414998,9414997
3880,2021-12-31,832,Value,0,-10000001,19414998,9414997
3882,2020-09-30,832,Value,2000,-9999999,15604997,5604998
3882,2020-12-31,832,Value,1000,-9999999,15604997,5604998
3882,2021-03-31,832,Value,1000,-9999999,15604997,5604998
3950,2020-03-31,3806,Value,0,-9999999,4182806,-5817193
3950,2020-06-30,3806,Value,0,-9999999,4182806,-5817193
3950,2020-09-30,3806,Value,0,-9999999,4182806,-5817193
3950,2020-12-31,3806,Value,0,-9999999,4182806,-5817193
3950,2021-03-31,3806,Value,0,-9999999,4182806,-5817193
3950,2021-12-31,3806,Value,0,-9999999,4182806,-5817193
3964,2020-03-31,3830,Value,0,-10000000,5718102,-4281898
3964,2020-06-30,3830,Value,0,-10000000,5718102,-4281898
3964,2020-09-30,3830,Value,0,-10000000,5718102,-4281898
3964,2020-12-31,3830,Value,0,-10000000,5718102,-4281898
3964,2021-03-31,3830,Value,0,-10000000,5718102,-4281898
3964,2021-06-30,3830,Value,0,-10000000,5718102,-4281898
3964,2021-09-30,3830,Value,0,-10000000,5718102,-4281898
3964,2021-12-31,3830,Value,0,-10000000,5718102,-4281898
3969,2021-12-31,1042,Value,0,-9525000,1539500,-7985500
3972,2020-03-31,212,Value,0,-9804998,6955668,-2849330
3972,2020-06-30,212,Value,0,-9804998,6955668,-2849330
3972,2020-09-30,212,Value,0,-9804998,6955668,-2849330
3972,2020-12-31,212,Value,0,-9804998,6955668,-2849330
3972,2021-03-31,212,Value,0,-9804998,6955668,-2849330
3972,2021-06-30,212,Value,0,-9804998,6955668,-2849330
3972,2021-09-30,212,Value,0,-9804998,6955668,-2849330
3972,2021-12-31,212,Value,0,-9804998,6955668,-2849330
3976,2021-12-31,96,Value,0,-9600001,12383999,2783998
3988,2020-03-31,4568,Value,0,-9829025,3936462,-5892563
3988,2020-06-30,4568,Value,0,-9829025,3936462,-5892563
3988,2020-09-30,4568,Value,0,-9829025,3936462,-5892563
3988,2020-12-31,4568,Value,0,-9829025,3936462,-5892563
3988,2021-03-31,4568,Value,0,-9829025,3936462,-5892563
3988,2021-06-30,4568,Value,0,-9829025,3936462,-5892563
3988,2021-09-30,4568,Value,0,-9829025,3936462,-5892563
3988,2021-12-31,4568,Value,0,-9829025,3936462,-5892563
4004,2020-06-30,741,Value,0,-10759999,20960000,10200001
4004,2020-09-30,741,Value,0,-10759999,20960000,10200001
4004,2020-12-31,741,Value,0,-10759999,20960000,10200001
4004,2021-03-31,741,Value,0,-10759999,20960000,10200001
4004,2021-06-30,741,Value,0,-10759999,20960000,10200001
4004,2021-12-31,741,Value,0,-10759999,20960000,10200001
4006,2021-12-31,4607,Value,0,-10000000,900000,-9100000
4021,2020-03-31,4633,Value,0,-11359999,4520001,-6839998
4021,2020-06-30,4633,Value,0,-11359999,4520001,-6839998
4021,2020-09-30,4633,Value,0,-11359999,4520001,-6839998
4021,2020-12-31,4633,Value,0,-11359999,4520001,-6839998
4021,2021-03-31,4633,Value,0,-11359999,4520001,-6839998
4021,2021-06-30,4633,Value,0,-11359999,4520001,-6839998
4021,2021-09-30,4633,Value,0,-11359999,4520001,-6839998
4021,2021-12-31,4633,Value,0,-11359999,4520001,-6839998
4022,2020-03-31,268,Value,3699890,-9737500,10476985,739485
4022,2020-06-30,268,Value,3728630,-9737500,10476985,739485
4022,2020-08-15,268,Distribution,221420,-9737500,10698405,960905
4022,2020-09-30,268,Value,3537040,-9737500,10698405,960905
4022,2020-12-31,268,Value,3537040,-9737500,10698405,960905
4022,2021-03-31,268,Value,2889370,-9737500,10698405,960905
4022,2021-06-30,268,Value,2918270,-9737500,10698405,960905
4022,2021-12-31,268,Value,0,-9737500,10698405,960905
4051,2020-02-15,231,Distribution,20000,-10000000,9319999,-680001
4051,2020-03-31,231,Value,1367000,-10000000,9319999,-680001
4051,2020-06-30,231,Value,1555000,-10000000,9319999,-680001
4051,2020-09-30,231,Value,1643000,-10000000,9319999,-680001
4051,2020-11-15,231,Distribution,191000,-10000000,9510999,-489001
4051,2020-12-31,231,Value,1610000,-10000000,9510999,-489001
4051,2021-02-14,231,Distribution,743000,-10000000,10253999,253999
4051,2021-03-31,231,Value,1115000,-10000000,10253999,253999
4051,2021-05-16,231,Distribution,608000,-10000000,10861999,861999
4051,2021-06-30,231,Value,197000,-10000000,10861999,861999
4051,2021-08-15,231,Distribution,26000,-10000000,10887999,887999
4051,2021-09-30,231,Value,331000,-10000000,10887999,887999
4051,2021-11-15,231,Distribution,45000,-10000000,10932999,932999
4051,2021-12-31,231,Value,5000,-10000000,10932999,932999
4054,2020-01-15,725,Distribution,545227,-9915000,17987989,8072989
4054,2020-02-29,725,Value,595510,-9915000,17987989,8072989
4054,2020-04-15,725,Distribution,0,-9915000,17987989,8072989
4054,2020-05-31,725,Value,412120,-9915000,17987989,8072989
4054,2020-08-31,725,Value,433770,-9915000,17987989,8072989
4054,2020-11-30,725,Value,485110,-9915000,17987989,8072989
4054,2021-02-28,725,Value,485110,-9915000,17987989,8072989
4054,2021-05-31,725,Value,491820,-9915000,17987989,8072989
4054,2021-07-16,725,Distribution,150969,-9915000,18138958,8223958
4054,2021-08-31,725,Value,204510,-9915000,18138958,8223958
4054,2021-10-16,725,Distribution,85649,-9915000,18224607,8309607
4054,2021-11-30,725,Value,255340,-9915000,18224607,8309607
4057,2020-02-15,4657,Distribution,74224,-9654194,10917765,1263571
4057,2020-03-31,4657,Value,619020,-9654194,10917765,1263571
4057,2020-05-16,4657,Distribution,142183,-9654194,11059948,1405754
4057,2020-06-30,4657,Value,436750,-9654194,11059948,1405754
4057,2020-08-15,4657,Capital Call,-41000,-9695194,11059948,1364754
4057,2020-09-30,4657,Value,374180,-9695194,11059948,1364754
4057,2020-12-31,4657,Value,646950,-9695194,11059948,1364754
4057,2021-02-14,4657,Distribution,41183,-9695194,11101131,1405937
4057,2021-03-31,4657,Value,641800,-9695194,11101131,1405937
4057,2021-06-30,4657,Value,798970,-9695194,11101131,1405937
4069,2020-06-30,1519,Value,47220,-10086907,4211599,-5875308
4073,2021-12-31,361,Value,0,-9197029,24424841,15227812
4076,2020-03-31,181,Value,0,-9148001,14440119,5292118
4076,2020-06-30,181,Value,0,-9148001,14440119,5292118
4076,2020-09-30,181,Value,0,-9148001,14440119,5292118
4076,2020-12-31,181,Value,0,-9148001,14440119,5292118
4076,2021-03-31,181,Value,0,-9148001,14440119,5292118
4076,2021-06-30,181,Value,0,-9148001,14440119,5292118
4076,2021-09-30,181,Value,0,-9148001,14440119,5292118
4076,2021-12-31,181,Value,0,-9148001,14440119,5292118
4091,2020-03-31,2147,Value,0,-9508737,29198467,19689730
4091,2020-06-30,2147,Value,0,-9508737,29198467,19689730
4091,2020-12-31,2147,Value,0,-9508737,29198467,19689730
4091,2021-03-31,2147,Value,0,-9508737,29198467,19689730
4091,2021-06-30,2147,Value,0,-9508737,29198467,19689730
4091,2021-09-30,2147,Value,0,-9508737,29198467,19689730
4091,2021-12-31,2147,Value,0,-9508737,29198467,19689730
4092,2020-03-31,355,Value,385860,-10074492,18933892,8859400
4092,2020-05-16,355,Distribution,189152,-10074492,19123044,9048552
4092,2020-06-30,355,Value,432950,-10074492,19123044,9048552
4092,2020-09-30,355,Value,480120,-10074492,19123044,9048552
4144,2020-03-31,5020,Distribution,300183,-9600000,15682770,6082770
4144,2020-06-30,5020,Value,4237730,-9600000,15682770,6082770
4144,2020-08-15,5020,Distribution,208320,-9600000,15891090,6291090
4144,2020-09-30,5020,Value,4815930,-9600000,15891090,6291090
4144,2020-11-15,5020,Distribution,490320,-9600000,16381410,6781410
4144,2020-12-31,5020,Value,4316780,-9600000,16381410,6781410
4144,2021-02-14,5020,Distribution,207480,-9600000,16588890,6988890
4144,2021-03-31,5020,Value,5584610,-9600000,16588890,6988890
4144,2021-06-30,5020,Value,6455990,-9600000,16588890,6988890
4144,2021-08-15,5020,Distribution,714433,-9600000,17303323,7703323
4144,2021-09-30,5020,Value,6017480,-9600000,17303323,7703323
4174,2020-03-31,72,Value,0,-10479999,17260003,6780004
4174,2020-06-30,72,Value,0,-10479999,17260003,6780004
4174,2020-09-30,72,Value,0,-10479999,17260003,6780004
4174,2020-12-31,72,Value,0,-10479999,17260003,6780004
4174,2021-03-31,72,Value,0,-10479999,17260003,6780004
4174,2021-06-30,72,Value,0,-10479999,17260003,6780004
4174,2021-09-30,72,Value,0,-10479999,17260003,6780004
4174,2021-12-31,72,Value,0,-10479999,17260003,6780004
4214,2020-02-15,306,Distribution,294768,-7115692,14339901,7224209
4214,2020-03-31,306,Value,588370,-7115692,14339901,7224209
4214,2020-06-30,306,Value,681660,-7115692,14339901,7224209
4214,2020-09-30,306,Value,653170,-7115692,14339901,7224209
4214,2020-12-31,306,Value,834160,-7115692,14339901,7224209
4214,2021-02-14,306,Capital Call,-15758,-7131450,14339901,7208451
4214,2021-02-14,306,Distribution,411895,-7131450,14751796,7620346
4214,2021-03-31,306,Value,475100,-7131450,14751796,7620346
4214,2021-06-30,306,Value,570780,-7131450,14751796,7620346
4223,2020-06-30,555,Value,5660,-9698149,22513864,12815715
4223,2021-12-31,555,Value,0,-9698149,22513864,12815715
4224,2020-03-31,938,Value,710000,-10010000,13400000,3390000
4224,2020-06-30,938,Value,710000,-10010000,13400000,3390000
4224,2020-09-30,938,Distribution,710096,-10010000,14110096,4100096
4224,2020-12-31,938,Value,0,-10010000,14110096,4100096
4224,2021-03-31,938,Value,0,-10010000,14110096,4100096
4224,2021-06-30,938,Value,0,-10010000,14110096,4100096
4224,2021-09-30,938,Value,0,-10010000,14110096,4100096
4224,2021-12-31,938,Value,0,-10010000,14110096,4100096
4230,2020-03-31,5197,Value,44550,-10002213,14359900,4357687
4230,2020-05-16,5197,Distribution,44203,-10002213,14404103,4401890
4230,2020-06-30,5197,Value,0,-10002213,14404103,4401890
4230,2021-12-31,5197,Value,0,-10002213,14404103,4401890
4231,2020-03-31,596,Value,0,-10000000,10197530,197530
4231,2020-06-30,596,Value,0,-10000000,10197530,197530
4231,2020-09-30,596,Value,0,-10000000,10197530,197530
4231,2020-12-31,596,Value,0,-10000000,10197530,197530
4231,2021-03-31,596,Value,0,-10000000,10197530,197530
4231,2021-06-30,596,Value,0,-10000000,10197530,197530
4231,2021-09-30,596,Value,0,-10000000,10197530,197530
4231,2021-12-31,596,Value,0,-10000000,10197530,197530
4248,2020-03-31,80,Value,39400,-9887752,18252934,8365182
4248,2020-06-30,80,Value,39400,-9887752,18252934,8365182
4248,2020-09-30,80,Value,39400,-9887752,18252934,8365182
4248,2020-12-31,80,Value,39400,-9887752,18252934,8365182
4248,2021-03-31,80,Value,39400,-9887752,18252934,8365182
4248,2021-06-30,80,Value,39400,-9887752,18252934,8365182
4248,2021-12-31,80,Value,0,-9887752,18252934,8365182
4251,2020-03-31,5264,Value,484970,-8391784,20953262,12561478
4251,2020-06-30,5264,Value,483920,-8391784,20953262,12561478
4251,2020-08-15,5264,Distribution,431099,-8391784,21384361,12992577
4251,2020-09-30,5264,Value,18660,-8391784,21384361,12992577
4251,2020-11-15,5264,Distribution,18663,-8391784,21403024,13011240
4251,2020-12-31,5264,Value,0,-8391784,21403024,13011240
4251,2021-06-30,5264,Value,0,-8391784,21403024,13011240
4251,2021-09-30,5264,Value,0,-8391784,21403024,13011240
4251,2021-12-31,5264,Value,0,-8391784,21403024,13011240
4262,2021-12-31,375,Value,0,-8543005,1536394,-7006611
4310,2021-12-31,5496,Value,0,-10284251,4990828,-5293423
4337,2020-02-15,2198,Distribution,199000,-9950001,13532000,3581999
4337,2020-03-31,2198,Value,169140,-9950001,13532000,3581999
4337,2020-06-30,2198,Value,169140,-9950001,13532000,3581999
4337,2020-09-30,2198,Value,139290,-9950001,13532000,3581999
4337,2020-12-31,2198,Value,169140,-9950001,13532000,3581999
4337,2021-02-14,2198,Distribution,-3980,-9950001,13528020,3578019
4337,2021-03-31,2198,Value,194020,-9950001,13528020,3578019
4337,2021-05-16,2198,Distribution,231835,-9950001,13759855,3809854
4337,2021-06-30,2198,Value,169140,-9950001,13759855,3809854
4341,2021-12-31,180,Value,0,-9700000,4684130,-5015870
4357,2020-03-31,23839,Value,0,-9532998,17553113,8020115
4357,2020-06-30,23839,Value,0,-9532998,17553113,8020115
4357,2020-09-30,23839,Value,0,-9532998,17553113,8020115
4357,2020-12-31,23839,Value,0,-9532998,17553113,8020115
4357,2021-03-31,23839,Value,0,-9532998,17553113,8020115
4357,2021-06-30,23839,Value,0,-9532998,17553113,8020115
4357,2021-09-30,23839,Value,0,-9532998,17553113,8020115
4357,2021-12-31,23839,Value,0,-9532998,17553113,8020115
4359,2020-03-31,4955,Value,123380,-11431647,14920681,3489034
4359,2020-06-30,4955,Value,133170,-11431647,14920681,3489034
4359,2020-09-30,4955,Value,138070,-11431647,14920681,3489034
4359,2020-12-31,4955,Value,146880,-11431647,14920681,3489034
4359,2021-03-31,4955,Value,146880,-11431647,14920681,3489034
4359,2021-06-30,4955,Value,127300,-11431647,14920681,3489034
4373,2020-03-31,2201,Value,2554070,-10882603,8701686,-2180917
4402,2020-02-15,18619,Capital Call,-8263,-10939631,14194208,3254577
4402,2020-02-15,18619,Distribution,456624,-10939631,14650832,3711201
4402,2020-03-31,18619,Value,41990,-10939631,14650832,3711201
4402,2020-09-30,18619,Value,39430,-10939631,14650832,3711201
4411,2020-03-31,355,Value,690570,-10006768,8581364,-1425404
4411,2020-06-30,355,Value,726070,-10006768,8581364,-1425404
4411,2020-09-30,355,Value,745850,-10006768,8581364,-1425404
4411,2020-11-15,355,Distribution,88826,-10006768,8670190,-1336578
4411,2020-12-31,355,Value,626380,-10006768,8670190,-1336578
4411,2021-03-31,355,Value,615560,-10006768,8670190,-1336578
4411,2021-06-30,355,Value,587260,-10006768,8670190,-1336578
4413,2020-03-31,487,Value,0,-10000000,26316000,16316000
4413,2020-06-30,487,Value,0,-10000000,26316000,16316000
4413,2020-09-30,487,Value,0,-10000000,26316000,16316000
4413,2020-12-31,487,Value,0,-10000000,26316000,16316000
4413,2021-03-31,487,Value,0,-10000000,26316000,16316000
4413,2021-06-30,487,Value,0,-10000000,26316000,16316000
4413,2021-09-30,487,Value,0,-10000000,26316000,16316000
4413,2021-12-31,487,Value,0,-10000000,26316000,16316000
4421,2020-03-31,902,Value,7254000,-10000000,12582000,2582000
4421,2020-05-16,902,Distribution,3056000,-10000000,15638000,5638000
4421,2020-06-30,902,Value,2908000,-10000000,15638000,5638000
4421,2020-08-15,902,Distribution,9174000,-10000000,24812000,14812000
4421,2020-09-30,902,Value,2468000,-10000000,24812000,14812000
4421,2020-12-31,902,Value,4530000,-10000000,24812000,14812000
4466,2020-03-31,613,Value,134180,-9273265,11284797,2011532
4466,2020-06-30,613,Value,128370,-9273265,11284797,2011532
4466,2020-09-30,613,Value,128770,-9273265,11284797,2011532
4466,2020-12-31,613,Value,156460,-9273265,11284797,2011532
4466,2021-02-14,613,Capital Call,-39,-9273304,11284797,2011493
4466,2021-02-14,613,Distribution,102414,-9273304,11387211,2113907
4466,2021-03-31,613,Value,54470,-9273304,11387211,2113907
4466,2021-06-30,613,Value,54090,-9273304,11387211,2113907
4466,2021-09-30,613,Value,54700,-9273304,11387211,2113907
4495,2021-12-31,7029,Value,0,-9512291,7411981,-2100310
4500,2020-03-31,553,Value,1549690,-10000000,7930555,-2069445
4500,2020-06-30,553,Value,1592970,-10000000,7930555,-2069445
4500,2020-09-30,553,Value,1207710,-10000000,7930555,-2069445
4500,2020-11-15,553,Distribution,91666,-10000000,8022221,-1977779
4500,2020-12-31,553,Value,865540,-10000000,8022221,-1977779
4500,2021-03-31,553,Value,889430,-10000000,8022221,-1977779
4500,2021-05-16,553,Distribution,162155,-10000000,8184376,-1815624
4500,2021-06-30,553,Value,755900,-10000000,8184376,-1815624
4526,2020-03-31,5752,Value,603850,-10000000,10252992,252992
4526,2020-06-30,5752,Value,609850,-10000000,10252992,252992
4526,2020-09-30,5752,Value,608770,-10000000,10252992,252992
4526,2020-12-31,5752,Value,607450,-10000000,10252992,252992
4526,2021-03-31,5752,Value,605910,-10000000,10252992,252992
4526,2021-06-30,5752,Value,605770,-10000000,10252992,252992
4544,2021-12-31,591,Value,0,-10000000,6385414,-3614586
4552,2021-12-31,395,Value,0,-9500000,2000000,-7500000
4556,2020-03-31,5776,Value,18220,-9743422,15109407,5365985
4556,2020-06-30,5776,Value,15860,-9743422,15109407,5365985
4556,2020-09-30,5776,Value,15830,-9743422,15109407,5365985
4556,2020-11-15,5776,Capital Call,-1092,-9744514,15109407,5364893
4556,2020-11-15,5776,Distribution,18321,-9744514,15127728,5383214
4556,2020-12-31,5776,Value,0,-9744514,15127728,5383214
4556,2021-12-31,5776,Value,0,-9744514,15127728,5383214
4568,2020-03-31,93,Value,213690,-9999999,17973345,7973346
4568,2020-06-30,93,Value,212350,-9999999,17973345,7973346
4568,2020-09-30,93,Value,211790,-9999999,17973345,7973346
4568,2020-11-15,93,Distribution,142755,-9999999,18116100,8116101
4568,2020-12-31,93,Value,333780,-9999999,18116100,8116101
4568,2021-03-31,93,Value,389910,-9999999,18116100,8116101
4568,2021-06-30,93,Value,417610,-9999999,18116100,8116101
4606,2021-12-31,910,Value,0,-10360000,4996000,-5364000
4647,2020-03-31,8003,Value,0,-12720398,17831499,5111101
4647,2020-06-30,8003,Value,0,-12720398,17831499,5111101
4647,2020-09-30,8003,Value,0,-12720398,17831499,5111101
4647,2020-12-31,8003,Value,0,-12720398,17831499,5111101
4647,2021-03-31,8003,Value,0,-12720398,17831499,5111101
4647,2021-06-30,8003,Value,0,-12720398,17831499,5111101
4647,2021-09-30,8003,Value,0,-12720398,17831499,5111101
4647,2021-12-31,8003,Value,0,-12720398,17831499,5111101
4675,2020-03-31,49,Value,1550000,-12525000,21255000,8730000
4675,2020-05-16,49,Capital Call,-5000,-12530000,21255000,8725000
4675,2020-05-16,49,Distribution,290000,-12530000,21545000,9015000
4675,2020-06-30,49,Value,1384990,-12530000,21545000,9015000
4675,2020-09-30,49,Value,1494990,-12530000,21545000,9015000
4675,2020-12-31,49,Value,1529990,-12530000,21545000,9015000
4675,2021-03-31,49,Value,1809990,-12530000,21545000,9015000
4675,2021-06-30,49,Value,1889990,-12530000,21545000,9015000
4675,2021-09-30,49,Value,2094490,-12530000,21545000,9015000
4710,2021-12-31,454,Value,0,-8142051,40023639,31881588
4712,2020-03-31,52,Value,298710,-10000000,1637623,-8362377
4712,2020-06-30,52,Value,150830,-10000000,1637623,-8362377
4712,2020-09-30,52,Value,165690,-10000000,1637623,-8362377
4712,2020-12-31,52,Value,165660,-10000000,1637623,-8362377
4712,2021-03-31,52,Value,165020,-10000000,1637623,-8362377
4712,2021-06-30,52,Value,164380,-10000000,1637623,-8362377
4714,2020-02-15,579,Capital Call,-119,-9496774,13422089,3925315
4714,2020-02-15,579,Distribution,294417,-9496774,13716506,4219732
4714,2020-03-31,579,Value,690850,-9496774,13716506,4219732
4714,2020-05-16,579,Capital Call,-33228,-9530002,13716506,4186504
4714,2020-05-16,579,Distribution,82932,-9530002,13799438,4269436
4714,2020-06-30,579,Value,705220,-9530002,13799438,4269436
4715,2020-03-31,5994,Value,0,-10046356,1293992,-8752364
4715,2020-06-30,5994,Value,0,-10046356,1293992,-8752364
4715,2020-09-30,5994,Value,0,-10046356,1293992,-8752364
4715,2020-12-31,5994,Value,0,-10046356,1293992,-8752364
4715,2021-03-31,5994,Value,0,-10046356,1293992,-8752364
4715,2021-06-30,5994,Value,0,-10046356,1293992,-8752364
4715,2021-09-30,5994,Value,0,-10046356,1293992,-8752364
4715,2021-12-31,5994,Value,0,-10046356,1293992,-8752364
4716,2020-03-31,5995,Value,0,-10135217,156740,-9978477
4716,2020-06-30,5995,Value,0,-10135217,156740,-9978477
4716,2020-09-30,5995,Value,0,-10135217,156740,-9978477
4716,2020-12-31,5995,Value,0,-10135217,156740,-9978477
4716,2021-03-31,5995,Value,0,-10135217,156740,-9978477
4716,2021-06-30,5995,Value,0,-10135217,156740,-9978477
4716,2021-09-30,5995,Value,0,-10135217,156740,-9978477
4716,2021-12-31,5995,Value,0,-10135217,156740,-9978477
4717,2021-12-31,634,Value,0,-10749134,15317843,4568709
4784,2020-03-31,1218,Value,0,-6160000,5535992,-624008
4784,2020-06-30,1218,Value,0,-6160000,5535992,-624008
4784,2020-09-30,1218,Value,0,-6160000,5535992,-624008
4784,2020-12-31,1218,Value,0,-6160000,5535992,-624008
4784,2021-03-31,1218,Value,0,-6160000,5535992,-624008
4784,2021-06-30,1218,Value,0,-6160000,5535992,-624008
4784,2021-09-30,1218,Value,0,-6160000,5535992,-624008
4784,2021-12-31,1218,Value,0,-6160000,5535992,-624008
4830,2020-03-31,538,Value,107330,-8158667,16548667,8390000
4830,2020-06-30,538,Value,156000,-8158667,16548667,8390000
4830,2020-09-30,538,Value,168000,-8158667,16548667,8390000
4830,2020-12-31,538,Value,146660,-8158667,16548667,8390000
4857,2020-06-30,435,Value,113360,-9383611,11055669,1672058
4857,2020-09-30,435,Value,113460,-9383611,11055669,1672058
4857,2020-12-31,435,Value,113480,-9383611,11055669,1672058
4857,2021-03-31,435,Value,110260,-9383611,11055669,1672058
4857,2021-05-16,435,Capital Call,-86587,-9470198,11055669,1585471
4857,2021-06-30,435,Value,110290,-9470198,11055669,1585471
4857,2021-12-31,435,Value,0,-9470198,11055669,1585471
4860,2020-02-15,2562,Distribution,880500,-7500000,17308500,9808500
4860,2020-03-31,2562,Value,695250,-7500000,17308500,9808500
4860,2020-05-16,2562,Distribution,16500,-7500000,17325000,9825000
4860,2020-06-30,2562,Value,564750,-7500000,17325000,9825000
4860,2020-08-15,2562,Distribution,172500,-7500000,17497500,9997500
4860,2020-09-30,2562,Value,382500,-7500000,17497500,9997500
4860,2021-06-30,2562,Value,435000,-7500000,17497500,9997500
4860,2021-09-30,2562,Distribution,-22500,-7500000,17475000,9975000
4860,2021-12-31,2562,Value,502500,-7500000,17475000,9975000
4873,2020-06-30,703,Value,2516660,-10007820,10446907,439087
4873,2020-09-30,703,Value,2442100,-10007820,10446907,439087
4873,2020-11-15,703,Distribution,185983,-10007820,10632890,625070
4873,2020-12-31,703,Value,2245460,-10007820,10632890,625070
4916,2020-02-15,32667,Distribution,10000,-10330000,8090000,-2240000
4916,2020-03-31,32667,Value,980000,-10330000,8090000,-2240000
4916,2020-05-16,32667,Distribution,-10000,-10330000,8080000,-2250000
4916,2020-06-30,32667,Value,980000,-10330000,8080000,-2250000
4916,2020-09-30,32667,Value,980000,-10330000,8080000,-2250000
4916,2020-11-15,32667,Distribution,130000,-10330000,8210000,-2120000
4916,2020-12-31,32667,Value,980000,-10330000,8210000,-2120000
4916,2021-03-31,32667,Value,980000,-10330000,8210000,-2120000
4916,2021-05-16,32667,Distribution,110000,-10330000,8320000,-2010000
4916,2021-06-30,32667,Value,980000,-10330000,8320000,-2010000
4916,2021-08-15,32667,Capital Call,-4000,-10334000,8320000,-2014000
4916,2021-08-15,32667,Distribution,171000,-10334000,8491000,-1843000
4916,2021-09-30,32667,Value,976990,-10334000,8491000,-1843000
4924,2020-03-31,5687,Value,125840,-11571406,18153291,6581885
4924,2020-06-30,5687,Value,123020,-11571406,18153291,6581885
4924,2020-09-30,5687,Value,137720,-11571406,18153291,6581885
4924,2021-12-31,5687,Value,0,-11571406,18153291,6581885
4925,2020-03-31,6138,Value,165950,-4767455,4957521,190066
4925,2020-06-30,6138,Value,163780,-4767455,4957521,190066
4925,2020-09-30,6138,Value,161030,-4767455,4957521,190066
4933,2021-12-31,178,Value,0,-10830001,17328000,6497999
4936,2021-12-31,475912,Value,0,-10938267,9720440,-1217827
4941,2020-03-31,1886,Value,0,-9700000,12782491,3082491
4941,2020-05-16,1886,Distribution,0,-9700000,12782491,3082491
4941,2020-06-30,1886,Value,0,-9700000,12782491,3082491
4941,2020-09-30,1886,Value,0,-9700000,12782491,3082491
4941,2020-12-31,1886,Value,0,-9700000,12782491,3082491
4941,2021-03-31,1886,Value,0,-9700000,12782491,3082491
4941,2021-06-30,1886,Value,0,-9700000,12782491,3082491
4941,2021-09-30,1886,Value,0,-9700000,12782491,3082491
4941,2021-12-31,1886,Value,0,-9700000,12782491,3082491
4958,2021-12-31,1997,Value,0,-9100000,2616000,-6484000
4991,2020-03-31,296,Value,0,-9600000,15040320,5440320
4991,2020-06-30,296,Value,0,-9600000,15040320,5440320
4991,2020-09-30,296,Value,0,-9600000,15040320,5440320
4991,2020-12-31,296,Value,0,-9600000,15040320,5440320
4991,2021-03-31,296,Value,0,-9600000,15040320,5440320
4991,2021-06-30,296,Value,0,-9600000,15040320,5440320
4991,2021-09-30,296,Value,0,-9600000,15040320,5440320
4991,2021-12-31,296,Value,0,-9600000,15040320,5440320
5015,2021-03-31,133,Capital Call,-9888889,-9888889,0,-9888889
5015,2021-12-31,133,Value,0,-9888889,0,-9888889
5022,2020-03-31,6203,Value,0,-9809000,9921803,112803
5022,2020-06-30,6203,Value,0,-9809000,9921803,112803
5022,2020-09-30,6203,Value,0,-9809000,9921803,112803
5022,2020-12-31,6203,Value,0,-9809000,9921803,112803
5022,2021-03-31,6203,Value,0,-9809000,9921803,112803
5022,2021-06-30,6203,Value,0,-9809000,9921803,112803
5022,2021-09-30,6203,Value,0,-9809000,9921803,112803
5022,2021-12-31,6203,Value,0,-9809000,9921803,112803
5051,2020-01-15,6217,Distribution,834642,-10303207,17305471,7002264
5051,2020-02-29,6217,Value,2033170,-10303207,17305471,7002264
5051,2020-05-31,6217,Value,1578830,-10303207,17305471,7002264
5051,2020-08-31,6217,Value,1913940,-10303207,17305471,7002264
5051,2020-10-16,6217,Distribution,611447,-10303207,17916918,7613711
5051,2020-11-30,6217,Value,1566880,-10303207,17916918,7613711
5051,2021-01-14,6217,Distribution,884387,-10303207,18801305,8498098
5051,2021-02-28,6217,Value,842190,-10303207,18801305,8498098
5051,2021-04-15,6217,Distribution,11594,-10303207,18812899,8509692
5051,2021-05-31,6217,Value,854490,-10303207,18812899,8509692
5051,2021-07-16,6217,Distribution,69976,-10303207,18882875,8579668
5051,2021-08-31,6217,Value,1102760,-10303207,18882875,8579668
5051,2021-10-16,6217,Distribution,0,-10303207,18882875,8579668
5051,2021-11-30,6217,Value,1089650,-10303207,18882875,8579668
5054,2021-12-31,6218,Value,0,-10834935,3043645,-7791290
5059,2020-03-31,50947,Value,110200,-7396001,19942574,12546573
5059,2020-06-30,50947,Value,110200,-7396001,19942574,12546573
5059,2020-09-30,50947,Value,109460,-7396001,19942574,12546573
5081,2020-03-31,182,Value,17570,-11358010,18889126,7531116
5081,2020-06-30,182,Value,16150,-11358010,18889126,7531116
5081,2020-09-30,182,Value,112750,-11358010,18889126,7531116
5081,2020-11-15,182,Distribution,112810,-11358010,19001936,7643926
5081,2020-12-31,182,Value,0,-11358010,19001936,7643926
5081,2021-03-31,182,Value,0,-11358010,19001936,7643926
5081,2021-06-30,182,Value,0,-11358010,19001936,7643926
5081,2021-12-31,182,Value,0,-11358010,19001936,7643926
5082,2020-03-31,795,Value,383580,-10000001,16909053,6909052
5082,2020-06-30,795,Value,332710,-10000001,16909053,6909052
5082,2020-09-30,795,Value,328640,-10000001,16909053,6909052
5082,2020-12-31,795,Value,330030,-10000001,16909053,6909052
5082,2021-03-31,795,Value,310670,-10000001,16909053,6909052
5082,2021-12-31,795,Value,0,-10000001,16909053,6909052
5084,2020-02-15,211,Capital Call,22857,-10620000,13485716,2865716
5084,2020-02-15,211,Distribution,44166,-10620000,13529882,2909882
5084,2020-03-31,211,Value,160360,-10620000,13529882,2909882
5084,2020-05-16,211,Capital Call,10000,-10610000,13529882,2919882
5084,2020-05-16,211,Distribution,-9557,-10610000,13520325,2910325
5084,2020-06-30,211,Value,160210,-10610000,13520325,2910325
5084,2020-09-30,211,Value,160210,-10610000,13520325,2910325
5084,2020-12-31,211,Value,160210,-10610000,13520325,2910325
5084,2021-02-14,211,Capital Call,-20000,-10630000,13520325,2890325
5084,2021-02-14,211,Distribution,-26,-10630000,13520299,2890299
5084,2021-03-31,211,Value,160510,-10630000,13520299,2890299
5131,2020-03-31,916,Value,196570,-9786915,15589502,5802587
5131,2020-06-30,916,Value,116640,-9786915,15589502,5802587
5131,2020-09-30,916,Value,808250,-9786915,15589502,5802587
5131,2020-11-15,916,Distribution,403871,-9786915,15993373,6206458
5131,2020-12-31,916,Value,405190,-9786915,15993373,6206458
5131,2021-03-31,916,Value,405190,-9786915,15993373,6206458
5131,2021-06-30,916,Value,405190,-9786915,15993373,6206458
5137,2020-01-15,139,Capital Call,-2825,-9281451,5065055,-4216396
5137,2020-01-15,139,Distribution,0,-9281451,5065055,-4216396
5137,2020-02-29,139,Value,188580,-9281451,5065055,-4216396
5137,2020-04-15,139,Capital Call,0,-9281451,5065055,-4216396
5137,2020-04-15,139,Distribution,0,-9281451,5065055,-4216396
5137,2020-05-31,139,Value,308000,-9281451,5065055,-4216396
5137,2020-08-31,139,Value,216720,-9281451,5065055,-4216396
5137,2020-11-30,139,Value,183030,-9281451,5065055,-4216396
5137,2021-01-14,139,Capital Call,-17182,-9298633,5065055,-4233578
5137,2021-01-14,139,Distribution,163260,-9298633,5228315,-4070318
5137,2021-02-28,139,Value,0,-9298633,5228315,-4070318
5137,2021-08-31,139,Value,0,-9298633,5228315,-4070318
5152,2021-12-31,1366,Value,0,-9541666,291667,-9249999
5155,2020-03-31,317,Value,0,-11048000,16697947,5649947
5155,2020-06-30,317,Value,0,-11048000,16697947,5649947
5155,2020-09-30,317,Value,0,-11048000,16697947,5649947
5155,2020-12-31,317,Value,0,-11048000,16697947,5649947
5155,2021-03-31,317,Value,0,-11048000,16697947,5649947
5155,2021-06-30,317,Value,0,-11048000,16697947,5649947
5155,2021-09-30,317,Value,0,-11048000,16697947,5649947
5155,2021-12-31,317,Value,0,-11048000,16697947,5649947
5156,2020-03-31,436,Value,79780,-10781914,15021275,4239361
5156,2020-06-30,436,Value,79780,-10781914,15021275,4239361
5156,2020-09-30,436,Value,79780,-10781914,15021275,4239361
5156,2020-12-31,436,Value,79780,-10781914,15021275,4239361
5156,2021-03-31,436,Value,79780,-10781914,15021275,4239361
5156,2021-06-30,436,Value,79780,-10781914,15021275,4239361
5156,2021-08-15,436,Capital Call,-1064,-10782978,15021275,4238297
5156,2021-08-15,436,Distribution,2128,-10782978,15023403,4240425
5156,2021-09-30,436,Value,80850,-10782978,15023403,4240425
5159,2020-02-15,569,Capital Call,-79986,-11558008,15153881,3595873
5159,2020-03-31,569,Value,1551680,-11558008,15153881,3595873
5159,2020-05-16,569,Capital Call,-52047,-11610055,15153881,3543826
5159,2020-06-30,569,Value,1624420,-11610055,15153881,3543826
5159,2020-09-30,569,Value,1691420,-11610055,15153881,3543826
5159,2020-12-31,569,Value,2116780,-11610055,15153881,3543826
5159,2021-03-31,569,Value,2017710,-11610055,15153881,3543826
5159,2021-06-30,569,Value,2311340,-11610055,15153881,3543826
5161,2020-02-15,571,Distribution,407646,-10761631,19831238,9069607
5161,2020-03-31,571,Value,178890,-10761631,19831238,9069607
5161,2020-06-30,571,Value,190550,-10761631,19831238,9069607
5161,2020-09-30,571,Value,186480,-10761631,19831238,9069607
5161,2020-11-15,571,Capital Call,20643,-10740988,19831238,9090250
5161,2020-11-15,571,Distribution,175007,-10740988,20006245,9265257
5161,2020-12-31,571,Value,69210,-10740988,20006245,9265257
5161,2021-03-31,571,Value,69750,-10740988,20006245,9265257
5161,2021-06-30,571,Value,68200,-10740988,20006245,9265257
5165,2021-12-31,782,Value,0,-12379097,9411646,-2967451
5193,2020-03-31,577,Value,4150000,-11230000,15800000,4570000
5193,2020-06-30,577,Value,6549990,-11230000,15800000,4570000
5193,2020-09-30,577,Value,7820000,-11230000,15800000,4570000
5193,2020-11-15,577,Distribution,3340000,-11230000,19140000,7910000
5193,2020-12-31,577,Value,9209990,-11230000,19140000,7910000
5193,2021-02-14,577,Distribution,1150000,-11230000,20290000,9060000
5193,2021-03-31,577,Value,22709990,-11230000,20290000,9060000
5193,2021-05-16,577,Distribution,2090000,-11230000,22380000,11150000
5193,2021-06-30,577,Value,13920000,-11230000,22380000,11150000
5193,2021-09-30,577,Value,9020000,-11230000,22380000,11150000
5199,2020-02-15,140,Capital Call,-267,-9817092,19689697,9872605
5199,2020-02-15,140,Distribution,259013,-9817092,19948710,10131618
5199,2020-03-31,140,Value,0,-9817092,19948710,10131618
5199,2020-11-15,140,Capital Call,0,-9817092,19948710,10131618
5199,2020-11-15,140,Distribution,0,-9817092,19948710,10131618
5199,2020-12-31,140,Value,0,-9817092,19948710,10131618
5199,2021-12-31,140,Value,0,-9817092,19948710,10131618
5212,2021-12-31,333,Value,0,-10557584,19631139,9073555
5234,2020-01-15,6384,Capital Call,0,-9960578,13758251,3797673
5234,2020-01-15,6384,Distribution,0,-9960578,13758251,3797673
5234,2020-02-29,6384,Value,14330,-9960578,13758251,3797673
5234,2020-04-15,6384,Capital Call,0,-9960578,13758251,3797673
5234,2020-04-15,6384,Distribution,0,-9960578,13758251,3797673
5234,2020-05-31,6384,Value,12550,-9960578,13758251,3797673
5234,2020-08-31,6384,Value,12490,-9960578,13758251,3797673
5234,2020-11-30,6384,Value,12370,-9960578,13758251,3797673
5234,2021-01-14,6384,Distribution,9074,-9960578,13767325,3806747
5234,2021-02-28,6384,Value,0,-9960578,13767325,3806747
5234,2021-08-31,6384,Value,0,-9960578,13767325,3806747
5234,2021-12-31,6384,Value,0,-9960578,13767325,3806747
5235,2020-06-30,483,Value,4510,-9429733,26956837,17527104
5235,2020-09-30,483,Value,4500,-9429733,26956837,17527104
5235,2021-02-14,483,Distribution,59325,-9429733,27016162,17586429
5235,2021-06-30,483,Value,0,-9429733,27016162,17586429
5239,2020-03-31,809,Value,1793390,-9765408,9562417,-202991
5239,2020-05-16,809,Distribution,1637928,-9765408,11200345,1434937
5239,2020-06-30,809,Value,155260,-9765408,11200345,1434937
5239,2020-09-30,809,Value,156970,-9765408,11200345,1434937
5239,2020-12-31,809,Value,179360,-9765408,11200345,1434937
5239,2021-03-31,809,Value,176790,-9765408,11200345,1434937
5256,2020-03-31,1390,Value,0,-10000002,3443643,-6556359
5256,2020-06-30,1390,Value,0,-10000002,3443643,-6556359
5256,2020-09-30,1390,Value,0,-10000002,3443643,-6556359
5256,2020-12-31,1390,Value,0,-10000002,3443643,-6556359
5256,2021-03-31,1390,Value,0,-10000002,3443643,-6556359
5256,2021-06-30,1390,Value,0,-10000002,3443643,-6556359
5256,2021-09-30,1390,Value,0,-10000002,3443643,-6556359
5256,2021-12-31,1390,Value,0,-10000002,3443643,-6556359
5268,2020-03-31,107708,Value,0,-11462426,17880636,6418210
5268,2020-09-30,107708,Value,0,-11462426,17880636,6418210
5268,2021-12-31,107708,Value,0,-11462426,17880636,6418210
5300,2020-03-31,295,Value,0,-10310000,12990602,2680602
5300,2020-06-30,295,Value,0,-10310000,12990602,2680602
5300,2020-09-30,295,Value,0,-10310000,12990602,2680602
5300,2020-12-31,295,Value,0,-10310000,12990602,2680602
5300,2021-03-31,295,Value,0,-10310000,12990602,2680602
5300,2021-06-30,295,Value,0,-10310000,12990602,2680602
5300,2021-09-30,295,Value,0,-10310000,12990602,2680602
5300,2021-12-31,295,Value,0,-10310000,12990602,2680602
5304,2020-03-31,727,Value,0,-10000001,16860001,6860000
5304,2020-06-30,727,Value,0,-10000001,16860001,6860000
5304,2020-09-30,727,Value,0,-10000001,16860001,6860000
5304,2020-12-31,727,Value,0,-10000001,16860001,6860000
5304,2021-03-31,727,Value,0,-10000001,16860001,6860000
5304,2021-06-30,727,Value,0,-10000001,16860001,6860000
5304,2021-09-30,727,Value,0,-10000001,16860001,6860000
5304,2021-12-31,727,Value,0,-10000001,16860001,6860000
5307,2020-03-31,1355,Value,119990,-9440000,22570000,13130000
5307,2020-06-30,1355,Value,119990,-9440000,22570000,13130000
5307,2020-09-30,1355,Value,119990,-9440000,22570000,13130000
5307,2020-12-31,1355,Value,119990,-9440000,22570000,13130000
5307,2021-03-31,1355,Value,119990,-9440000,22570000,13130000
5307,2021-06-30,1355,Value,119990,-9440000,22570000,13130000
5307,2021-08-15,1355,Capital Call,5000,-9435000,22570000,13135000
5307,2021-08-15,1355,Distribution,4000,-9435000,22574000,13139000
5307,2021-09-30,1355,Value,116990,-9435000,22574000,13139000
5308,2020-03-31,2564,Value,0,-9879608,20914143,11034535
5308,2020-06-30,2564,Value,0,-9879608,20914143,11034535
5308,2020-09-30,2564,Value,0,-9879608,20914143,11034535
5308,2020-12-31,2564,Value,0,-9879608,20914143,11034535
5308,2021-03-31,2564,Value,0,-9879608,20914143,11034535
5308,2021-06-30,2564,Value,0,-9879608,20914143,11034535
5308,2021-09-30,2564,Value,0,-9879608,20914143,11034535
5308,2021-12-31,2564,Value,0,-9879608,20914143,11034535
5334,2020-03-31,6479,Value,13620,-10000000,17740006,7740006
5334,2020-06-30,6479,Value,13380,-10000000,17740006,7740006
5334,2020-08-15,6479,Distribution,13389,-10000000,17753395,7753395
5334,2020-09-30,6479,Value,0,-10000000,17753395,7753395
5334,2021-03-31,6479,Value,0,-10000000,17753395,7753395
5334,2021-06-30,6479,Value,0,-10000000,17753395,7753395
5334,2021-09-30,6479,Value,0,-10000000,17753395,7753395
5334,2021-12-31,6479,Value,0,-10000000,17753395,7753395
5335,2020-03-31,458,Value,1187110,-9908779,15112264,5203485
5335,2020-05-16,458,Distribution,130404,-9908779,15242668,5333889
5335,2020-06-30,458,Value,867080,-9908779,15242668,5333889
5335,2020-08-15,458,Distribution,18182,-9908779,15260850,5352071
5335,2020-09-30,458,Value,864620,-9908779,15260850,5352071
5335,2020-11-15,458,Distribution,54546,-9908779,15315396,5406617
5335,2020-12-31,458,Value,885100,-9908779,15315396,5406617
5335,2021-02-14,458,Distribution,36364,-9908779,15351760,5442981
5335,2021-03-31,458,Value,896170,-9908779,15351760,5442981
5335,2021-05-16,458,Distribution,90910,-9908779,15442670,5533891
5335,2021-06-30,458,Value,872280,-9908779,15442670,5533891
5337,2020-03-31,506,Value,527690,-9550000,4742640,-4807360
5337,2020-05-16,506,Distribution,310000,-9550000,5052640,-4497360
5337,2020-06-30,506,Value,217360,-9550000,5052640,-4497360
5337,2020-09-30,506,Distribution,360,-9550000,5053000,-4497000
5337,2020-12-31,506,Value,177000,-9550000,5053000,-4497000
5337,2021-06-30,506,Value,186000,-9550000,5053000,-4497000
5344,2020-02-15,458,Distribution,58885,-10613269,14056291,3443022
5344,2020-03-31,458,Value,732990,-10613269,14056291,3443022
5344,2020-05-16,458,Distribution,56208,-10613269,14112499,3499230
5344,2020-06-30,458,Value,676240,-10613269,14112499,3499230
5344,2020-08-15,458,Distribution,28190,-10613269,14140689,3527420
5344,2020-09-30,458,Value,606580,-10613269,14140689,3527420
5344,2020-11-15,458,Distribution,94479,-10613269,14235168,3621899
5344,2020-12-31,458,Value,512100,-10613269,14235168,3621899
5344,2021-02-14,458,Distribution,46705,-10613269,14281873,3668604
5344,2021-03-31,458,Value,516810,-10613269,14281873,3668604
5344,2021-05-16,458,Distribution,96357,-10613269,14378230,3764961
5344,2021-06-30,458,Value,474130,-10613269,14378230,3764961
5345,2020-03-31,633,Value,4098000,-10000000,1480000,-8520000
5345,2020-06-30,633,Value,3436000,-10000000,1480000,-8520000
5345,2020-09-30,633,Value,4600000,-10000000,1480000,-8520000
5345,2020-11-15,633,Distribution,336000,-10000000,1816000,-8184000
5345,2020-12-31,633,Value,3834000,-10000000,1816000,-8184000
5349,2020-03-31,519,Value,0,-9340000,10660000,1320000
5349,2020-06-30,519,Value,0,-9340000,10660000,1320000
5349,2020-09-30,519,Value,0,-9340000,10660000,1320000
5349,2020-12-31,519,Value,0,-9340000,10660000,1320000
5349,2021-03-31,519,Value,0,-9340000,10660000,1320000
5349,2021-06-30,519,Value,0,-9340000,10660000,1320000
5349,2021-09-30,519,Value,0,-9340000,10660000,1320000
5349,2021-12-31,519,Value,0,-9340000,10660000,1320000
5365,2020-03-31,11,Value,335780,-9167722,18418932,9251210
5365,2020-05-16,11,Distribution,10444,-9167722,18429376,9261654
5365,2020-06-30,11,Value,333470,-9167722,18429376,9261654
5365,2020-08-15,11,Distribution,308634,-9167722,18738010,9570288
5365,2020-09-30,11,Value,15900,-9167722,18738010,9570288
5365,2020-12-31,11,Value,21700,-9167722,18738010,9570288
5365,2021-03-31,11,Value,20990,-9167722,18738010,9570288
5365,2021-06-30,11,Value,20570,-9167722,18738010,9570288
5372,2020-02-15,753,Distribution,0,-10000000,8858700,-1141300
5372,2020-03-31,753,Value,6987930,-10000000,8858700,-1141300
5372,2020-05-16,753,Distribution,4683022,-10000000,13541722,3541722
5372,2020-06-30,753,Value,2047420,-10000000,13541722,3541722
5372,2020-09-30,753,Value,2120910,-10000000,13541722,3541722
5372,2020-11-15,753,Distribution,0,-10000000,13541722,3541722
5372,2020-12-31,753,Value,2429360,-10000000,13541722,3541722
5373,2020-02-15,6330,Distribution,93383,-9850000,13285694,3435694
5373,2020-03-31,6330,Value,3591410,-9850000,13285694,3435694
5373,2020-06-30,6330,Value,3641510,-9850000,13285694,3435694
5373,2020-09-30,6330,Value,3655370,-9850000,13285694,3435694
5373,2020-11-15,6330,Distribution,671677,-9850000,13957371,4107371
5373,2020-12-31,6330,Value,3067400,-9850000,13957371,4107371
5373,2021-03-31,6330,Value,4861640,-9850000,13957371,4107371
5373,2021-05-16,6330,Capital Call,-4644532,-14494532,13957371,-537161
5373,2021-06-30,6330,Value,299780,-14494532,13957371,-537161
5373,2021-09-30,6330,Value,321320,-14494532,13957371,-537161
5385,2020-02-15,303,Distribution,117959,-10000000,18926507,8926507
5385,2020-03-31,303,Value,2115780,-10000000,18926507,8926507
5385,2020-05-16,303,Distribution,27805,-10000000,18954312,8954312
5385,2020-06-30,303,Value,2240900,-10000000,18954312,8954312
5385,2020-09-30,303,Value,3167120,-10000000,18954312,8954312
5385,2020-11-15,303,Distribution,485440,-10000000,19439752,9439752
5385,2020-12-31,303,Value,2912930,-10000000,19439752,9439752
5385,2021-02-14,303,Distribution,2521773,-10000000,21961525,11961525
5385,2021-03-31,303,Value,388030,-10000000,21961525,11961525
5385,2021-06-30,303,Value,384020,-10000000,21961525,11961525
5387,2020-03-31,465,Value,60000,-10000000,23660000,13660000
5387,2020-06-30,465,Value,60000,-10000000,23660000,13660000
5387,2020-09-30,465,Value,60000,-10000000,23660000,13660000
5387,2020-12-31,465,Value,80000,-10000000,23660000,13660000
5387,2021-02-14,465,Distribution,20000,-10000000,23680000,13680000
5387,2021-03-31,465,Value,60000,-10000000,23680000,13680000
5387,2021-06-30,465,Value,60000,-10000000,23680000,13680000
5387,2021-09-30,465,Value,60000,-10000000,23680000,13680000
5387,2021-12-31,465,Value,0,-10000000,23680000,13680000
5392,2020-02-15,23,Distribution,100000,-10100000,23445000,13345000
5392,2020-03-31,23,Value,479990,-10100000,23445000,13345000
5392,2020-06-30,23,Value,479990,-10100000,23445000,13345000
5392,2020-09-30,23,Value,479990,-10100000,23445000,13345000
5392,2020-12-31,23,Value,479990,-10100000,23445000,13345000
5392,2021-03-31,23,Value,479990,-10100000,23445000,13345000
5392,2021-06-30,23,Value,479990,-10100000,23445000,13345000
5392,2021-08-15,23,Capital Call,-1500,-10101500,23445000,13343500
5392,2021-08-15,23,Distribution,1000,-10101500,23446000,13344500
5392,2021-09-30,23,Value,479000,-10101500,23446000,13344500
5408,2020-03-31,1389,Value,208380,-9926760,507681,-9419079
5408,2020-06-30,1389,Value,176890,-9926760,507681,-9419079
5408,2020-09-30,1389,Value,100440,-9926760,507681,-9419079
5408,2020-12-31,1389,Value,204680,-9926760,507681,-9419079
5408,2021-03-31,1389,Value,159690,-9926760,507681,-9419079
5408,2021-06-30,1389,Value,125140,-9926760,507681,-9419079
5424,2020-03-31,6558,Value,0,-9090000,15134850,6044850
5424,2020-06-30,6558,Value,0,-9090000,15134850,6044850
5424,2020-09-30,6558,Value,0,-9090000,15134850,6044850
5424,2020-12-31,6558,Value,0,-9090000,15134850,6044850
5424,2021-03-31,6558,Value,0,-9090000,15134850,6044850
5424,2021-06-30,6558,Value,0,-9090000,15134850,6044850
5424,2021-09-30,6558,Value,0,-9090000,15134850,6044850
5424,2021-12-31,6558,Value,0,-9090000,15134850,6044850
5429,2020-03-31,75,Value,946810,-9904216,12254994,2350778
5429,2020-06-30,75,Value,930830,-9904216,12254994,2350778
5429,2020-09-30,75,Value,957230,-9904216,12254994,2350778
5429,2020-12-31,75,Value,1370300,-9904216,12254994,2350778
5429,2021-03-31,75,Value,1504740,-9904216,12254994,2350778
5429,2021-06-30,75,Value,1434950,-9904216,12254994,2350778
5435,2020-03-31,12961,Value,333740,-13657142,14214120,556978
5435,2020-05-16,12961,Distribution,168264,-13657142,14382384,725242
5435,2020-06-30,12961,Value,182620,-13657142,14382384,725242
5435,2020-08-15,12961,Distribution,164209,-13657142,14546593,889451
5435,2020-09-30,12961,Value,17460,-13657142,14546593,889451
5435,2020-11-15,12961,Distribution,17469,-13657142,14564062,906920
5435,2020-12-31,12961,Value,0,-13657142,14564062,906920
5435,2021-03-31,12961,Value,0,-13657142,14564062,906920
5435,2021-06-30,12961,Value,0,-13657142,14564062,906920
5435,2021-09-30,12961,Value,0,-13657142,14564062,906920
5435,2021-12-31,12961,Value,0,-13657142,14564062,906920
5449,2021-12-31,802,Value,0,-9878629,16809307,6930678
5456,2020-01-15,1628,Distribution,0,-9445498,19023864,9578366
5456,2020-02-29,1628,Value,39900,-9445498,19023864,9578366
5456,2020-04-15,1628,Distribution,0,-9445498,19023864,9578366
5456,2020-05-31,1628,Value,39780,-9445498,19023864,9578366
5456,2020-08-31,1628,Value,39630,-9445498,19023864,9578366
5456,2020-11-30,1628,Value,39540,-9445498,19023864,9578366
5456,2021-02-28,1628,Value,39540,-9445498,19023864,9578366
5456,2021-05-31,1628,Value,39540,-9445498,19023864,9578366
5456,2021-08-31,1628,Value,39320,-9445498,19023864,9578366
5456,2021-12-31,1628,Value,0,-9445498,19023864,9578366
5472,2020-03-31,372,Value,0,-11904222,27798022,15893800
5472,2020-09-30,372,Value,0,-11904222,27798022,15893800
5472,2021-12-31,372,Value,0,-11904222,27798022,15893800
5473,2020-03-31,91,Value,416000,-9442300,16008792,6566492
5473,2020-06-30,91,Value,415380,-9442300,16008792,6566492
5473,2020-08-15,91,Distribution,58294,-9442300,16067086,6624786
5473,2020-09-30,91,Value,357030,-9442300,16067086,6624786
5473,2020-12-31,91,Value,354660,-9442300,16067086,6624786
5475,2020-03-31,3830,Value,1752520,-9300000,8297020,-1002980
5475,2020-06-30,3830,Value,1752340,-9300000,8297020,-1002980
5475,2020-09-30,3830,Value,1752180,-9300000,8297020,-1002980
5475,2020-12-31,3830,Value,1785920,-9300000,8297020,-1002980
5475,2021-03-31,3830,Value,1785330,-9300000,8297020,-1002980
5475,2021-06-30,3830,Value,1785200,-9300000,8297020,-1002980
5477,2020-03-31,380,Value,199590,-12855671,19842382,6986711
5477,2020-06-30,380,Value,199820,-12855671,19842382,6986711
5477,2020-09-30,380,Value,198200,-12855671,19842382,6986711
5477,2020-12-31,380,Value,198110,-12855671,19842382,6986711
5477,2021-03-31,380,Value,197660,-12855671,19842382,6986711
5477,2021-06-30,380,Value,197120,-12855671,19842382,6986711
5481,2020-03-31,462,Value,690890,-9327640,14886260,5558620
5481,2020-06-30,462,Value,690890,-9327640,14886260,5558620
5481,2020-09-30,462,Value,690890,-9327640,14886260,5558620
5481,2020-12-31,462,Value,690890,-9327640,14886260,5558620
5481,2021-02-14,462,Capital Call,-11660,-9339300,14886260,5546960
5481,2021-03-31,462,Value,710370,-9339300,14886260,5546960
5481,2021-06-30,462,Value,710370,-9339300,14886260,5546960
5482,2021-01-14,554,Distribution,9403,-10136257,30706278,20570021
5482,2021-02-28,554,Value,0,-10136257,30706278,20570021
5482,2021-05-31,554,Value,0,-10136257,30706278,20570021
5482,2021-08-31,554,Value,0,-10136257,30706278,20570021
5482,2021-10-16,554,Capital Call,0,-10136257,30706278,20570021
5482,2021-10-16,554,Distribution,0,-10136257,30706278,20570021
5482,2021-12-31,554,Value,0,-10136257,30706278,20570021
5483,2021-12-31,567,Value,0,-11400000,14330000,2930000
5485,2020-03-31,618,Value,681450,-9439077,12964718,3525641
5485,2020-06-30,618,Value,823730,-9439077,12964718,3525641
5485,2020-08-15,618,Capital Call,-13541,-9452618,12964718,3512100
5485,2020-08-15,618,Distribution,47478,-9452618,13012196,3559578
5485,2020-09-30,618,Value,787310,-9452618,13012196,3559578
5485,2020-12-31,618,Value,787310,-9452618,13012196,3559578
5485,2021-02-14,618,Distribution,77022,-9452618,13089218,3636600
5485,2021-03-31,618,Value,716150,-9452618,13089218,3636600
5489,2020-03-31,722,Value,0,-11778982,13772314,1993332
5489,2020-06-30,722,Value,0,-11778982,13772314,1993332
5489,2020-09-30,722,Value,0,-11778982,13772314,1993332
5489,2020-12-31,722,Value,0,-11778982,13772314,1993332
5489,2021-03-31,722,Value,0,-11778982,13772314,1993332
5489,2021-06-30,722,Value,0,-11778982,13772314,1993332
5489,2021-09-30,722,Value,0,-11778982,13772314,1993332
5489,2021-12-31,722,Value,0,-11778982,13772314,1993332
5495,2020-02-15,111,Capital Call,-70,-10740400,17365326,6624926
5495,2020-02-15,111,Distribution,70,-10740400,17365396,6624996
5495,2020-03-31,111,Value,313900,-10740400,17365396,6624996
5495,2020-06-30,111,Value,329350,-10740400,17365396,6624996
5495,2020-08-15,111,Distribution,24991,-10740400,17390387,6649987
5495,2020-09-30,111,Value,362220,-10740400,17390387,6649987
5495,2020-11-15,111,Distribution,31631,-10740400,17422018,6681618
5495,2020-12-31,111,Value,343810,-10740400,17422018,6681618
5495,2021-02-14,111,Capital Call,-7,-10740407,17422018,6681611
5495,2021-02-14,111,Distribution,199543,-10740407,17621561,6881154
5495,2021-03-31,111,Value,304190,-10740407,17621561,6881154
5495,2021-06-30,111,Value,312710,-10740407,17621561,6881154
5500,2020-03-31,808,Value,0,-9923040,9727186,-195854
5500,2020-06-30,808,Value,0,-9923040,9727186,-195854
5500,2020-09-30,808,Value,0,-9923040,9727186,-195854
5500,2020-12-31,808,Value,0,-9923040,9727186,-195854
5500,2021-03-31,808,Value,0,-9923040,9727186,-195854
5500,2021-06-30,808,Value,0,-9923040,9727186,-195854
5500,2021-09-30,808,Value,0,-9923040,9727186,-195854
5500,2021-12-31,808,Value,0,-9923040,9727186,-195854
5512,2020-03-31,302,Value,1617840,-9943173,13895358,3952185
5512,2020-06-30,302,Value,1819910,-9943173,13895358,3952185
5512,2020-08-15,302,Distribution,555000,-9943173,14450358,4507185
5512,2020-09-30,302,Value,1236480,-9943173,14450358,4507185
5512,2020-11-15,302,Distribution,195000,-9943173,14645358,4702185
5512,2020-12-31,302,Value,1158240,-9943173,14645358,4702185
5512,2021-03-31,302,Value,1427000,-9943173,14645358,4702185
5512,2021-06-30,302,Value,1240090,-9943173,14645358,4702185
5528,2020-03-31,888,Value,3743050,-10001260,14226586,4225326
5528,2020-06-30,888,Value,3778650,-10001260,14226586,4225326
5528,2020-09-30,888,Value,3485490,-10001260,14226586,4225326
5528,2020-12-31,888,Value,3294490,-10001260,14226586,4225326
5528,2021-03-31,888,Value,3293530,-10001260,14226586,4225326
5528,2021-06-30,888,Value,3292570,-10001260,14226586,4225326
5529,2020-03-31,811,Value,0,-10000005,24709997,14709992
5529,2020-06-30,811,Value,0,-10000005,24709997,14709992
5529,2020-09-30,811,Value,0,-10000005,24709997,14709992
5529,2020-12-31,811,Value,0,-10000005,24709997,14709992
5529,2021-03-31,811,Value,0,-10000005,24709997,14709992
5529,2021-06-30,811,Value,0,-10000005,24709997,14709992
5529,2021-09-30,811,Value,0,-10000005,24709997,14709992
5529,2021-12-31,811,Value,0,-10000005,24709997,14709992
5530,2020-07-01,70,Distribution,-328,-10000000,18326673,8326673
5530,2020-12-31,70,Value,86000,-10000000,18326673,8326673
5530,2021-03-31,70,Value,85710,-10000000,18326673,8326673
5531,2020-09-30,479,Value,265370,-9545999,15077909,5531910
5531,2020-11-15,479,Distribution,42957,-9545999,15120866,5574867
5531,2020-12-31,479,Value,593760,-9545999,15120866,5574867
5531,2021-02-14,479,Distribution,24820,-9545999,15145686,5599687
5531,2021-03-31,479,Value,593760,-9545999,15145686,5599687
5531,2021-06-30,479,Value,664400,-9545999,15145686,5599687
5531,2021-12-31,479,Value,476340,-9545999,15145686,5599687
5534,2020-03-31,28681,Value,376630,-12333691,14610254,2276563
5534,2020-06-30,28681,Value,374330,-12333691,14610254,2276563
5534,2020-09-30,28681,Value,371530,-12333691,14610254,2276563
5534,2020-11-15,28681,Capital Call,-15946,-12349637,14610254,2260617
5534,2020-11-15,28681,Distribution,410658,-12349637,15020912,2671275
5534,2020-12-31,28681,Value,0,-12349637,15020912,2671275
5534,2021-03-31,28681,Value,0,-12349637,15020912,2671275
5534,2021-06-30,28681,Value,0,-12349637,15020912,2671275
5534,2021-09-30,28681,Value,0,-12349637,15020912,2671275
5534,2021-12-31,28681,Value,0,-12349637,15020912,2671275
5557,2020-03-31,381,Value,2887500,-10000000,23727001,13727001
5557,2020-06-30,381,Value,2798070,-10000000,23727001,13727001
5557,2020-09-30,381,Value,3209920,-10000000,23727001,13727001
5557,2020-11-15,381,Distribution,435110,-10000000,24162111,14162111
5557,2020-12-31,381,Value,5151890,-10000000,24162111,14162111
5557,2021-03-31,381,Value,6446470,-10000000,24162111,14162111
5557,2021-05-16,381,Distribution,3223807,-10000000,27385918,17385918
5557,2021-06-30,381,Value,3969730,-10000000,27385918,17385918
5558,2021-12-31,1487,Value,0,-9750000,8272001,-1477999
5565,2020-02-29,202,Value,64940,-9441887,19668663,10226776
5565,2020-05-31,202,Value,66590,-9441887,19668663,10226776
5565,2020-08-31,202,Value,66550,-9441887,19668663,10226776
5565,2020-11-30,202,Value,91860,-9441887,19668663,10226776
5565,2021-01-14,202,Distribution,130301,-9441887,19798964,10357077
5565,2021-02-28,202,Value,0,-9441887,19798964,10357077
5565,2021-05-31,202,Value,0,-9441887,19798964,10357077
5565,2021-08-31,202,Value,0,-9441887,19798964,10357077
5566,2020-03-31,439,Value,0,-9524003,10381161,857158
5566,2020-06-30,439,Value,0,-9524003,10381161,857158
5566,2020-09-30,439,Value,0,-9524003,10381161,857158
5566,2020-12-31,439,Value,0,-9524003,10381161,857158
5566,2021-03-31,439,Value,0,-9524003,10381161,857158
5566,2021-06-30,439,Value,0,-9524003,10381161,857158
5566,2021-09-30,439,Value,0,-9524003,10381161,857158
5566,2021-12-31,439,Value,0,-9524003,10381161,857158
5567,2020-03-31,710,Value,1871790,-10000001,16267521,6267520
5567,2020-06-30,710,Value,2181190,-10000001,16267521,6267520
5567,2020-09-30,710,Value,2357260,-10000001,16267521,6267520
5567,2020-12-31,710,Value,2646150,-10000001,16267521,6267520
5567,2021-02-14,710,Distribution,441026,-10000001,16708547,6708546
5567,2021-03-31,710,Value,2664100,-10000001,16708547,6708546
5567,2021-05-16,710,Distribution,144444,-10000001,16852991,6852990
5567,2021-06-30,710,Value,2772640,-10000001,16852991,6852990
5572,2020-03-31,417,Value,1165990,-11384757,17346996,5962239
5572,2020-06-30,417,Value,1013720,-11384757,17346996,5962239
5572,2020-09-30,417,Value,765870,-11384757,17346996,5962239
5572,2020-12-30,417,Capital Call,-3333,-11388090,17346996,5958906
5572,2021-03-31,417,Value,1032350,-11388090,17346996,5958906
5572,2021-06-30,417,Value,1008660,-11388090,17346996,5958906
5580,2020-03-31,718,Value,4140,-9650000,12710000,3060000
5580,2020-06-30,718,Value,4040,-9650000,12710000,3060000
5580,2020-09-30,718,Value,3980,-9650000,12710000,3060000
5580,2020-11-15,718,Distribution,3928,-9650000,12713928,3063928
5580,2020-12-31,718,Value,0,-9650000,12713928,3063928
5580,2021-12-31,718,Value,0,-9650000,12713928,3063928
5587,2020-01-15,6715,Distribution,0,-8900000,122376167,113476167
5587,2020-02-29,6715,Value,924490,-8900000,122376167,113476167
5587,2020-04-15,6715,Distribution,0,-8900000,122376167,113476167
5587,2020-05-31,6715,Value,924320,-8900000,122376167,113476167
5587,2020-08-31,6715,Value,924470,-8900000,122376167,113476167
5587,2020-11-30,6715,Value,924220,-8900000,122376167,113476167
5587,2021-02-28,6715,Value,924220,-8900000,122376167,113476167
5587,2021-05-31,6715,Value,931150,-8900000,122376167,113476167
5587,2021-08-31,6715,Value,785080,-8900000,122376167,113476167
5587,2021-11-30,6715,Value,568700,-8900000,122376167,113476167
5604,2020-03-31,54293,Value,5490,-10475843,4842606,-5633237
5604,2020-06-30,54293,Value,5490,-10475843,4842606,-5633237
5604,2020-08-15,54293,Distribution,7321,-10475843,4849927,-5625916
5604,2020-09-30,54293,Value,0,-10475843,4849927,-5625916
5604,2020-12-31,54293,Value,0,-10475843,4849927,-5625916
5604,2021-03-31,54293,Value,0,-10475843,4849927,-5625916
5604,2021-12-31,54293,Value,0,-10475843,4849927,-5625916
5605,2020-03-31,376,Value,0,-9410000,12976388,3566388
5605,2020-06-30,376,Value,0,-9410000,12976388,3566388
5605,2020-09-30,376,Value,0,-9410000,12976388,3566388
5605,2020-12-31,376,Value,0,-9410000,12976388,3566388
5605,2021-03-31,376,Value,0,-9410000,12976388,3566388
5605,2021-06-30,376,Value,0,-9410000,12976388,3566388
5605,2021-09-30,376,Value,0,-9410000,12976388,3566388
5605,2021-12-31,376,Value,0,-9410000,12976388,3566388
5606,2020-02-15,785,Distribution,51708,-10428448,12442984,2014536
5606,2020-03-31,785,Value,1113990,-10428448,12442984,2014536
5606,2020-06-30,785,Value,1218280,-10428448,12442984,2014536
5606,2020-08-15,785,Capital Call,-8030,-10436478,12442984,2006506
5606,2020-08-15,785,Distribution,8030,-10436478,12451014,2014536
5606,2020-09-30,785,Value,1429500,-10436478,12451014,2014536
5606,2020-11-15,785,Distribution,883512,-10436478,13334526,2898048
5606,2020-12-31,785,Value,545980,-10436478,13334526,2898048
5606,2021-02-14,785,Capital Call,-3358,-10439836,13334526,2894690
5606,2021-02-14,785,Distribution,3358,-10439836,13337884,2898048
5606,2021-03-31,785,Value,547090,-10439836,13337884,2898048
5606,2021-06-30,785,Value,547090,-10439836,13337884,2898048
5607,2021-12-31,244,Value,0,-9800001,6370000,-3430001
5626,2020-03-31,68,Value,539760,-10000000,12703371,2703371
5626,2020-06-30,68,Value,604400,-10000000,12703371,2703371
5626,2020-09-30,68,Value,596270,-10000000,12703371,2703371
5626,2020-12-31,68,Value,714560,-10000000,12703371,2703371
5626,2021-03-31,68,Value,686400,-10000000,12703371,2703371
5626,2021-06-30,68,Value,641120,-10000000,12703371,2703371
5634,2020-03-31,6739,Value,801390,-10000001,12377060,2377059
5634,2020-06-30,6739,Value,801390,-10000001,12377060,2377059
5634,2020-09-30,6739,Value,800550,-10000001,12377060,2377059
5634,2020-11-15,6739,Distribution,398470,-10000001,12775530,2775529
5634,2020-12-31,6739,Value,536530,-10000001,12775530,2775529
5634,2021-03-31,6739,Value,510360,-10000001,12775530,2775529
5634,2021-06-30,6739,Value,508980,-10000001,12775530,2775529
5637,2020-03-31,174,Value,51990,-10244000,16828000,6584000
5637,2020-06-30,174,Value,51990,-10244000,16828000,6584000
5637,2020-09-30,174,Value,51990,-10244000,16828000,6584000
5637,2020-12-31,174,Value,51990,-10244000,16828000,6584000
5637,2021-03-31,174,Value,51990,-10244000,16828000,6584000
5637,2021-06-30,174,Value,51990,-10244000,16828000,6584000
5637,2021-08-15,174,Capital Call,1600,-10242400,16828000,6585600
5637,2021-09-30,174,Value,52390,-10242400,16828000,6585600
5651,2020-03-31,11277,Value,1431250,-9793750,12425000,2631250
5651,2020-06-30,11277,Value,1481240,-9793750,12425000,2631250
5651,2020-08-15,11277,Capital Call,-112500,-9906250,12425000,2518750
5651,2020-08-15,11277,Distribution,231250,-9906250,12656250,2750000
5651,2020-09-30,11277,Value,1481240,-9906250,12656250,2750000
5651,2020-12-31,11277,Value,1481240,-9906250,12656250,2750000
5651,2021-02-14,11277,Distribution,100000,-9906250,12756250,2850000
5651,2021-03-31,11277,Value,1449990,-9906250,12756250,2850000
5651,2021-05-16,11277,Distribution,1300000,-9906250,14056250,4150000
5651,2021-06-30,11277,Value,1449990,-9906250,14056250,4150000
5652,2020-03-31,814,Value,27940,-10800134,12898084,2097950
5652,2020-06-30,814,Value,27410,-10800134,12898084,2097950
5652,2020-09-30,814,Value,27070,-10800134,12898084,2097950
5652,2020-12-31,814,Value,26340,-10800134,12898084,2097950
5652,2021-03-31,814,Value,26330,-10800134,12898084,2097950
5656,2020-03-31,6758,Value,752000,-9787234,19145432,9358198
5656,2020-05-16,6758,Distribution,25988,-9787234,19171420,9384186
5656,2020-06-30,6758,Value,889740,-9787234,19171420,9384186
5656,2020-08-15,6758,Distribution,93048,-9787234,19264468,9477234
5656,2020-09-30,6758,Value,882650,-9787234,19264468,9477234
5656,2020-11-15,6758,Distribution,41702,-9787234,19306170,9518936
5656,2020-12-31,6758,Value,883190,-9787234,19306170,9518936
5656,2021-03-31,6758,Value,881790,-9787234,19306170,9518936
5656,2021-05-16,6758,Distribution,133446,-9787234,19439616,9652382
5656,2021-06-30,6758,Value,876820,-9787234,19439616,9652382
5666,2020-06-30,161,Value,788300,-13820637,18749835,4929198
5666,2020-12-30,161,Capital Call,-9149,-13829786,18749835,4920049
5666,2020-12-30,161,Distribution,166565,-13829786,18916400,5086614
5666,2021-06-30,161,Value,847240,-13829786,18916400,5086614
5670,2020-02-15,743,Distribution,279340,-12283405,18192542,5909137
5670,2020-03-31,743,Value,403000,-12283405,18192542,5909137
5670,2020-05-16,743,Capital Call,-1138,-12284543,18192542,5907999
5670,2020-05-16,743,Distribution,238889,-12284543,18431431,6146888
5670,2020-06-30,743,Value,164110,-12284543,18431431,6146888
5670,2020-08-15,743,Distribution,333785,-12284543,18765216,6480673
5670,2020-09-30,743,Value,34420,-12284543,18765216,6480673
5670,2020-11-15,743,Capital Call,-227,-12284770,18765216,6480446
5670,2020-11-15,743,Distribution,2549,-12284770,18767765,6482995
5670,2020-12-31,743,Value,5310,-12284770,18767765,6482995
5670,2021-03-31,743,Value,4580,-12284770,18767765,6482995
5670,2021-05-16,743,Capital Call,552001,-11732769,18767765,7034996
5670,2021-06-30,743,Value,4580,-11732769,18767765,7034996
5670,2021-12-31,743,Value,0,-11732769,18767765,7034996
5688,2020-03-31,245,Value,634490,-9875000,10773362,898362
5688,2020-06-30,245,Value,560680,-9875000,10773362,898362
5688,2020-09-30,245,Value,561790,-9875000,10773362,898362
5688,2020-12-31,245,Value,519660,-9875000,10773362,898362
5688,2021-03-31,245,Value,516930,-9875000,10773362,898362
5688,2021-06-30,245,Value,583530,-9875000,10773362,898362
5688,2021-12-31,245,Value,0,-9875000,10773362,898362
5689,2020-03-31,245,Value,523220,-10000000,12266171,2266171
5689,2020-06-30,245,Value,500680,-10000000,12266171,2266171
5689,2020-09-30,245,Value,507100,-10000000,12266171,2266171
5689,2020-12-31,245,Value,498860,-10000000,12266171,2266171
5689,2021-03-31,245,Value,499300,-10000000,12266171,2266171
5689,2021-06-30,245,Value,524430,-10000000,12266171,2266171
5689,2021-12-31,245,Value,0,-10000000,12266171,2266171
5691,2020-06-30,6839,Value,238030,-11573636,3661556,-7912080
5691,2020-09-30,6839,Value,227010,-11573636,3661556,-7912080
5691,2020-12-31,6839,Value,111610,-11573636,3661556,-7912080
5691,2021-03-31,6839,Value,109490,-11573636,3661556,-7912080
5691,2021-06-30,6839,Value,107760,-11573636,3661556,-7912080
5696,2020-03-31,212,Value,14990,-9525000,19030000,9505000
5696,2020-06-30,212,Value,14990,-9525000,19030000,9505000
5696,2020-08-15,212,Capital Call,-15000,-9540000,19030000,9490000
5696,2020-09-30,212,Value,14990,-9540000,19030000,9490000
5696,2020-12-31,212,Value,14990,-9540000,19030000,9490000
5696,2021-03-31,212,Value,14990,-9540000,19030000,9490000
5696,2021-05-16,212,Distribution,5000,-9540000,19035000,9495000
5696,2021-06-30,212,Value,14990,-9540000,19035000,9495000
5696,2021-08-15,212,Capital Call,1000,-9539000,19035000,9496000
5696,2021-08-15,212,Distribution,-1500,-9539000,19033500,9494500
5696,2021-09-30,212,Value,14000,-9539000,19033500,9494500
5761,2021-12-31,718,Value,0,-11910498,20304912,8394414
5765,2020-03-31,532,Value,0,-13053284,20632983,7579699
5765,2020-06-30,532,Value,0,-13053284,20632983,7579699
5765,2020-09-30,532,Value,0,-13053284,20632983,7579699
5765,2020-12-31,532,Value,0,-13053284,20632983,7579699
5765,2021-03-31,532,Value,0,-13053284,20632983,7579699
5765,2021-06-30,532,Value,0,-13053284,20632983,7579699
5765,2021-09-30,532,Value,0,-13053284,20632983,7579699
5765,2021-12-31,532,Value,0,-13053284,20632983,7579699
5768,2020-03-31,365,Value,75550,-8994438,12150991,3156553
5768,2020-06-30,365,Value,119840,-8994438,12150991,3156553
5768,2020-09-30,365,Value,145220,-8994438,12150991,3156553
5768,2020-12-31,365,Value,134060,-8994438,12150991,3156553
5768,2021-03-31,365,Value,160840,-8994438,12150991,3156553
5768,2021-06-30,365,Value,191060,-8994438,12150991,3156553
5768,2021-09-30,365,Value,270700,-8994438,12150991,3156553
5825,2020-03-31,703,Value,792160,-10502410,10763953,261543
5825,2020-06-30,703,Value,791680,-10502410,10763953,261543
5830,2020-09-30,18,Value,1855780,-9505000,11243016,1738016
5830,2020-11-15,18,Distribution,317815,-9505000,11560831,2055831
5830,2020-12-31,18,Value,1650380,-9505000,11560831,2055831
5830,2021-03-31,18,Value,1635940,-9505000,11560831,2055831
5831,2020-02-15,18,Capital Call,0,-9495000,12888511,3393511
5831,2020-02-15,18,Distribution,363,-9495000,12888874,3393874
5831,2020-03-31,18,Value,1923450,-9495000,12888874,3393874
5831,2020-05-16,18,Distribution,378306,-9495000,13267180,3772180
5831,2020-06-30,18,Value,1732350,-9495000,13267180,3772180
5831,2020-09-30,18,Value,1881060,-9495000,13267180,3772180
5831,2020-11-15,18,Distribution,312783,-9495000,13579963,4084963
5831,2020-12-31,18,Value,1911430,-9495000,13579963,4084963
5831,2021-03-31,18,Value,2020850,-9495000,13579963,4084963
5831,2021-05-16,18,Capital Call,95,-9494905,13579963,4085058
5831,2021-05-16,18,Distribution,418965,-9494905,13998928,4504023
5831,2021-06-30,18,Value,1725850,-9494905,13998928,4504023
5831,2021-09-30,18,Value,1552570,-9494905,13998928,4504023
5844,2020-02-15,496,Distribution,2992402,-10000000,20440813,10440813
5844,2020-03-31,496,Value,495150,-10000000,20440813,10440813
5844,2020-06-30,496,Value,524810,-10000000,20440813,10440813
5844,2020-09-30,496,Value,530590,-10000000,20440813,10440813
5844,2020-12-31,496,Value,713550,-10000000,20440813,10440813
5844,2021-03-31,496,Value,713010,-10000000,20440813,10440813
5844,2021-06-30,496,Value,710340,-10000000,20440813,10440813
5850,2020-02-15,710,Distribution,620833,-10000000,22097916,12097916
5850,2020-03-31,710,Value,579160,-10000000,22097916,12097916
5850,2020-06-30,710,Value,556250,-10000000,22097916,12097916
5850,2020-09-30,710,Value,577080,-10000000,22097916,12097916
5850,2020-12-31,710,Value,579160,-10000000,22097916,12097916
5850,2021-02-14,710,Distribution,316667,-10000000,22414583,12414583
5850,2021-03-31,710,Value,260410,-10000000,22414583,12414583
5850,2021-06-30,710,Value,260410,-10000000,22414583,12414583
5870,2020-01-15,526,Distribution,1731717,-10000000,16588319,6588319
5870,2020-02-29,526,Value,1159960,-10000000,16588319,6588319
5870,2020-04-15,526,Distribution,0,-10000000,16588319,6588319
5870,2020-05-31,526,Value,1184910,-10000000,16588319,6588319
5870,2020-08-31,526,Value,1287560,-10000000,16588319,6588319
5870,2020-11-30,526,Value,1303010,-10000000,16588319,6588319
5870,2021-02-28,526,Value,1490470,-10000000,16588319,6588319
5870,2021-05-31,526,Value,1504280,-10000000,16588319,6588319
5870,2021-07-16,526,Distribution,172980,-10000000,16761299,6761299
5870,2021-08-31,526,Value,1468860,-10000000,16761299,6761299
5870,2021-10-16,526,Distribution,0,-10000000,16761299,6761299
5870,2021-11-30,526,Value,1541990,-10000000,16761299,6761299
5871,2020-02-15,5571,Distribution,157377,-7000000,12465246,5465246
5871,2020-03-31,5571,Value,88440,-7000000,12465246,5465246
5871,2020-06-30,5571,Value,88030,-7000000,12465246,5465246
5871,2020-09-30,5571,Value,87570,-7000000,12465246,5465246
5871,2020-11-15,5571,Distribution,43754,-7000000,12509000,5509000
5871,2020-12-31,5571,Value,42000,-7000000,12509000,5509000
5871,2021-02-14,5571,Distribution,2148,-7000000,12511148,5511148
5871,2021-03-31,5571,Value,41350,-7000000,12511148,5511148
5871,2021-06-30,5571,Value,41470,-7000000,12511148,5511148
5871,2021-08-15,5571,Distribution,-48,-7000000,12511100,5511100
5871,2021-09-30,5571,Value,41300,-7000000,12511100,5511100
5878,2020-03-31,355,Value,493330,-10000000,17773334,7773334
5878,2020-09-30,355,Value,373330,-10000000,17773334,7773334
5878,2020-12-31,355,Value,213330,-10000000,17773334,7773334
5878,2021-02-14,355,Distribution,213333,-10000000,17986667,7986667
5878,2021-03-31,355,Value,0,-10000000,17986667,7986667
5878,2021-06-30,355,Value,0,-10000000,17986667,7986667
5878,2021-09-30,355,Value,0,-10000000,17986667,7986667
5891,2020-03-31,283,Value,0,-13960000,20820000,6860000
5891,2020-06-30,283,Value,0,-13960000,20820000,6860000
5891,2020-09-30,283,Value,0,-13960000,20820000,6860000
5891,2020-12-31,283,Value,0,-13960000,20820000,6860000
5891,2021-03-31,283,Value,0,-13960000,20820000,6860000
5891,2021-06-30,283,Value,0,-13960000,20820000,6860000
5891,2021-09-30,283,Value,0,-13960000,20820000,6860000
5891,2021-12-31,283,Value,0,-13960000,20820000,6860000
5910,2020-02-15,355,Distribution,138947,-9600000,14486154,4886154
5910,2020-03-31,355,Value,1368740,-9600000,14486154,4886154
5910,2020-05-16,355,Distribution,126316,-9600000,14612470,5012470
5910,2020-06-30,355,Value,1096720,-9600000,14612470,5012470
5910,2020-08-15,355,Distribution,167579,-9600000,14780049,5180049
5910,2020-09-30,355,Value,1071360,-9600000,14780049,5180049
5910,2020-11-15,355,Distribution,159474,-9600000,14939523,5339523
5910,2020-12-31,355,Value,911880,-9600000,14939523,5339523
5910,2021-02-14,355,Distribution,99578,-9600000,15039101,5439101
5910,2021-03-31,355,Value,829430,-9600000,15039101,5439101
5910,2021-06-30,355,Value,1098510,-9600000,15039101,5439101
5910,2021-08-15,355,Distribution,355031,-9600000,15394132,5794132
5910,2021-09-30,355,Value,704340,-9600000,15394132,5794132
5921,2020-02-15,6733,Capital Call,-2500,-12770000,19212499,6442499
5921,2020-03-31,6733,Value,219990,-12770000,19212499,6442499
5921,2020-05-16,6733,Capital Call,2500,-12767500,19212499,6444999
5921,2020-06-30,6733,Value,220000,-12767500,19212499,6444999
5921,2020-09-30,6733,Value,220000,-12767500,19212499,6444999
5921,2020-12-31,6733,Value,220000,-12767500,19212499,6444999
5921,2021-03-31,6733,Value,220000,-12767500,19212499,6444999
5921,2021-06-30,6733,Value,220000,-12767500,19212499,6444999
5921,2021-08-15,6733,Capital Call,-1250,-12768750,19212499,6443749
5921,2021-08-15,6733,Distribution,250,-12768750,19212749,6443999
5921,2021-09-30,6733,Value,220500,-12768750,19212749,6443999
5931,2020-06-30,464,Value,31950,-9557615,12940408,3382793
5931,2021-12-31,464,Value,0,-9557615,12940408,3382793
5933,2021-12-31,1366,Value,0,-7130000,3420000,-3710000
5946,2020-03-31,4903,Value,0,-9315573,14845985,5530412
5946,2020-06-30,4903,Value,0,-9315573,14845985,5530412
5946,2020-09-30,4903,Value,0,-9315573,14845985,5530412
5946,2020-12-31,4903,Value,0,-9315573,14845985,5530412
5946,2021-03-31,4903,Value,0,-9315573,14845985,5530412
5946,2021-06-30,4903,Value,0,-9315573,14845985,5530412
5946,2021-09-30,4903,Value,0,-9315573,14845985,5530412
5946,2021-12-31,4903,Value,0,-9315573,14845985,5530412
5947,2020-02-15,141,Distribution,166776,-9854776,10221550,366774
5947,2020-03-31,141,Value,1684250,-9854776,10221550,366774
5947,2020-06-30,141,Value,2752930,-9854776,10221550,366774
5947,2020-08-15,141,Distribution,2572072,-9854776,12793622,2938846
5947,2020-09-30,141,Value,181210,-9854776,12793622,2938846
5947,2020-11-15,141,Distribution,152060,-9854776,12945682,3090906
5947,2020-12-31,141,Value,24480,-9854776,12945682,3090906
5947,2021-03-31,141,Value,24480,-9854776,12945682,3090906
5947,2021-06-30,141,Value,24480,-9854776,12945682,3090906
5947,2021-12-31,141,Value,0,-9854776,12945682,3090906
5948,2020-03-31,1430,Value,1365710,-10000000,21277142,11277142
5948,2020-06-30,1430,Value,1365710,-10000000,21277142,11277142
5948,2020-09-30,1430,Value,1962850,-10000000,21277142,11277142
5948,2020-12-31,1430,Value,2042850,-10000000,21277142,11277142
5948,2021-02-14,1430,Distribution,242857,-10000000,21519999,11519999
5948,2021-03-31,1430,Value,1805710,-10000000,21519999,11519999
5948,2021-06-30,1430,Value,1802850,-10000000,21519999,11519999
5951,2020-03-31,7225,Value,819670,-9578183,11758837,2180654
5951,2020-06-30,7225,Value,826440,-9578183,11758837,2180654
5951,2020-09-30,7225,Value,877480,-9578183,11758837,2180654
5951,2020-12-31,7225,Value,882730,-9578183,11758837,2180654
5951,2021-03-31,7225,Value,757540,-9578183,11758837,2180654
5951,2021-06-30,7225,Value,760350,-9578183,11758837,2180654
5951,2021-09-30,7225,Value,762220,-9578183,11758837,2180654
5966,2020-02-15,18601,Capital Call,-7708,-9555436,11143003,1587567
5966,2020-02-15,18601,Distribution,158799,-9555436,11301802,1746366
5966,2020-03-31,18601,Value,2287610,-9555436,11301802,1746366
5966,2020-05-16,18601,Capital Call,-26171,-9581607,11301802,1720195
5966,2020-05-16,18601,Distribution,188826,-9581607,11490628,1909021
5966,2020-06-30,18601,Value,2188600,-9581607,11490628,1909021
5966,2020-08-15,18601,Capital Call,-5478,-9587085,11490628,1903543
5966,2020-08-15,18601,Distribution,101818,-9587085,11592446,2005361
5966,2020-09-30,18601,Value,2080740,-9587085,11592446,2005361
5966,2020-11-15,18601,Capital Call,-10013,-9597098,11592446,1995348
5966,2020-11-15,18601,Distribution,660835,-9597098,12253281,2656183
5966,2020-12-31,18601,Value,1431760,-9597098,12253281,2656183
5966,2021-02-14,18601,Capital Call,-3950,-9601048,12253281,2652233
5966,2021-02-14,18601,Distribution,35922,-9601048,12289203,2688155
5966,2021-03-31,18601,Value,1352110,-9601048,12289203,2688155
5966,2021-05-16,18601,Capital Call,-5951,-9606999,12289203,2682204
5966,2021-05-16,18601,Distribution,70053,-9606999,12359256,2752257
5966,2021-06-30,18601,Value,1361630,-9606999,12359256,2752257
5980,2020-02-15,7252,Capital Call,-2470,-10070695,15350852,5280157
5980,2020-02-15,7252,Distribution,6955,-10070695,15357807,5287112
5980,2020-03-31,7252,Value,1490460,-10070695,15357807,5287112
5980,2020-06-30,7252,Value,1510600,-10070695,15357807,5287112
5980,2020-08-15,7252,Capital Call,3073,-10067622,15357807,5290185
5980,2020-08-15,7252,Distribution,-7875,-10067622,15349932,5282310
5980,2020-09-30,7252,Value,1520750,-10067622,15349932,5282310
5980,2020-11-15,7252,Distribution,3188,-10067622,15353120,5285498
5980,2020-12-31,7252,Value,1530270,-10067622,15353120,5285498
5980,2021-02-14,7252,Capital Call,-2379,-10070001,15353120,5283119
5980,2021-02-14,7252,Distribution,3629,-10070001,15356749,5286748
5980,2021-03-31,7252,Value,1460040,-10070001,15356749,5286748
5982,2020-02-15,211,Capital Call,-10000,-9890000,5690000,-4200000
5982,2020-02-15,211,Distribution,30000,-9890000,5720000,-4170000
5982,2020-03-31,211,Value,3760000,-9890000,5720000,-4170000
5982,2020-05-16,211,Distribution,430000,-9890000,6150000,-3740000
5982,2020-06-30,211,Value,3240000,-9890000,6150000,-3740000
5982,2020-08-15,211,Distribution,80000,-9890000,6230000,-3660000
5982,2020-09-30,211,Value,3009990,-9890000,6230000,-3660000
5982,2020-11-15,211,Distribution,80000,-9890000,6310000,-3580000
5982,2020-12-31,211,Value,2289990,-9890000,6310000,-3580000
5982,2021-02-14,211,Distribution,2290000,-9890000,8600000,-1290000
5982,2021-03-31,211,Value,0,-9890000,8600000,-1290000
5982,2021-05-16,211,Distribution,10000,-9890000,8610000,-1280000
5982,2021-06-30,211,Value,0,-9890000,8610000,-1280000
5982,2021-09-30,211,Value,0,-9890000,8610000,-1280000
5982,2021-12-31,211,Value,0,-9890000,8610000,-1280000
5996,2021-12-31,543,Value,0,-9690756,677953,-9012803
6002,2020-03-31,94,Value,215320,-9405593,18878033,9472440
6002,2020-06-30,94,Value,27440,-9405593,18878033,9472440
6002,2021-12-31,94,Value,0,-9405593,18878033,9472440
6019,2020-03-31,7326,Value,1052470,-9445226,9210863,-234363
6019,2020-06-30,7326,Value,1070350,-9445226,9210863,-234363
6019,2020-08-15,7326,Distribution,1015880,-9445226,10226743,781517
6019,2020-09-30,7326,Value,58840,-9445226,10226743,781517
6019,2020-12-31,7326,Value,56760,-9445226,10226743,781517
6019,2021-03-31,7326,Value,54280,-9445226,10226743,781517
6019,2021-06-30,7326,Value,47010,-9445226,10226743,781517
6036,2020-03-31,656,Value,2770990,-8750000,12754270,4004270
6036,2020-06-30,656,Value,2850750,-8750000,12754270,4004270
6036,2020-09-30,656,Value,2789520,-8750000,12754270,4004270
6036,2020-12-31,656,Value,2630290,-8750000,12754270,4004270
6036,2021-03-31,656,Value,2643440,-8750000,12754270,4004270
6036,2021-06-30,656,Value,2683040,-8750000,12754270,4004270
6036,2021-08-15,656,Capital Call,-645252,-9395252,12754270,3359018
6036,2021-09-30,656,Value,2050330,-9395252,12754270,3359018
6097,2020-03-31,7486,Value,1152940,-10094117,22764708,12670591
6097,2020-05-16,7486,Capital Call,-482353,-10576470,22764708,12188238
6097,2020-05-16,7486,Distribution,1117647,-10576470,23882355,13305885
6097,2020-06-30,7486,Value,1152940,-10576470,23882355,13305885
6097,2020-09-30,7486,Value,1152940,-10576470,23882355,13305885
6097,2020-11-15,7486,Capital Call,470588,-10105882,23882355,13776473
6097,2020-11-15,7486,Distribution,-470588,-10105882,23411767,13305885
6097,2020-12-31,7486,Value,1152940,-10105882,23411767,13305885
6097,2021-03-31,7486,Value,1152940,-10105882,23411767,13305885
6097,2021-06-30,7486,Value,1152940,-10105882,23411767,13305885
6097,2021-08-15,7486,Capital Call,3529,-10102353,23411767,13309414
6097,2021-08-15,7486,Distribution,817647,-10102353,24229414,14127061
6097,2021-09-30,7486,Value,1151760,-10102353,24229414,14127061
6168,2020-02-15,7567,Distribution,1486910,-9513982,4431632,-5082350
6168,2020-03-31,7567,Value,3926250,-9513982,4431632,-5082350
6168,2020-06-30,7567,Value,3329180,-9513982,4431632,-5082350
6168,2020-08-15,7567,Distribution,491968,-9513982,4923600,-4590382
6168,2020-09-30,7567,Value,2980710,-9513982,4923600,-4590382
6168,2020-12-31,7567,Value,3107760,-9513982,4923600,-4590382
6168,2021-03-31,7567,Value,3107760,-9513982,4923600,-4590382
6168,2021-06-30,7567,Value,2955910,-9513982,4923600,-4590382
6185,2020-03-31,7626,Value,1200590,-9324480,13541844,4217364
6185,2020-06-30,7626,Value,1339180,-9324480,13541844,4217364
6185,2020-09-30,7626,Value,1676310,-9324480,13541844,4217364
6185,2020-11-15,7626,Distribution,161241,-9324480,13703085,4378605
6185,2020-12-31,7626,Value,1812020,-9324480,13703085,4378605
6185,2021-03-31,7626,Value,2340510,-9324480,13703085,4378605
6185,2021-06-30,7626,Value,3411400,-9324480,13703085,4378605
6190,2021-12-31,2901,Value,0,-9735000,11993520,2258520
6238,2020-02-15,6868,Distribution,172652,-10000000,28724345,18724345
6238,2020-03-31,6868,Value,3249800,-10000000,28724345,18724345
6238,2020-06-30,6868,Value,3249800,-10000000,28724345,18724345
6238,2020-09-30,6868,Value,3420770,-10000000,28724345,18724345
6238,2020-12-31,6868,Value,3150980,-10000000,28724345,18724345
6238,2021-02-14,6868,Distribution,305055,-10000000,29029400,19029400
6238,2021-03-31,6868,Value,3399220,-10000000,29029400,19029400
6238,2021-05-16,6868,Distribution,517981,-10000000,29547381,19547381
6238,2021-06-30,6868,Value,2881240,-10000000,29547381,19547381
6241,2020-02-15,416,Distribution,342541,-10240577,11603031,1362454
6241,2020-03-31,416,Value,3532840,-10240577,11603031,1362454
6241,2020-05-16,416,Capital Call,-181102,-10421679,11603031,1181352
6241,2020-05-16,416,Distribution,2011,-10421679,11605042,1183363
6241,2020-06-30,416,Value,3468570,-10421679,11605042,1183363
6241,2020-08-15,416,Distribution,4294,-10421679,11609336,1187657
6241,2020-09-30,416,Value,3464270,-10421679,11609336,1187657
6241,2020-10-31,416,Capital Call,-2559,-10424238,11609336,1185098
6241,2020-10-31,416,Distribution,8748,-10424238,11618084,1193846
6241,2020-12-16,416,Capital Call,-32954,-10457192,11618084,1160892
6241,2020-12-16,416,Distribution,59136,-10457192,11677220,1220028
6241,2020-12-31,416,Value,3497790,-10457192,11677220,1220028
6241,2021-02-14,416,Distribution,6238,-10457192,11683458,1226266
6241,2021-03-31,416,Value,3844970,-10457192,11683458,1226266
6241,2021-12-31,416,Value,0,-10457192,11683458,1226266
6242,2020-02-15,1642,Distribution,456112,-9915644,15702728,5787084
6242,2020-03-31,1642,Value,162300,-9915644,15702728,5787084
6242,2020-06-30,1642,Value,63140,-9915644,15702728,5787084
6242,2020-09-30,1642,Value,63140,-9915644,15702728,5787084
6242,2020-11-15,1642,Distribution,73966,-9915644,15776694,5861050
6242,2021-12-31,1642,Value,0,-9915644,15776694,5861050
6246,2020-03-31,461,Value,0,-9604161,13704910,4100749
6246,2020-06-30,461,Value,0,-9604161,13704910,4100749
6246,2020-09-30,461,Value,0,-9604161,13704910,4100749
6246,2020-12-31,461,Value,0,-9604161,13704910,4100749
6246,2021-03-31,461,Value,0,-9604161,13704910,4100749
6246,2021-06-30,461,Value,0,-9604161,13704910,4100749
6246,2021-09-30,461,Value,0,-9604161,13704910,4100749
6246,2021-12-31,461,Value,0,-9604161,13704910,4100749
6277,2020-03-31,116,Value,0,-10416136,11134429,718293
6277,2020-06-30,116,Value,0,-10416136,11134429,718293
6277,2020-09-30,116,Value,0,-10416136,11134429,718293
6277,2020-12-31,116,Value,0,-10416136,11134429,718293
6277,2021-03-31,116,Value,0,-10416136,11134429,718293
6277,2021-06-30,116,Value,0,-10416136,11134429,718293
6277,2021-09-30,116,Value,0,-10416136,11134429,718293
6277,2021-12-31,116,Value,0,-10416136,11134429,718293
6355,2020-02-15,1360,Distribution,346000,-9411371,13266813,3855442
6355,2020-03-31,1360,Value,3705740,-9411371,13266813,3855442
6355,2020-05-16,1360,Distribution,250000,-9411371,13516813,4105442
6355,2020-06-30,1360,Value,2877340,-9411371,13516813,4105442
6355,2020-08-15,1360,Distribution,120000,-9411371,13636813,4225442
6355,2020-09-30,1360,Value,3612990,-9411371,13636813,4225442
6355,2020-11-15,1360,Distribution,132000,-9411371,13768813,4357442
6355,2020-12-31,1360,Value,3578540,-9411371,13768813,4357442
6355,2021-02-14,1360,Distribution,636000,-9411371,14404813,4993442
6355,2021-03-31,1360,Value,3518500,-9411371,14404813,4993442
6355,2021-06-30,1360,Value,3843970,-9411371,14404813,4993442
6364,2020-02-15,963,Distribution,500000,-9950000,13851087,3901087
6364,2020-03-31,963,Value,1099260,-9950000,13851087,3901087
6364,2020-06-30,963,Value,1129560,-9950000,13851087,3901087
6364,2020-09-30,963,Value,901090,-9950000,13851087,3901087
6364,2020-11-15,963,Distribution,220000,-9950000,14071087,4121087
6364,2020-12-31,963,Value,868670,-9950000,14071087,4121087
6364,2021-03-31,963,Value,735330,-9950000,14071087,4121087
6364,2021-06-30,963,Value,798480,-9950000,14071087,4121087
6364,2021-09-30,963,Value,799770,-9950000,14071087,4121087
6370,2020-02-15,5937,Distribution,1363,-9709614,14331622,4622008
6370,2020-03-31,5937,Value,5211520,-9709614,14331622,4622008
6370,2020-05-16,5937,Distribution,654,-9709614,14332276,4622662
6370,2020-06-30,5937,Value,5506410,-9709614,14332276,4622662
6370,2020-08-15,5937,Distribution,98299,-9709614,14430575,4720961
6370,2020-09-30,5937,Value,5502370,-9709614,14430575,4720961
6370,2020-11-15,5937,Distribution,68375,-9709614,14498950,4789336
6370,2020-12-31,5937,Value,6769370,-9709614,14498950,4789336
6370,2021-02-14,5937,Capital Call,-290385,-9999999,14498950,4498951
6370,2021-02-14,5937,Distribution,1702429,-9999999,16201379,6201380
6370,2021-03-31,5937,Value,5821580,-9999999,16201379,6201380
6370,2021-06-30,5937,Value,5817050,-9999999,16201379,6201380
6409,2020-03-31,801,Value,0,-10312501,15850001,5537500
6409,2020-06-30,801,Value,0,-10312501,15850001,5537500
6409,2020-09-30,801,Value,0,-10312501,15850001,5537500
6409,2020-12-31,801,Value,0,-10312501,15850001,5537500
6409,2021-03-31,801,Value,0,-10312501,15850001,5537500
6409,2021-06-30,801,Value,0,-10312501,15850001,5537500
6409,2021-09-30,801,Value,0,-10312501,15850001,5537500
6409,2021-12-31,801,Value,0,-10312501,15850001,5537500
6423,2020-03-31,573,Value,0,-9824750,14976682,5151932
6423,2020-06-30,573,Value,0,-9824750,14976682,5151932
6423,2020-09-30,573,Value,0,-9824750,14976682,5151932
6423,2020-12-31,573,Value,0,-9824750,14976682,5151932
6423,2021-03-31,573,Value,0,-9824750,14976682,5151932
6423,2021-06-30,573,Value,0,-9824750,14976682,5151932
6423,2021-09-30,573,Value,0,-9824750,14976682,5151932
6423,2021-12-31,573,Value,0,-9824750,14976682,5151932
6439,2020-03-31,803,Value,0,-9530056,11496066,1966010
6439,2020-06-30,803,Value,0,-9530056,11496066,1966010
6439,2020-09-30,803,Value,0,-9530056,11496066,1966010
6439,2020-12-31,803,Value,0,-9530056,11496066,1966010
6439,2021-03-31,803,Value,0,-9530056,11496066,1966010
6439,2021-06-30,803,Value,0,-9530056,11496066,1966010
6439,2021-09-30,803,Value,0,-9530056,11496066,1966010
6439,2021-12-31,803,Value,0,-9530056,11496066,1966010
6450,2020-03-31,100,Value,0,-9620001,11020001,1400000
6450,2020-06-30,100,Value,0,-9620001,11020001,1400000
6450,2020-09-30,100,Value,0,-9620001,11020001,1400000
6450,2020-12-31,100,Value,0,-9620001,11020001,1400000
6450,2021-03-31,100,Value,0,-9620001,11020001,1400000
6450,2021-06-30,100,Value,0,-9620001,11020001,1400000
6450,2021-09-30,100,Value,0,-9620001,11020001,1400000
6450,2021-12-31,100,Value,0,-9620001,11020001,1400000
6455,2020-06-30,444,Value,142770,-9611871,12598943,2987072
6455,2020-08-15,444,Distribution,58371,-9611871,12657314,3045443
6455,2020-09-30,444,Value,67300,-9611871,12657314,3045443
6455,2020-12-31,444,Value,71160,-9611871,12657314,3045443
6455,2021-02-14,444,Distribution,37377,-9611871,12694691,3082820
6455,2021-03-31,444,Value,33900,-9611871,12694691,3082820
6455,2021-06-30,444,Value,35080,-9611871,12694691,3082820
6455,2021-09-30,444,Value,35370,-9611871,12694691,3082820
6462,2020-03-31,114,Value,269140,-9894999,26850084,16955085
6462,2020-06-30,114,Value,278040,-9894999,26850084,16955085
6462,2020-09-30,114,Value,278040,-9894999,26850084,16955085
6462,2020-12-31,114,Value,277060,-9894999,26850084,16955085
6462,2021-03-31,114,Value,277060,-9894999,26850084,16955085
6473,2020-01-15,45,Distribution,1600193,-10000000,22187329,12187329
6473,2020-02-29,45,Value,6980190,-10000000,22187329,12187329
6473,2020-05-31,45,Value,7700030,-10000000,22187329,12187329
6473,2020-08-31,45,Value,9067420,-10000000,22187329,12187329
6473,2020-10-16,45,Distribution,9042584,-10000000,31229913,21229913
6473,2020-11-30,45,Value,56990,-10000000,31229913,21229913
6473,2021-02-28,45,Value,56990,-10000000,31229913,21229913
6473,2021-05-31,45,Value,236190,-10000000,31229913,21229913
6473,2021-08-31,45,Value,236190,-10000000,31229913,21229913
6473,2021-11-30,45,Value,251060,-10000000,31229913,21229913
6477,2020-03-31,362,Value,1597030,-10067830,7361772,-2706058
6477,2020-06-30,362,Value,1515690,-10067830,7361772,-2706058
6477,2020-09-30,362,Value,1286050,-10067830,7361772,-2706058
6477,2020-12-31,362,Value,1277300,-10067830,7361772,-2706058
6477,2021-03-31,362,Value,828680,-10067830,7361772,-2706058
6477,2021-06-30,362,Value,824850,-10067830,7361772,-2706058
6477,2021-09-30,362,Value,824950,-10067830,7361772,-2706058
6477,2021-12-31,362,Value,0,-10067830,7361772,-2706058
6483,2020-02-15,7976,Distribution,178378,-11378375,15767567,4389192
6483,2020-03-31,7976,Value,4356750,-11378375,15767567,4389192
6483,2020-05-16,7976,Capital Call,-10811,-11389186,15767567,4378381
6483,2020-05-16,7976,Distribution,464865,-11389186,16232432,4843246
6483,2020-06-30,7976,Value,4389180,-11389186,16232432,4843246
6483,2020-08-15,7976,Capital Call,-10811,-11399997,16232432,4832435
6483,2020-08-15,7976,Distribution,264865,-11399997,16497297,5097300
6483,2020-09-30,7976,Value,4551350,-11399997,16497297,5097300
6483,2020-11-15,7976,Capital Call,-10811,-11410808,16497297,5086489
6483,2020-11-15,7976,Distribution,313514,-11410808,16810811,5400003
6483,2020-12-31,7976,Value,4551350,-11410808,16810811,5400003
6483,2021-02-14,7976,Capital Call,-10811,-11421619,16810811,5389192
6483,2021-02-14,7976,Distribution,308108,-11421619,17118919,5697300
6483,2021-03-31,7976,Value,5643240,-11421619,17118919,5697300
6483,2021-05-16,7976,Capital Call,-5405,-11427024,17118919,5691895
6483,2021-05-16,7976,Distribution,129730,-11427024,17248649,5821625
6483,2021-06-30,7976,Value,5929720,-11427024,17248649,5821625
6483,2021-08-15,7976,Capital Call,1081,-11425943,17248649,5822706
6483,2021-08-15,7976,Distribution,342162,-11425943,17590811,6164868
6483,2021-09-30,7976,Value,5721080,-11425943,17590811,6164868
6487,2020-03-31,7981,Value,1155250,-10096367,9468104,-628263
6487,2020-06-30,7981,Value,1154930,-10096367,9468104,-628263
6487,2020-09-30,7981,Value,1154630,-10096367,9468104,-628263
6487,2020-12-31,7981,Value,1304400,-10096367,9468104,-628263
6487,2021-06-30,7981,Value,1301790,-10096367,9468104,-628263
6495,2020-02-15,1314,Capital Call,-30000,-9848999,13365626,3516627
6495,2020-02-15,1314,Distribution,195465,-9848999,13561091,3712092
6495,2020-03-31,1314,Value,3421540,-9848999,13561091,3712092
6495,2020-05-16,1314,Distribution,165463,-9848999,13726554,3877555
6495,2020-06-30,1314,Value,3698290,-9848999,13726554,3877555
6495,2020-08-15,1314,Capital Call,-25000,-9873999,13726554,3852555
6495,2020-08-15,1314,Distribution,364634,-9873999,14091188,4217189
6495,2020-09-30,1314,Value,3424300,-9873999,14091188,4217189
6495,2020-11-15,1314,Distribution,1059480,-9873999,15150668,5276669
6495,2020-12-31,1314,Value,3873570,-9873999,15150668,5276669
6495,2021-02-14,1314,Distribution,232039,-9873999,15382707,5508708
6495,2021-03-31,1314,Value,4055250,-9873999,15382707,5508708
6495,2021-05-16,1314,Distribution,267585,-9873999,15650292,5776293
6495,2021-06-30,1314,Value,4181630,-9873999,15650292,5776293
6495,2021-08-15,1314,Distribution,462103,-9873999,16112395,6238396
6495,2021-09-30,1314,Value,3777790,-9873999,16112395,6238396
6496,2020-02-15,1314,Capital Call,-6000,-9685999,13141571,3455572
6496,2020-02-15,1314,Distribution,147624,-9685999,13289195,3603196
6496,2020-03-31,1314,Value,1344410,-9685999,13289195,3603196
6496,2020-05-16,1314,Capital Call,-43,-9686042,13289195,3603153
6496,2020-05-16,1314,Distribution,148347,-9686042,13437542,3751500
6496,2020-06-30,1314,Value,1378720,-9686042,13437542,3751500
6496,2020-08-15,1314,Capital Call,43,-9685999,13437542,3751543
6496,2020-08-15,1314,Distribution,-151,-9685999,13437391,3751392
6496,2020-09-30,1314,Value,1506170,-9685999,13437391,3751392
6496,2020-11-15,1314,Distribution,-968600,-9685999,12468791,2782792
6496,2020-12-31,1314,Value,1656300,-9685999,12468791,2782792
6496,2021-02-14,1314,Distribution,1066429,-9685999,13535220,3849221
6496,2021-03-31,1314,Value,1561380,-9685999,13535220,3849221
6496,2021-05-16,1314,Distribution,59085,-9685999,13594305,3908306
6496,2021-06-30,1314,Value,1562350,-9685999,13594305,3908306
6496,2021-08-15,1314,Distribution,-427153,-9685999,13167152,3481153
6496,2021-09-30,1314,Value,1384120,-9685999,13167152,3481153
6505,2020-03-31,3017,Value,0,-6846846,0,-6846846
6505,2020-06-30,3017,Value,0,-6846846,0,-6846846
6505,2020-09-30,3017,Value,0,-6846846,0,-6846846
6505,2020-12-31,3017,Value,0,-6846846,0,-6846846
6505,2021-03-31,3017,Value,0,-6846846,0,-6846846
6505,2021-06-30,3017,Value,0,-6846846,0,-6846846
6505,2021-09-30,3017,Value,0,-6846846,0,-6846846
6505,2021-12-31,3017,Value,0,-6846846,0,-6846846
6535,2020-01-20,515145,Distribution,40593,-8540093,10887880,2347787
6535,2020-02-27,515145,Distribution,36533,-8540093,10924413,2384320
6535,2020-03-12,515145,Distribution,71037,-8540093,10995450,2455357
6535,2020-03-31,515145,Value,494220,-8540093,10995450,2455357
6562,2020-02-15,832,Distribution,31937,-9678001,11762641,2084640
6562,2020-03-31,832,Value,449050,-9678001,11762641,2084640
6562,2020-06-30,832,Value,474220,-9678001,11762641,2084640
6562,2020-08-15,832,Capital Call,-1000,-9679001,11762641,2083640
6562,2020-08-15,832,Distribution,-18143,-9679001,11744498,2065497
6562,2020-09-30,832,Value,444260,-9679001,11744498,2065497
6562,2020-11-15,832,Capital Call,10000,-9669001,11744498,2075497
6562,2020-11-15,832,Distribution,34277,-9669001,11778775,2109774
6562,2020-12-31,832,Value,325840,-9669001,11778775,2109774
6562,2021-03-31,832,Value,385790,-9669001,11778775,2109774
6562,2021-06-30,832,Value,382890,-9669001,11778775,2109774
6562,2021-09-30,832,Value,429300,-9669001,11778775,2109774
6562,2021-11-15,832,Distribution,20305,-9669001,11799080,2130079
6562,2021-12-31,832,Value,395460,-9669001,11799080,2130079
6565,2020-01-15,756,Capital Call,0,-13812998,25379105,11566107
6565,2020-01-15,756,Distribution,0,-13812998,25379105,11566107
6565,2020-02-29,756,Value,737550,-13812998,25379105,11566107
6565,2020-04-15,756,Capital Call,0,-13812998,25379105,11566107
6565,2020-04-15,756,Distribution,0,-13812998,25379105,11566107
6565,2020-05-31,756,Value,746880,-13812998,25379105,11566107
6565,2020-08-31,756,Value,562050,-13812998,25379105,11566107
6565,2020-11-30,756,Value,636080,-13812998,25379105,11566107
6565,2021-02-28,756,Value,730390,-13812998,25379105,11566107
6565,2021-05-31,756,Value,735720,-13812998,25379105,11566107
6565,2021-08-31,756,Value,1192850,-13812998,25379105,11566107
6565,2021-12-31,756,Value,0,-13812998,25379105,11566107
6577,2020-03-31,8072,Value,519070,-9800000,13263376,3463376
6577,2020-06-30,8072,Value,519070,-9800000,13263376,3463376
6577,2020-09-30,8072,Value,524100,-9800000,13263376,3463376
6577,2020-12-31,8072,Value,520960,-9800000,13263376,3463376
6577,2021-06-30,8072,Value,491430,-9800000,13263376,3463376
6586,2020-03-31,2220,Value,2169180,-10240961,3725064,-6515897
6586,2020-05-16,2220,Distribution,475000,-10240961,4200064,-6040897
6586,2020-06-30,2220,Value,1664230,-10240961,4200064,-6040897
6586,2020-08-15,2220,Distribution,300000,-10240961,4500064,-5740897
6586,2020-09-30,2220,Value,1319760,-10240961,4500064,-5740897
6586,2020-12-31,2220,Value,1288030,-10240961,4500064,-5740897
6586,2021-03-31,2220,Value,1216470,-10240961,4500064,-5740897
6586,2021-06-30,2220,Value,1268910,-10240961,4500064,-5740897
6588,2021-12-31,1886,Value,0,-9900000,15217449,5317449
6589,2020-03-31,1886,Value,0,-10000000,19972860,9972860
6589,2020-06-30,1886,Value,0,-10000000,19972860,9972860
6589,2020-09-30,1886,Value,0,-10000000,19972860,9972860
6589,2020-12-31,1886,Value,0,-10000000,19972860,9972860
6589,2021-03-31,1886,Value,0,-10000000,19972860,9972860
6589,2021-06-30,1886,Value,0,-10000000,19972860,9972860
6589,2021-09-30,1886,Value,0,-10000000,19972860,9972860
6589,2021-12-31,1886,Value,0,-10000000,19972860,9972860
6590,2020-03-31,1886,Value,0,-10000000,78485555,68485555
6590,2020-06-30,1886,Value,0,-10000000,78485555,68485555
6590,2020-09-30,1886,Value,0,-10000000,78485555,68485555
6590,2020-12-31,1886,Value,0,-10000000,78485555,68485555
6590,2021-03-31,1886,Value,0,-10000000,78485555,68485555
6590,2021-06-30,1886,Value,0,-10000000,78485555,68485555
6590,2021-09-30,1886,Value,0,-10000000,78485555,68485555
6590,2021-12-31,1886,Value,0,-10000000,78485555,68485555
6591,2020-03-31,1886,Value,0,-10000001,22648343,12648342
6591,2020-06-30,1886,Value,0,-10000001,22648343,12648342
6591,2020-09-30,1886,Value,0,-10000001,22648343,12648342
6591,2020-12-31,1886,Value,0,-10000001,22648343,12648342
6591,2021-03-31,1886,Value,0,-10000001,22648343,12648342
6591,2021-06-30,1886,Value,0,-10000001,22648343,12648342
6591,2021-09-30,1886,Value,0,-10000001,22648343,12648342
6591,2021-12-31,1886,Value,0,-10000001,22648343,12648342
6594,2020-03-31,1886,Value,0,-10000000,14940536,4940536
6594,2020-06-30,1886,Value,0,-10000000,14940536,4940536
6594,2020-09-30,1886,Value,0,-10000000,14940536,4940536
6594,2020-12-31,1886,Value,0,-10000000,14940536,4940536
6594,2021-03-31,1886,Value,0,-10000000,14940536,4940536
6594,2021-06-30,1886,Value,0,-10000000,14940536,4940536
6594,2021-09-30,1886,Value,0,-10000000,14940536,4940536
6594,2021-12-31,1886,Value,0,-10000000,14940536,4940536
6595,2020-03-31,1886,Value,0,-9999999,52923264,42923265
6595,2020-06-30,1886,Value,0,-9999999,52923264,42923265
6595,2020-09-30,1886,Value,0,-9999999,52923264,42923265
6595,2020-12-31,1886,Value,0,-9999999,52923264,42923265
6595,2021-03-31,1886,Value,0,-9999999,52923264,42923265
6595,2021-06-30,1886,Value,0,-9999999,52923264,42923265
6595,2021-09-30,1886,Value,0,-9999999,52923264,42923265
6595,2021-12-31,1886,Value,0,-9999999,52923264,42923265
6645,2020-03-31,355,Value,2041410,-10983891,12308718,1324827
6654,2020-02-15,812,Capital Call,-7826,-9716520,13366958,3650438
6654,2020-02-15,812,Distribution,329565,-9716520,13696523,3980003
6654,2020-03-31,812,Value,2824340,-9716520,13696523,3980003
6654,2020-05-16,812,Capital Call,-7826,-9724346,13696523,3972177
6654,2020-05-16,812,Distribution,285217,-9724346,13981740,4257394
6654,2020-06-30,812,Value,1746950,-9724346,13981740,4257394
6654,2020-08-15,812,Capital Call,-7826,-9732172,13981740,4249568
6654,2020-08-15,812,Distribution,244348,-9732172,14226088,4493916
6654,2020-09-30,812,Value,1713040,-9732172,14226088,4493916
6654,2020-11-15,812,Capital Call,-7826,-9739998,14226088,4486090
6654,2020-11-15,812,Distribution,226087,-9739998,14452175,4712177
6654,2020-12-31,812,Value,1487820,-9739998,14452175,4712177
6654,2021-02-14,812,Capital Call,-6957,-9746955,14452175,4705220
6654,2021-02-14,812,Distribution,182609,-9746955,14634784,4887829
6654,2021-03-31,812,Value,1758260,-9746955,14634784,4887829
6654,2021-05-16,812,Capital Call,-6957,-9753912,14634784,4880872
6654,2021-05-16,812,Distribution,221739,-9753912,14856523,5102611
6654,2021-06-30,812,Value,1695650,-9753912,14856523,5102611
6716,2020-02-15,725,Distribution,360000,-9960000,14560003,4600003
6716,2020-03-31,725,Value,1360000,-9960000,14560003,4600003
6716,2020-06-30,725,Value,1360000,-9960000,14560003,4600003
6716,2020-08-15,725,Distribution,800000,-9960000,15360003,5400003
6716,2020-09-30,725,Value,160000,-9960000,15360003,5400003
6716,2020-11-15,725,Distribution,320000,-9960000,15680003,5720003
6716,2020-12-31,725,Value,0,-9960000,15680003,5720003
6716,2021-03-31,725,Value,0,-9960000,15680003,5720003
6716,2021-06-30,725,Value,0,-9960000,15680003,5720003
6716,2021-09-30,725,Value,0,-9960000,15680003,5720003
6716,2021-12-31,725,Value,0,-9960000,15680003,5720003
6718,2020-03-31,368,Value,3109290,-10000000,11728367,1728367
6718,2020-06-30,368,Value,3016320,-10000000,11728367,1728367
6718,2020-09-30,368,Value,3139620,-10000000,11728367,1728367
6718,2020-11-15,368,Distribution,196044,-10000000,11924411,1924411
6718,2020-12-31,368,Value,2924890,-10000000,11924411,1924411
6718,2021-03-31,368,Value,4163440,-10000000,11924411,1924411
6718,2021-05-16,368,Distribution,3006731,-10000000,14931142,4931142
6718,2021-06-30,368,Value,1463480,-10000000,14931142,4931142
6724,2020-02-29,7473,Value,1653680,-10000000,5256630,-4743370
6724,2020-05-31,7473,Value,1652940,-10000000,5256630,-4743370
6724,2020-08-31,7473,Value,1652510,-10000000,5256630,-4743370
6724,2020-11-30,7473,Value,1652510,-10000000,5256630,-4743370
6724,2021-02-28,7473,Value,1652510,-10000000,5256630,-4743370
6724,2021-05-31,7473,Value,1380800,-10000000,5256630,-4743370
6724,2021-08-31,7473,Value,1380800,-10000000,5256630,-4743370
6724,2021-11-30,7473,Value,1380800,-10000000,5256630,-4743370
6732,2020-03-31,162,Value,3450,-10000599,9602578,-398021
6732,2020-06-30,162,Value,3430,-10000599,9602578,-398021
6732,2020-09-30,162,Value,10720,-10000599,9602578,-398021
6732,2021-12-31,162,Value,0,-10000599,9602578,-398021
6765,2020-01-15,895,Capital Call,0,-10557913,12108094,1550181
6765,2020-01-15,895,Distribution,0,-10557913,12108094,1550181
6765,2020-02-29,895,Value,2815690,-10557913,12108094,1550181
6765,2020-04-15,895,Capital Call,0,-10557913,12108094,1550181
6765,2020-04-15,895,Distribution,0,-10557913,12108094,1550181
6765,2020-05-31,895,Value,1779270,-10557913,12108094,1550181
6765,2020-08-31,895,Value,1641120,-10557913,12108094,1550181
6765,2020-10-16,895,Capital Call,-230447,-10788360,12108094,1319734
6765,2020-11-30,895,Value,1861940,-10788360,12108094,1319734
6765,2021-02-28,895,Value,1861940,-10788360,12108094,1319734
6765,2021-05-31,895,Value,2289220,-10788360,12108094,1319734
6765,2021-08-31,895,Value,2249510,-10788360,12108094,1319734
6765,2021-10-16,895,Capital Call,0,-10788360,12108094,1319734
6765,2021-10-16,895,Distribution,0,-10788360,12108094,1319734
6765,2021-11-30,895,Value,2240630,-10788360,12108094,1319734
6894,2020-03-31,8366,Value,17321460,-10000000,253180,-9746820
6894,2020-06-30,8366,Value,17321460,-10000000,253180,-9746820
6894,2020-09-30,8366,Value,14383480,-10000000,253180,-9746820
6894,2020-11-15,8366,Distribution,239000,-10000000,492180,-9507820
6894,2020-12-31,8366,Value,14120060,-10000000,492180,-9507820
6896,2021-12-31,910,Value,0,-9740003,7918619,-1821384
6920,2020-03-31,736,Value,0,-10000000,15162001,5162001
6920,2020-06-30,736,Value,0,-10000000,15162001,5162001
6920,2020-09-30,736,Value,0,-10000000,15162001,5162001
6920,2020-12-31,736,Value,0,-10000000,15162001,5162001
6920,2021-03-31,736,Value,0,-10000000,15162001,5162001
6920,2021-06-30,736,Value,0,-10000000,15162001,5162001
6920,2021-09-30,736,Value,0,-10000000,15162001,5162001
6920,2021-12-31,736,Value,0,-10000000,15162001,5162001
6921,2020-02-15,770,Distribution,340000,-10000000,1420000,-8580000
6921,2020-03-31,770,Value,2240000,-10000000,1420000,-8580000
6921,2020-06-30,770,Value,2120000,-10000000,1420000,-8580000
6921,2020-09-30,770,Value,3180000,-10000000,1420000,-8580000
6921,2020-11-15,770,Distribution,1860000,-10000000,3280000,-6720000
6921,2020-12-31,770,Value,0,-10000000,3280000,-6720000
6921,2021-06-30,770,Value,0,-10000000,3280000,-6720000
6921,2021-09-30,770,Value,0,-10000000,3280000,-6720000
6921,2021-12-31,770,Value,0,-10000000,3280000,-6720000
6923,2020-03-31,187,Value,1278860,-10179550,20810756,10631206
6923,2020-06-30,187,Value,1278860,-10179550,20810756,10631206
6923,2020-09-30,187,Value,1278860,-10179550,20810756,10631206
6923,2020-12-31,187,Value,1380660,-10179550,20810756,10631206
6923,2021-03-31,187,Value,1278860,-10179550,20810756,10631206
6923,2021-06-30,187,Value,1787840,-10179550,20810756,10631206
6956,2020-03-31,7,Value,1328970,-9660000,12393554,2733554
6956,2020-05-16,7,Distribution,0,-9660000,12393554,2733554
6956,2020-06-30,7,Value,1486710,-9660000,12393554,2733554
6956,2020-09-30,7,Value,1666320,-9660000,12393554,2733554
6956,2020-11-15,7,Distribution,281850,-9660000,12675404,3015404
6956,2020-12-31,7,Value,1549880,-9660000,12675404,3015404
6956,2021-02-14,7,Distribution,0,-9660000,12675404,3015404
6956,2021-03-31,7,Value,1620240,-9660000,12675404,3015404
6956,2021-05-16,7,Distribution,237096,-9660000,12912500,3252500
6956,2021-06-30,7,Value,1373230,-9660000,12912500,3252500
6968,2020-02-15,6402,Distribution,4840000,-10080000,19880000,9800000
6968,2020-03-31,6402,Value,7400000,-10080000,19880000,9800000
6968,2020-06-30,6402,Value,12800000,-10080000,19880000,9800000
6968,2020-09-30,6402,Value,12800000,-10080000,19880000,9800000
6968,2020-12-31,6402,Value,24880000,-10080000,19880000,9800000
6968,2021-03-31,6402,Value,25000000,-10080000,19880000,9800000
6968,2021-06-30,6402,Value,32160000,-10080000,19880000,9800000
6968,2021-09-30,6402,Value,25960000,-10080000,19880000,9800000
6971,2021-12-31,337,Value,0,-10000000,11500000,1500000
6984,2020-02-15,579,Capital Call,-3000,-9837998,16360527,6522529
6984,2020-02-15,579,Distribution,44343,-9837998,16404870,6566872
6984,2020-03-31,579,Value,316780,-9837998,16404870,6566872
6984,2020-05-16,579,Capital Call,38000,-9799998,16404870,6604872
6984,2020-05-16,579,Distribution,-244665,-9799998,16160205,6360207
6984,2020-06-30,579,Value,215600,-9799998,16160205,6360207
7015,2020-03-31,545,Value,27450,-11293551,16967246,5673695
7015,2020-06-30,545,Value,19740,-11293551,16967246,5673695
7015,2020-09-30,545,Value,11290,-11293551,16967246,5673695
7015,2020-12-31,545,Value,2390,-11293551,16967246,5673695
7015,2021-03-31,545,Value,41410,-11293551,16967246,5673695
7015,2021-05-16,545,Distribution,19274,-11293551,16986520,5692969
7015,2021-06-30,545,Value,22760,-11293551,16986520,5692969
7042,2020-02-15,25007,Capital Call,-149423,-7491422,3730470,-3760952
7042,2020-02-15,25007,Distribution,307128,-7491422,4037598,-3453824
7042,2020-03-31,25007,Value,1523800,-7491422,4037598,-3453824
7042,2020-06-30,25007,Value,1522100,-7491422,4037598,-3453824
7042,2020-09-30,25007,Value,1520760,-7491422,4037598,-3453824
7042,2020-12-31,25007,Value,1517710,-7491422,4037598,-3453824
7042,2021-02-14,25007,Capital Call,149423,-7341999,4037598,-3304401
7042,2021-02-14,25007,Distribution,-307128,-7341999,3730470,-3611529
7042,2021-03-31,25007,Value,2778210,-7341999,3730470,-3611529
7042,2021-05-16,25007,Capital Call,-149423,-7491422,3730470,-3760952
7042,2021-05-16,25007,Distribution,1480451,-7491422,5210921,-2280501
7042,2021-06-30,25007,Value,0,-7491422,5210921,-2280501
7054,2020-03-31,401,Value,0,-10000000,9034145,-965855
7054,2020-06-30,401,Value,0,-10000000,9034145,-965855
7054,2020-09-30,401,Value,0,-10000000,9034145,-965855
7054,2020-12-31,401,Value,0,-10000000,9034145,-965855
7054,2021-03-31,401,Value,0,-10000000,9034145,-965855
7054,2021-06-30,401,Value,0,-10000000,9034145,-965855
7054,2021-09-30,401,Value,0,-10000000,9034145,-965855
7054,2021-12-31,401,Value,0,-10000000,9034145,-965855
7082,2020-03-31,8512,Value,951510,-9028700,10193695,1164995
7082,2020-06-30,8512,Value,990550,-9028700,10193695,1164995
7082,2020-08-15,8512,Distribution,183992,-9028700,10377687,1348987
7082,2020-09-30,8512,Value,895760,-9028700,10377687,1348987
7082,2020-12-31,8512,Value,880860,-9028700,10377687,1348987
7082,2021-03-31,8512,Value,1033160,-9028700,10377687,1348987
7082,2021-05-16,8512,Distribution,59979,-9028700,10437666,1408966
7082,2021-06-30,8512,Value,1095010,-9028700,10437666,1408966
7083,2020-02-15,733,Distribution,178390,-8718712,12295225,3576513
7083,2020-03-31,733,Value,188280,-8718712,12295225,3576513
7083,2020-06-30,733,Value,223300,-8718712,12295225,3576513
7083,2020-08-15,733,Distribution,133532,-8718712,12428757,3710045
7083,2020-09-30,733,Value,107320,-8718712,12428757,3710045
7083,2020-12-31,733,Value,104780,-8718712,12428757,3710045
7083,2021-03-31,733,Value,76210,-8718712,12428757,3710045
7083,2021-05-16,733,Distribution,44856,-8718712,12473613,3754901
7083,2021-06-30,733,Value,26560,-8718712,12473613,3754901
7083,2021-09-30,733,Value,26200,-8718712,12473613,3754901
7116,2020-03-31,1632,Value,0,-9889999,28940118,19050119
7116,2020-06-30,1632,Value,0,-9889999,28940118,19050119
7116,2020-09-30,1632,Value,0,-9889999,28940118,19050119
7116,2020-12-31,1632,Value,0,-9889999,28940118,19050119
7116,2021-03-31,1632,Value,0,-9889999,28940118,19050119
7116,2021-06-30,1632,Value,0,-9889999,28940118,19050119
7116,2021-09-30,1632,Value,0,-9889999,28940118,19050119
7116,2021-12-31,1632,Value,0,-9889999,28940118,19050119
7131,2020-02-15,1152,Distribution,3333,-9959999,4739999,-5220000
7131,2020-03-31,1152,Value,803330,-9959999,4739999,-5220000
7131,2020-05-16,1152,Distribution,-3333,-9959999,4736666,-5223333
7131,2020-06-30,1152,Value,803330,-9959999,4736666,-5223333
7131,2020-08-15,1152,Distribution,243333,-9959999,4979999,-4980000
7131,2020-09-30,1152,Value,553330,-9959999,4979999,-4980000
7131,2020-11-15,1152,Capital Call,-3333,-9963332,4979999,-4983333
7131,2020-11-15,1152,Distribution,496667,-9963332,5476666,-4486666
7131,2020-12-31,1152,Value,553330,-9963332,5476666,-4486666
7131,2021-03-31,1152,Value,553330,-9963332,5476666,-4486666
7131,2021-06-30,1152,Value,553330,-9963332,5476666,-4486666
7131,2021-08-15,1152,Capital Call,1333,-9961999,5476666,-4485333
7131,2021-08-15,1152,Distribution,1333,-9961999,5477999,-4484000
7131,2021-09-30,1152,Value,554660,-9961999,5477999,-4484000
7141,2021-12-31,3802,Value,0,-9373000,7876130,-1496870
7177,2020-03-31,8571,Value,294890,-9689983,29732664,20042681
7177,2020-06-30,8571,Value,318810,-9689983,29732664,20042681
7177,2020-08-15,8571,Distribution,190016,-9689983,29922680,20232697
7177,2020-09-30,8571,Value,150340,-9689983,29922680,20232697
7177,2020-12-31,8571,Value,190650,-9689983,29922680,20232697
7223,2020-03-31,2204,Value,2111820,-10020777,19113247,9092470
7223,2020-06-30,2204,Value,2055410,-10020777,19113247,9092470
7223,2020-09-30,2204,Value,2119650,-10020777,19113247,9092470
7223,2020-12-31,2204,Value,2353900,-10020777,19113247,9092470
7223,2021-02-14,2204,Capital Call,-496938,-10517715,19113247,8595532
7223,2021-03-31,2204,Value,2417200,-10517715,19113247,8595532
7223,2021-06-30,2204,Value,2124910,-10517715,19113247,8595532
7223,2021-09-30,2204,Value,2124850,-10517715,19113247,8595532
7224,2020-03-31,2564,Value,1231580,-9854328,20969390,11115062
7224,2020-05-16,2564,Capital Call,-5517,-9859845,20969390,11109545
7224,2020-06-30,2564,Value,1595290,-9859845,20969390,11109545
7224,2020-08-15,2564,Capital Call,-6645,-9866490,20969390,11102900
7224,2020-08-15,2564,Distribution,14382,-9866490,20983772,11117282
7224,2020-09-30,2564,Value,1736380,-9866490,20983772,11117282
7224,2020-11-15,2564,Capital Call,-4390,-9870880,20983772,11112892
7224,2020-11-15,2564,Distribution,507731,-9870880,21491503,11620623
7224,2020-12-31,2564,Value,1539650,-9870880,21491503,11620623
7224,2021-02-14,2564,Capital Call,-5517,-9876397,21491503,11615106
7224,2021-02-14,2564,Distribution,234923,-9876397,21726426,11850029
7224,2021-03-31,2564,Value,1588930,-9876397,21726426,11850029
7224,2021-05-16,2564,Distribution,349476,-9876397,22075902,12199505
7224,2021-06-30,2564,Value,1254650,-9876397,22075902,12199505
7230,2020-02-15,436,Capital Call,-233,-11720781,17065776,5344995
7230,2020-02-15,436,Distribution,247857,-11720781,17313633,5592852
7230,2020-03-31,436,Value,2551640,-11720781,17313633,5592852
7230,2020-05-16,436,Capital Call,-3192,-11723973,17313633,5589660
7230,2020-05-16,436,Distribution,12884,-11723973,17326517,5602544
7230,2020-06-30,436,Value,2640290,-11723973,17326517,5602544
7230,2020-08-15,436,Capital Call,-165,-11724138,17326517,5602379
7230,2020-08-15,436,Distribution,345436,-11724138,17671953,5947815
7230,2020-09-30,436,Value,2550290,-11724138,17671953,5947815
7230,2020-11-15,436,Distribution,399979,-11724138,18071932,6347794
7230,2020-12-31,436,Value,2504460,-11724138,18071932,6347794
7230,2021-02-14,436,Distribution,98745,-11724138,18170677,6446539
7230,2021-03-31,436,Value,2546400,-11724138,18170677,6446539
7230,2021-05-16,436,Distribution,557515,-11724138,18728192,7004054
7230,2021-06-30,436,Value,1937200,-11724138,18728192,7004054
7234,2020-03-31,2212,Value,2558000,-10000000,16958001,6958001
7234,2020-06-30,2212,Value,2618000,-10000000,16958001,6958001
7234,2020-09-30,2212,Value,2755000,-10000000,16958001,6958001
7234,2020-11-15,2212,Distribution,-20000,-10000000,16938001,6938001
7234,2020-12-31,2212,Value,2922000,-10000000,16938001,6938001
7234,2021-03-31,2212,Value,2962000,-10000000,16938001,6938001
7234,2021-06-30,2212,Value,2987000,-10000000,16938001,6938001
7234,2021-09-30,2212,Value,3072000,-10000000,16938001,6938001
7240,2020-03-31,1484,Value,0,-9577678,18615916,9038238
7240,2020-06-30,1484,Value,0,-9577678,18615916,9038238
7240,2020-09-30,1484,Value,0,-9577678,18615916,9038238
7240,2020-12-31,1484,Value,0,-9577678,18615916,9038238
7240,2021-03-31,1484,Value,0,-9577678,18615916,9038238
7240,2021-06-30,1484,Value,0,-9577678,18615916,9038238
7240,2021-09-30,1484,Value,0,-9577678,18615916,9038238
7240,2021-12-31,1484,Value,0,-9577678,18615916,9038238
7249,2020-03-31,60,Distribution,4155805,-10021577,24201731,14180154
7249,2020-06-30,60,Value,86170,-10021577,24201731,14180154
7249,2020-09-30,60,Value,84110,-10021577,24201731,14180154
7249,2020-12-31,60,Value,82750,-10021577,24201731,14180154
7249,2021-03-31,60,Value,101760,-10021577,24201731,14180154
7249,2021-06-30,60,Value,100260,-10021577,24201731,14180154
7249,2021-09-30,60,Value,97880,-10021577,24201731,14180154
7253,2020-03-31,8649,Value,411340,-11780176,11411581,-368595
7253,2020-06-30,8649,Value,440730,-11780176,11411581,-368595
7253,2020-09-30,8649,Value,390580,-11780176,11411581,-368595
7253,2020-12-31,8649,Value,325770,-11780176,11411581,-368595
7253,2021-02-14,8649,Distribution,141820,-11780176,11553401,-226775
7253,2021-03-31,8649,Value,320440,-11780176,11553401,-226775
7253,2021-06-30,8649,Value,334380,-11780176,11553401,-226775
7259,2021-12-31,8654,Value,0,-5454181,2703584,-2750597
7273,2020-03-31,8661,Value,1029000,-10000000,22834000,12834000
7273,2020-06-30,8661,Value,1046000,-10000000,22834000,12834000
7273,2020-09-30,8661,Value,1231000,-10000000,22834000,12834000
7273,2020-12-31,8661,Value,1092000,-10000000,22834000,12834000
7273,2021-06-30,8661,Value,894000,-10000000,22834000,12834000
7273,2021-09-30,8661,Value,853000,-10000000,22834000,12834000
7273,2021-12-31,8661,Value,763000,-10000000,22834000,12834000
7286,2020-02-15,21861,Distribution,46250,-9250000,41060750,31810750
7286,2020-03-31,21861,Value,0,-9250000,41060750,31810750
7286,2020-06-30,21861,Value,0,-9250000,41060750,31810750
7286,2020-09-30,21861,Value,0,-9250000,41060750,31810750
7286,2020-12-31,21861,Value,0,-9250000,41060750,31810750
7286,2021-03-31,21861,Value,0,-9250000,41060750,31810750
7286,2021-06-30,21861,Value,0,-9250000,41060750,31810750
7286,2021-09-30,21861,Value,0,-9250000,41060750,31810750
7286,2021-12-31,21861,Value,0,-9250000,41060750,31810750
7288,2020-03-31,617,Distribution,7676,-9454871,15493636,6038765
7288,2020-06-30,617,Value,11400,-9454871,15493636,6038765
7288,2020-12-31,617,Value,11400,-9454871,15493636,6038765
7288,2021-03-31,617,Value,15390,-9454871,15493636,6038765
7288,2021-06-30,617,Value,15360,-9454871,15493636,6038765
7288,2021-08-15,617,Capital Call,199,-9454672,15493636,6038964
7288,2021-08-15,617,Distribution,10017,-9454672,15503653,6048981
7288,2021-09-30,617,Value,5180,-9454672,15503653,6048981
7305,2020-03-31,18619,Value,187930,-10015858,13470538,3454680
7305,2020-06-30,18619,Value,195080,-10015858,13470538,3454680
7305,2020-09-30,18619,Value,188300,-10015858,13470538,3454680
7305,2020-11-15,18619,Capital Call,-6900,-10022758,13470538,3447780
7305,2020-11-15,18619,Distribution,45012,-10022758,13515550,3492792
7305,2020-12-31,18619,Value,150440,-10022758,13515550,3492792
7305,2021-02-14,18619,Capital Call,0,-10022758,13515550,3492792
7305,2021-02-14,18619,Distribution,0,-10022758,13515550,3492792
7305,2021-03-31,18619,Value,150440,-10022758,13515550,3492792
7305,2021-05-16,18619,Capital Call,-1112,-10023870,13515550,3491680
7305,2021-05-16,18619,Distribution,34445,-10023870,13549995,3526125
7305,2021-06-30,18619,Value,117520,-10023870,13549995,3526125
7305,2021-09-30,18619,Value,114980,-10023870,13549995,3526125
7334,2020-02-15,8710,Distribution,417390,-9918982,18713996,8795014
7334,2020-03-31,8710,Value,9239340,-9918982,18713996,8795014
7334,2020-06-30,8710,Value,11665120,-9918982,18713996,8795014
7334,2020-09-30,8710,Value,12427160,-9918982,18713996,8795014
7334,2020-12-31,8710,Value,17965760,-9918982,18713996,8795014
7334,2021-03-31,8710,Value,16934030,-9918982,18713996,8795014
7334,2021-05-16,8710,Distribution,3421466,-9918982,22135462,12216480
7334,2021-06-30,8710,Value,11670430,-9918982,22135462,12216480
7338,2020-03-31,8713,Value,1293820,-9050000,9026824,-23176
7338,2020-06-30,8713,Value,1298710,-9050000,9026824,-23176
7338,2020-09-30,8713,Value,1298730,-9050000,9026824,-23176
7338,2020-12-31,8713,Value,2471660,-9050000,9026824,-23176
7338,2021-03-31,8713,Value,3223420,-9050000,9026824,-23176
7338,2021-06-30,8713,Value,2493820,-9050000,9026824,-23176
7365,2020-03-31,211,Value,0,-11479999,18833329,7353330
7365,2020-06-30,211,Value,0,-11479999,18833329,7353330
7365,2020-09-30,211,Value,0,-11479999,18833329,7353330
7365,2020-12-31,211,Value,0,-11479999,18833329,7353330
7365,2021-03-31,211,Value,0,-11479999,18833329,7353330
7365,2021-06-30,211,Value,0,-11479999,18833329,7353330
7365,2021-09-30,211,Value,0,-11479999,18833329,7353330
7365,2021-12-31,211,Value,0,-11479999,18833329,7353330
7366,2020-02-15,698,Capital Call,-20000,-8390000,10570000,2180000
7366,2020-02-15,698,Distribution,330000,-8390000,10900000,2510000
7366,2020-03-31,698,Value,850000,-8390000,10900000,2510000
7366,2020-06-30,698,Value,850000,-8390000,10900000,2510000
7366,2020-09-30,698,Value,850000,-8390000,10900000,2510000
7366,2020-12-31,698,Value,850000,-8390000,10900000,2510000
7366,2021-03-31,698,Value,850000,-8390000,10900000,2510000
7366,2021-06-30,698,Value,850000,-8390000,10900000,2510000
7366,2021-08-15,698,Capital Call,-150000,-8540000,10900000,2360000
7366,2021-08-15,698,Distribution,413000,-8540000,11313000,2773000
7366,2021-09-30,698,Value,847000,-8540000,11313000,2773000
7371,2020-03-31,8734,Value,0,-10000001,12480494,2480493
7371,2020-06-30,8734,Value,0,-10000001,12480494,2480493
7371,2020-09-30,8734,Value,0,-10000001,12480494,2480493
7371,2020-12-31,8734,Value,0,-10000001,12480494,2480493
7371,2021-03-31,8734,Value,0,-10000001,12480494,2480493
7371,2021-06-30,8734,Value,0,-10000001,12480494,2480493
7371,2021-09-30,8734,Value,0,-10000001,12480494,2480493
7371,2021-12-31,8734,Value,0,-10000001,12480494,2480493
7412,2020-01-15,6372,Distribution,85122,-9740000,11149914,1409914
7412,2020-02-29,6372,Value,3570340,-9740000,11149914,1409914
7412,2020-04-15,6372,Distribution,134403,-9740000,11284317,1544317
7412,2020-05-31,6372,Value,3435940,-9740000,11284317,1544317
7412,2020-07-16,6372,Distribution,111998,-9740000,11396315,1656315
7412,2020-08-31,6372,Value,3189020,-9740000,11396315,1656315
7412,2020-10-16,6372,Distribution,228480,-9740000,11624795,1884795
7412,2020-11-30,6372,Value,2960540,-9740000,11624795,1884795
7412,2021-01-14,6372,Distribution,452480,-9740000,12077275,2337275
7412,2021-02-28,6372,Value,2595140,-9740000,12077275,2337275
7412,2021-05-31,6372,Value,2595140,-9740000,12077275,2337275
7412,2021-07-16,6372,Distribution,463684,-9740000,12540959,2800959
7412,2021-08-31,6372,Value,3675620,-9740000,12540959,2800959
7412,2021-10-16,6372,Distribution,2821070,-9740000,15362029,5622029
7412,2021-11-30,6372,Value,854550,-9740000,15362029,5622029
7413,2020-03-31,434,Value,0,-8960528,10020557,1060029
7413,2020-06-30,434,Value,0,-8960528,10020557,1060029
7413,2020-09-30,434,Value,0,-8960528,10020557,1060029
7413,2020-12-31,434,Value,0,-8960528,10020557,1060029
7413,2021-03-31,434,Value,0,-8960528,10020557,1060029
7413,2021-06-30,434,Value,0,-8960528,10020557,1060029
7413,2021-09-30,434,Value,0,-8960528,10020557,1060029
7413,2021-12-31,434,Value,0,-8960528,10020557,1060029
7414,2020-03-31,22035,Value,30652570,-9900000,37381674,27481674
7414,2020-05-16,22035,Distribution,8375616,-9900000,45757290,35857290
7414,2020-06-30,22035,Value,18712370,-9900000,45757290,35857290
7414,2020-08-15,22035,Distribution,17706546,-9900000,63463836,53563836
7414,2020-09-30,22035,Value,7555280,-9900000,63463836,53563836
7414,2020-12-31,22035,Value,11089820,-9900000,63463836,53563836
7414,2021-03-31,22035,Value,29970100,-9900000,63463836,53563836
7414,2021-06-30,22035,Value,41043080,-9900000,63463836,53563836
7414,2021-09-30,22035,Value,62748110,-9900000,63463836,53563836
7415,2020-03-31,561,Value,4457150,-10000000,2649794,-7350206
7415,2020-09-30,561,Value,6634550,-10000000,2649794,-7350206
7415,2020-11-15,561,Distribution,5270760,-10000000,7920554,-2079446
7415,2020-12-31,561,Value,2538000,-10000000,7920554,-2079446
7415,2021-03-31,561,Value,2598670,-10000000,7920554,-2079446
7415,2021-06-30,561,Value,3089610,-10000000,7920554,-2079446
7420,2020-03-31,8787,Value,897290,-9828000,22925776,13097776
7420,2020-06-30,8787,Value,870760,-9828000,22925776,13097776
7420,2020-09-30,8787,Value,685990,-9828000,22925776,13097776
7420,2020-12-31,8787,Value,759700,-9828000,22925776,13097776
7420,2021-03-31,8787,Value,759700,-9828000,22925776,13097776
7420,2021-06-30,8787,Value,707610,-9828000,22925776,13097776
7420,2021-09-30,8787,Value,680090,-9828000,22925776,13097776
7449,2020-03-31,795,Value,0,-10000000,44000000,34000000
7449,2020-06-30,795,Value,0,-10000000,44000000,34000000
7449,2020-09-30,795,Value,0,-10000000,44000000,34000000
7449,2020-12-31,795,Value,0,-10000000,44000000,34000000
7449,2021-03-31,795,Value,0,-10000000,44000000,34000000
7449,2021-06-30,795,Value,0,-10000000,44000000,34000000
7449,2021-09-30,795,Value,0,-10000000,44000000,34000000
7449,2021-12-31,795,Value,0,-10000000,44000000,34000000
7462,2021-12-31,8836,Value,0,-9973982,1067621,-8906361
7464,2020-03-31,589,Value,1419990,-10866668,17886668,7020000
7464,2020-06-30,589,Value,1573330,-10866668,17886668,7020000
7464,2020-09-30,589,Value,1773330,-10866668,17886668,7020000
7464,2020-11-15,589,Distribution,273333,-10866668,18160001,7293333
7464,2020-12-31,589,Value,1793330,-10866668,18160001,7293333
7464,2021-03-31,589,Value,1919990,-10866668,18160001,7293333
7464,2021-06-30,589,Value,2346660,-10866668,18160001,7293333
7464,2021-08-15,589,Capital Call,667,-10866001,18160001,7294000
7464,2021-08-15,589,Distribution,-2667,-10866001,18157334,7291333
7464,2021-09-30,589,Value,3816000,-10866001,18157334,7291333
7464,2021-12-31,589,Value,0,-10866001,18157334,7291333
7465,2020-01-15,8837,Capital Call,0,-15820499,27013449,11192950
7465,2020-02-29,8837,Value,1299990,-15820499,27013449,11192950
7465,2020-04-15,8837,Capital Call,18288,-15802211,27013449,11211238
7465,2020-04-15,8837,Distribution,185868,-15802211,27199317,11397106
7465,2020-05-31,8837,Value,918600,-15802211,27199317,11397106
7465,2020-08-31,8837,Value,880220,-15802211,27199317,11397106
7465,2020-11-30,8837,Value,895540,-15802211,27199317,11397106
7465,2021-01-14,8837,Capital Call,12322,-15789889,27199317,11409428
7465,2021-01-14,8837,Distribution,582538,-15789889,27781855,11991966
7465,2021-02-28,8837,Value,465130,-15789889,27781855,11991966
7465,2021-05-31,8837,Value,456590,-15789889,27781855,11991966
7465,2021-08-31,8837,Value,436120,-15789889,27781855,11991966
7465,2021-10-16,8837,Capital Call,0,-15789889,27781855,11991966
7465,2021-11-30,8837,Value,423220,-15789889,27781855,11991966
7490,2020-02-15,1597,Distribution,445900,-9800000,10995601,1195601
7490,2020-03-31,1597,Value,5801600,-9800000,10995601,1195601
7490,2020-05-16,1597,Distribution,266560,-9800000,11262161,1462161
7490,2020-06-30,1597,Value,5748680,-9800000,11262161,1462161
7490,2020-08-15,1597,Distribution,887880,-9800000,12150041,2350041
7490,2020-09-30,1597,Value,5253780,-9800000,12150041,2350041
7490,2020-11-15,1597,Distribution,81340,-9800000,12231381,2431381
7490,2020-12-31,1597,Value,6121080,-9800000,12231381,2431381
7490,2021-03-31,1597,Value,6402340,-9800000,12231381,2431381
7490,2021-05-16,1597,Distribution,186200,-9800000,12417581,2617581
7490,2021-06-30,1597,Value,6512100,-9800000,12417581,2617581
7490,2021-08-15,1597,Distribution,355740,-9800000,12773321,2973321
7490,2021-09-30,1597,Value,7112840,-9800000,12773321,2973321
7493,2020-03-31,126,Value,11000,-7912001,10657500,2745499
7493,2020-06-30,126,Value,10500,-7912001,10657500,2745499
7493,2020-09-30,126,Value,10000,-7912001,10657500,2745499
7494,2021-12-31,280,Value,0,-9840001,11711417,1871416
7510,2020-03-31,537,Value,1064970,-9850000,12866230,3016230
7510,2020-05-16,537,Distribution,154047,-9850000,13020277,3170277
7510,2020-06-30,537,Value,1052580,-9850000,13020277,3170277
7510,2020-09-30,537,Value,1033840,-9850000,13020277,3170277
7510,2020-12-31,537,Value,1235160,-9850000,13020277,3170277
7510,2021-03-31,537,Value,1301750,-9850000,13020277,3170277
7511,2020-02-15,80,Distribution,68323,-10109889,15241657,5131768
7511,2020-03-31,80,Value,428670,-10109889,15241657,5131768
7511,2020-06-30,80,Value,428670,-10109889,15241657,5131768
7511,2020-09-30,80,Value,529760,-10109889,15241657,5131768
7511,2020-12-31,80,Value,529760,-10109889,15241657,5131768
7511,2021-03-31,80,Value,833060,-10109889,15241657,5131768
7511,2021-05-16,80,Distribution,758826,-10109889,16000483,5890594
7511,2021-06-30,80,Value,74230,-10109889,16000483,5890594
7512,2020-03-31,16819,Value,3966230,-11018379,8712762,-2305617
7512,2020-06-30,16819,Value,2781270,-11018379,8712762,-2305617
7512,2020-09-30,16819,Value,3231130,-11018379,8712762,-2305617
7512,2020-12-31,16819,Value,3391320,-11018379,8712762,-2305617
7512,2021-02-14,16819,Distribution,1207391,-11018379,9920153,-1098226
7512,2021-03-31,16819,Value,2170490,-11018379,9920153,-1098226
7521,2020-03-31,54,Value,17280,-10979768,18298521,7318753
7521,2020-06-30,54,Value,17280,-10979768,18298521,7318753
7521,2020-09-30,54,Value,17280,-10979768,18298521,7318753
7521,2020-12-31,54,Value,19770,-10979768,18298521,7318753
7521,2021-02-14,54,Distribution,6785,-10979768,18305306,7325538
7521,2021-03-31,54,Value,12850,-10979768,18305306,7325538
7539,2020-03-31,4,Value,202860,-10143000,24444629,14301629
7539,2020-06-30,4,Value,202860,-10143000,24444629,14301629
7539,2020-08-15,4,Capital Call,-80000,-10223000,24444629,14221629
7539,2020-08-15,4,Distribution,192800,-10223000,24637429,14414429
7539,2020-09-30,4,Value,204460,-10223000,24637429,14414429
7539,2020-12-31,4,Value,204460,-10223000,24637429,14414429
7539,2021-06-30,4,Value,204460,-10223000,24637429,14414429
7540,2020-02-15,280,Distribution,375074,-10269398,10370258,100860
7540,2020-03-31,280,Value,1071090,-10269398,10370258,100860
7540,2020-06-30,280,Value,1081350,-10269398,10370258,100860
7540,2020-08-15,280,Distribution,173212,-10269398,10543470,274072
7540,2020-09-30,280,Value,913000,-10269398,10543470,274072
7540,2020-12-31,280,Value,931250,-10269398,10543470,274072
7540,2021-02-14,280,Distribution,226377,-10269398,10769847,500449
7540,2021-03-31,280,Value,732960,-10269398,10769847,500449
7540,2021-06-30,280,Value,505670,-10269398,10769847,500449
7556,2020-06-30,6733,Value,0,-11490891,16463389,4972498
7556,2021-12-31,6733,Value,0,-11490891,16463389,4972498
7563,2020-03-31,8935,Value,0,-9752500,13523026,3770526
7563,2020-06-30,8935,Value,0,-9752500,13523026,3770526
7563,2020-09-30,8935,Value,0,-9752500,13523026,3770526
7563,2020-12-31,8935,Value,0,-9752500,13523026,3770526
7563,2021-03-31,8935,Value,0,-9752500,13523026,3770526
7563,2021-06-30,8935,Value,0,-9752500,13523026,3770526
7563,2021-09-30,8935,Value,0,-9752500,13523026,3770526
7563,2021-12-31,8935,Value,0,-9752500,13523026,3770526
7568,2020-03-31,140,Value,0,-11302245,10423669,-878576
7568,2020-09-30,140,Value,0,-11302245,10423669,-878576
7568,2020-12-31,140,Value,0,-11302245,10423669,-878576
7568,2021-03-31,140,Value,0,-11302245,10423669,-878576
7568,2021-06-30,140,Value,0,-11302245,10423669,-878576
7568,2021-09-30,140,Value,0,-11302245,10423669,-878576
7568,2021-12-31,140,Value,0,-11302245,10423669,-878576
7606,2021-12-31,346,Value,0,-9621131,17267702,7646571
7614,2020-03-31,5906,Value,37330,-9896003,20868666,10972663
7614,2020-06-30,5906,Value,38000,-9896003,20868666,10972663
7614,2020-09-30,5906,Value,38000,-9896003,20868666,10972663
7614,2020-12-31,5906,Value,51330,-9896003,20868666,10972663
7623,2020-02-15,8980,Distribution,-39310,-10000000,101460690,91460690
7623,2020-03-31,8980,Value,2412160,-10000000,101460690,91460690
7623,2020-05-16,8980,Distribution,-90,-10000000,101460600,91460600
7623,2020-06-30,8980,Value,2239100,-10000000,101460600,91460600
7623,2020-08-15,8980,Distribution,90,-10000000,101460690,91460690
7623,2020-09-30,8980,Value,2532300,-10000000,101460690,91460690
7623,2020-11-15,8980,Distribution,722016,-10000000,102182706,92182706
7623,2020-12-31,8980,Value,2029670,-10000000,102182706,92182706
7623,2021-02-14,8980,Distribution,294,-10000000,102183000,92183000
7623,2021-03-31,8980,Value,2140000,-10000000,102183000,92183000
7623,2021-05-16,8980,Distribution,-294,-10000000,102182706,92182706
7623,2021-06-30,8980,Value,2024090,-10000000,102182706,92182706
7623,2021-08-15,8980,Distribution,17294,-10000000,102200000,92200000
7623,2021-09-30,8980,Value,1600000,-10000000,102200000,92200000
7626,2020-03-31,184,Value,600660,-8594367,11448426,2854059
7626,2020-06-30,184,Value,525050,-8594367,11448426,2854059
7626,2020-08-15,184,Distribution,66759,-8594367,11515185,2920818
7626,2020-09-30,184,Value,407910,-8594367,11515185,2920818
7626,2020-12-31,184,Value,384720,-8594367,11515185,2920818
7626,2021-03-31,184,Value,357950,-8594367,11515185,2920818
7626,2021-05-16,184,Distribution,54660,-8594367,11569845,2975478
7626,2021-06-30,184,Value,338990,-8594367,11569845,2975478
7657,2020-02-15,9022,Distribution,481068,-10176154,9783254,-392900
7657,2020-03-31,9022,Value,4056310,-10176154,9783254,-392900
7657,2020-06-30,9022,Value,4056310,-10176154,9783254,-392900
7657,2020-08-15,9022,Distribution,460604,-10176154,10243858,67704
7657,2020-09-30,9022,Value,3595710,-10176154,10243858,67704
7657,2020-12-31,9022,Value,4511560,-10176154,10243858,67704
7657,2021-03-31,9022,Value,5223890,-10176154,10243858,67704
7657,2021-06-30,9022,Value,7055600,-10176154,10243858,67704
7662,2020-02-15,289,Distribution,18888,-10239600,6536605,-3702995
7662,2020-03-31,289,Value,11510,-10239600,6536605,-3702995
7662,2020-05-16,289,Distribution,3679,-10239600,6540284,-3699316
7662,2020-06-30,289,Value,10520,-10239600,6540284,-3699316
7662,2020-09-30,289,Value,10020,-10239600,6540284,-3699316
7662,2020-12-31,289,Value,115790,-10239600,6540284,-3699316
7662,2021-04-01,289,Distribution,112083,-10239600,6652367,-3587233
7662,2021-06-30,289,Value,12450,-10239600,6652367,-3587233
7662,2021-09-30,289,Value,12080,-10239600,6652367,-3587233
7666,2020-03-31,9036,Value,709990,-9550002,16699999,7149997
7666,2020-06-30,9036,Value,630000,-9550002,16699999,7149997
7666,2020-08-15,9036,Capital Call,-10000,-9560002,16699999,7139997
7666,2020-09-30,9036,Value,560000,-9560002,16699999,7139997
7666,2020-11-15,9036,Distribution,420000,-9560002,17119999,7559997
7666,2020-12-31,9036,Value,0,-9560002,17119999,7559997
7666,2021-03-31,9036,Value,0,-9560002,17119999,7559997
7666,2021-06-30,9036,Value,0,-9560002,17119999,7559997
7666,2021-09-30,9036,Value,0,-9560002,17119999,7559997
7762,2020-01-15,9112,Distribution,129696,-9949730,6789820,-3159910
7762,2020-02-29,9112,Value,1919450,-9949730,6789820,-3159910
7762,2020-05-31,9112,Value,2011630,-9949730,6789820,-3159910
7762,2020-07-16,9112,Distribution,77330,-9949730,6867150,-3082580
7762,2020-08-31,9112,Value,1228850,-9949730,6867150,-3082580
7762,2020-11-30,9112,Value,1181450,-9949730,6867150,-3082580
7762,2021-01-14,9112,Distribution,356008,-9949730,7223158,-2726572
7762,2021-02-28,9112,Value,2373630,-9949730,7223158,-2726572
7762,2021-04-15,9112,Distribution,648217,-9949730,7871375,-2078355
7762,2021-05-31,9112,Value,131340,-9949730,7871375,-2078355
7762,2021-08-31,9112,Value,104870,-9949730,7871375,-2078355
7762,2021-11-30,9112,Value,99000,-9949730,7871375,-2078355
7771,2020-03-31,8636,Value,7880,-10385574,4148354,-6237220
7771,2020-06-30,8636,Value,7400,-10385574,4148354,-6237220
7771,2020-09-30,8636,Value,6880,-10385574,4148354,-6237220
7771,2020-11-15,8636,Distribution,4102,-10385574,4152456,-6233118
7771,2020-12-31,8636,Value,0,-10385574,4152456,-6233118
7771,2021-03-31,8636,Value,0,-10385574,4152456,-6233118
7771,2021-12-31,8636,Value,0,-10385574,4152456,-6233118
7791,2020-03-31,6041,Value,888890,-9495608,2700095,-6795513
7791,2020-06-30,6041,Value,903140,-9495608,2700095,-6795513
7791,2020-09-30,6041,Distribution,240171,-9495608,2940266,-6555342
7791,2020-12-31,6041,Value,842460,-9495608,2940266,-6555342
7791,2021-03-31,6041,Value,644880,-9495608,2940266,-6555342
7791,2021-05-16,6041,Distribution,128433,-9495608,3068699,-6426909
7791,2021-06-30,6041,Value,644880,-9495608,3068699,-6426909
7811,2020-03-31,140,Value,102400,-11225823,17123930,5898107
7811,2020-06-30,140,Value,102280,-11225823,17123930,5898107
7811,2020-09-30,140,Value,102080,-11225823,17123930,5898107
7811,2020-12-31,140,Value,74400,-11225823,17123930,5898107
7811,2021-03-31,140,Value,74050,-11225823,17123930,5898107
7811,2021-06-30,140,Value,73740,-11225823,17123930,5898107
7831,2020-01-15,2154,Capital Call,0,-10036662,8630473,-1406189
7831,2020-01-15,2154,Distribution,0,-10036662,8630473,-1406189
7831,2020-02-29,2154,Value,4459480,-10036662,8630473,-1406189
7831,2020-04-15,2154,Capital Call,0,-10036662,8630473,-1406189
7831,2020-04-15,2154,Distribution,0,-10036662,8630473,-1406189
7831,2020-05-31,2154,Value,3480120,-10036662,8630473,-1406189
7831,2020-08-31,2154,Value,4168200,-10036662,8630473,-1406189
7831,2020-11-30,2154,Value,4710010,-10036662,8630473,-1406189
7831,2021-04-16,2154,Distribution,1124121,-10036662,9754594,-282068
7831,2021-08-31,2154,Value,4276060,-10036662,9754594,-282068
7831,2021-10-16,2154,Capital Call,0,-10036662,9754594,-282068
7831,2021-10-16,2154,Distribution,1459059,-10036662,11213653,1176991
7831,2021-11-30,2154,Value,2622340,-10036662,11213653,1176991
7855,2020-02-15,332,Capital Call,-11900,-9777137,10631524,854387
7855,2020-02-15,332,Distribution,130835,-9777137,10762359,985222
7855,2020-03-31,332,Value,591170,-9777137,10762359,985222
7855,2020-06-30,332,Value,591170,-9777137,10762359,985222
7855,2020-09-30,332,Value,462860,-9777137,10762359,985222
7855,2020-12-31,332,Value,478360,-9777137,10762359,985222
7855,2021-02-14,332,Capital Call,-6550,-9783687,10762359,978672
7855,2021-02-14,332,Distribution,106550,-9783687,10868909,1085222
7855,2021-03-31,332,Value,439500,-9783687,10868909,1085222
7855,2021-05-16,332,Capital Call,863051,-8920636,10868909,1948273
7855,2021-06-30,332,Value,577700,-8920636,10868909,1948273
7866,2020-06-30,9189,Value,47600,-9856680,13794949,3938269
7877,2020-02-29,47,Value,0,-8450000,9892170,1442170
7877,2020-08-31,47,Value,0,-8450000,9892170,1442170
7877,2020-11-30,47,Value,0,-8450000,9892170,1442170
7877,2021-02-28,47,Value,0,-8450000,9892170,1442170
7877,2021-08-31,47,Value,0,-8450000,9892170,1442170
7877,2021-12-31,47,Value,0,-8450000,9892170,1442170
7880,2020-03-31,12961,Value,1386720,-11597268,9481433,-2115835
7880,2020-05-16,12961,Distribution,71580,-11597268,9553013,-2044255
7880,2020-06-30,12961,Value,1288760,-11597268,9553013,-2044255
7880,2020-09-30,12961,Value,1273990,-11597268,9553013,-2044255
7880,2020-12-31,12961,Value,1267030,-11597268,9553013,-2044255
7880,2021-03-31,12961,Value,1095740,-11597268,9553013,-2044255
7880,2021-06-30,12961,Value,1081460,-11597268,9553013,-2044255
7882,2021-12-31,398,Value,0,-9701493,1343284,-8358209
7885,2020-03-31,8846,Value,0,-10053018,30965725,20912707
7885,2020-06-30,8846,Value,0,-10053018,30965725,20912707
7885,2020-09-30,8846,Value,0,-10053018,30965725,20912707
7885,2020-12-31,8846,Value,0,-10053018,30965725,20912707
7885,2021-03-31,8846,Value,0,-10053018,30965725,20912707
7885,2021-06-30,8846,Value,0,-10053018,30965725,20912707
7885,2021-09-30,8846,Value,0,-10053018,30965725,20912707
7885,2021-12-31,8846,Value,0,-10053018,30965725,20912707
7893,2020-03-31,80,Value,559580,-12337500,17344328,5006828
7893,2020-06-30,80,Value,205340,-12337500,17344328,5006828
7893,2020-09-30,80,Value,503540,-12337500,17344328,5006828
7893,2020-12-31,80,Value,644600,-12337500,17344328,5006828
7893,2021-03-31,80,Value,827980,-12337500,17344328,5006828
7945,2020-02-15,1360,Distribution,106627,-9029001,8701589,-327412
7945,2020-03-31,1360,Value,3920220,-9029001,8701589,-327412
7945,2020-06-30,1360,Value,3978540,-9029001,8701589,-327412
7945,2020-08-15,1360,Distribution,533133,-9029001,9234722,205721
7945,2020-09-30,1360,Value,3042460,-9029001,9234722,205721
7945,2020-11-15,1360,Distribution,60048,-9029001,9294770,265769
7945,2020-12-31,1360,Value,3722770,-9029001,9294770,265769
7945,2021-03-31,1360,Value,3844160,-9029001,9294770,265769
7945,2021-05-16,1360,Distribution,669503,-9029001,9964273,935272
7945,2021-06-30,1360,Value,3230500,-9029001,9964273,935272
7945,2021-08-15,1360,Distribution,174531,-9029001,10138804,1109803
7945,2021-09-30,1360,Value,3036350,-9029001,10138804,1109803
7945,2021-11-15,1360,Distribution,112239,-9029001,10251043,1222042
7945,2021-12-31,1360,Value,2692350,-9029001,10251043,1222042
7966,2020-02-15,17285,Distribution,642454,-10269836,12017093,1747257
7966,2020-03-31,17285,Value,343490,-10269836,12017093,1747257
7966,2020-06-30,17285,Value,375850,-10269836,12017093,1747257
7966,2020-08-15,17285,Distribution,333022,-10269836,12350115,2080279
7966,2020-09-30,17285,Value,47720,-10269836,12350115,2080279
7966,2020-11-15,17285,Distribution,16247,-10269836,12366362,2096526
7966,2020-12-31,17285,Value,23210,-10269836,12366362,2096526
7966,2021-02-14,17285,Capital Call,-9132,-10278968,12366362,2087394
7966,2021-02-14,17285,Distribution,23216,-10278968,12389578,2110610
7966,2021-03-31,17285,Value,9130,-10278968,12389578,2110610
7966,2021-06-30,17285,Value,9130,-10278968,12389578,2110610
7966,2021-12-31,17285,Value,0,-10278968,12389578,2110610
7982,2020-03-31,938,Value,2110000,-9170000,8610000,-560000
7982,2020-06-30,938,Value,1950000,-9170000,8610000,-560000
7982,2020-09-30,938,Value,1979990,-9170000,8610000,-560000
7982,2020-12-31,938,Value,1880000,-9170000,8610000,-560000
7982,2021-03-31,938,Value,1900000,-9170000,8610000,-560000
7982,2021-06-30,938,Value,1930000,-9170000,8610000,-560000
7982,2021-08-15,938,Capital Call,-3000,-9173000,8610000,-563000
7982,2021-08-15,938,Distribution,-4000,-9173000,8606000,-567000
7982,2021-09-30,938,Value,2152990,-9173000,8606000,-567000
8051,2020-02-15,9398,Distribution,740000,-9999999,6320000,-3679999
8051,2020-03-31,9398,Value,5840000,-9999999,6320000,-3679999
8051,2020-06-30,9398,Value,6280000,-9999999,6320000,-3679999
8051,2020-09-30,9398,Value,6380000,-9999999,6320000,-3679999
8051,2020-12-30,9398,Distribution,2600000,-9999999,8920000,-1079999
8051,2021-03-31,9398,Value,0,-9999999,8920000,-1079999
8051,2021-06-30,9398,Value,0,-9999999,8920000,-1079999
8051,2021-09-30,9398,Value,0,-9999999,8920000,-1079999
8053,2020-03-31,657,Value,263700,-12587407,35995576,23408169
8053,2020-06-30,657,Value,263700,-12587407,35995576,23408169
8053,2020-09-30,657,Value,263420,-12587407,35995576,23408169
8053,2020-12-31,657,Value,263420,-12587407,35995576,23408169
8053,2021-03-31,657,Value,388860,-12587407,35995576,23408169
8053,2021-05-16,657,Capital Call,-405063,-12992470,35995576,23003106
8053,2021-06-30,657,Value,388860,-12992470,35995576,23003106
8053,2021-09-30,657,Value,9230,-12992470,35995576,23003106
8054,2020-03-31,1383,Value,1760000,-8000000,18160000,10160000
8054,2020-07-01,1383,Distribution,160000,-8000000,18320000,10320000
8054,2020-09-30,1383,Value,1360000,-8000000,18320000,10320000
8054,2021-03-31,1383,Value,1360000,-8000000,18320000,10320000
8054,2021-06-30,1383,Value,1120000,-8000000,18320000,10320000
8054,2021-08-15,1383,Capital Call,-100000,-8100000,18320000,10220000
8054,2021-08-15,1383,Distribution,-95000,-8100000,18225000,10125000
8054,2021-09-30,1383,Value,1458000,-8100000,18225000,10125000
8054,2021-11-15,1383,Distribution,162000,-8100000,18387000,10287000
8054,2021-12-31,1383,Value,1458000,-8100000,18387000,10287000
8057,2020-03-31,553,Value,1706660,-9986669,7600000,-2386669
8057,2020-06-30,553,Value,2173330,-9986669,7600000,-2386669
8057,2020-08-15,553,Distribution,786667,-9986669,8386667,-1600002
8057,2020-09-30,553,Value,1546660,-9986669,8386667,-1600002
8057,2020-11-15,553,Distribution,346667,-9986669,8733334,-1253335
8057,2020-12-31,553,Value,1066660,-9986669,8733334,-1253335
8057,2021-03-31,553,Value,973330,-9986669,8733334,-1253335
8057,2021-05-16,553,Distribution,133333,-9986669,8866667,-1120002
8057,2021-06-30,553,Value,680000,-9986669,8866667,-1120002
8059,2020-03-31,211,Value,737950,-11350522,17669881,6319359
8059,2020-05-16,211,Distribution,155498,-11350522,17825379,6474857
8059,2020-06-30,211,Value,709590,-11350522,17825379,6474857
8059,2020-09-30,211,Value,709590,-11350522,17825379,6474857
8059,2020-12-31,211,Value,646690,-11350522,17825379,6474857
8059,2021-03-31,211,Value,646690,-11350522,17825379,6474857
8063,2020-02-15,558,Distribution,217698,-9465000,20356006,10891006
8063,2020-03-31,558,Value,1337690,-9465000,20356006,10891006
8063,2020-06-30,558,Value,1385850,-9465000,20356006,10891006
8063,2020-09-30,558,Value,1493590,-9465000,20356006,10891006
8063,2020-12-31,558,Value,1797490,-9465000,20356006,10891006
8063,2021-03-31,558,Value,1800040,-9465000,20356006,10891006
8063,2021-05-16,558,Distribution,1502921,-9465000,21858927,12393927
8063,2021-06-30,558,Value,375560,-9465000,21858927,12393927
8093,2020-03-31,9443,Value,0,-10000423,7742309,-2258114
8093,2020-06-30,9443,Value,0,-10000423,7742309,-2258114
8093,2020-09-30,9443,Value,0,-10000423,7742309,-2258114
8093,2020-12-31,9443,Value,0,-10000423,7742309,-2258114
8093,2021-03-31,9443,Value,0,-10000423,7742309,-2258114
8093,2021-06-30,9443,Value,0,-10000423,7742309,-2258114
8093,2021-09-30,9443,Value,0,-10000423,7742309,-2258114
8093,2021-12-31,9443,Value,0,-10000423,7742309,-2258114
8094,2020-09-30,9446,Value,0,-10001200,15331764,5330564
8094,2020-12-31,9446,Value,0,-10001200,15331764,5330564
8094,2021-03-31,9446,Value,0,-10001200,15331764,5330564
8094,2021-06-30,9446,Value,0,-10001200,15331764,5330564
8094,2021-09-30,9446,Value,0,-10001200,15331764,5330564
8094,2021-12-31,9446,Value,0,-10001200,15331764,5330564
8096,2020-03-31,910,Value,0,-10691441,16677915,5986474
8096,2020-06-30,910,Value,0,-10691441,16677915,5986474
8096,2020-09-30,910,Value,0,-10691441,16677915,5986474
8096,2020-12-31,910,Value,0,-10691441,16677915,5986474
8096,2021-03-31,910,Value,0,-10691441,16677915,5986474
8096,2021-06-30,910,Value,0,-10691441,16677915,5986474
8096,2021-09-30,910,Value,0,-10691441,16677915,5986474
8096,2021-12-31,910,Value,0,-10691441,16677915,5986474
8106,2020-03-31,9455,Value,3500690,-10000000,6580130,-3419870
8106,2020-06-30,9455,Value,3810930,-10000000,6580130,-3419870
8106,2020-09-30,9455,Value,3813520,-10000000,6580130,-3419870
8106,2020-12-31,9455,Value,4442020,-10000000,6580130,-3419870
8106,2021-02-14,9455,Distribution,1443368,-10000000,8023498,-1976502
8106,2021-03-31,9455,Value,2968810,-10000000,8023498,-1976502
8106,2021-06-30,9455,Value,2981430,-10000000,8023498,-1976502
8120,2020-02-15,14411,Distribution,0,-9427151,18088120,8660969
8120,2020-03-31,14411,Value,176150,-9427151,18088120,8660969
8120,2020-09-30,14411,Value,0,-9427151,18088120,8660969
8120,2021-03-31,14411,Value,0,-9427151,18088120,8660969
8120,2021-06-30,14411,Value,0,-9427151,18088120,8660969
8120,2021-09-30,14411,Value,0,-9427151,18088120,8660969
8120,2021-12-31,14411,Value,0,-9427151,18088120,8660969
8147,2020-02-15,1759,Capital Call,-51000,-10999999,20912588,9912589
8147,2020-02-15,1759,Distribution,121610,-10999999,21034198,10034199
8147,2020-03-31,1759,Value,994400,-10999999,21034198,10034199
8147,2020-06-30,1759,Value,7730,-10999999,21034198,10034199
8147,2020-09-30,1759,Value,773420,-10999999,21034198,10034199
8147,2020-11-15,1759,Distribution,708400,-10999999,21742598,10742599
8147,2020-12-31,1759,Value,110480,-10999999,21742598,10742599
8147,2021-02-14,1759,Distribution,4400,-10999999,21746998,10746999
8147,2021-03-31,1759,Value,110000,-10999999,21746998,10746999
8147,2021-05-16,1759,Distribution,143000,-10999999,21889998,10889999
8147,2021-06-30,1759,Value,0,-10999999,21889998,10889999
8147,2021-09-30,1759,Value,0,-10999999,21889998,10889999
8147,2021-12-31,1759,Value,0,-10999999,21889998,10889999
8148,2020-03-31,23839,Value,975830,-10462284,15522794,5060510
8148,2020-05-16,23839,Capital Call,-121474,-10583758,15522794,4939036
8148,2020-05-16,23839,Distribution,291474,-10583758,15814268,5230510
8148,2020-06-30,23839,Value,657490,-10583758,15814268,5230510
8148,2020-09-30,23839,Value,654000,-10583758,15814268,5230510
8148,2020-12-31,23839,Value,654000,-10583758,15814268,5230510
8148,2021-03-31,23839,Value,555970,-10583758,15814268,5230510
8148,2021-06-30,23839,Value,610480,-10583758,15814268,5230510
8165,2020-03-31,9515,Value,2932070,-11864201,13573274,1709073
8165,2020-07-01,9515,Distribution,44659,-11864201,13617933,1753732
8165,2020-09-30,9515,Value,2718740,-11864201,13617933,1753732
8165,2020-11-15,9515,Distribution,95682,-11864201,13713615,1849414
8165,2020-12-31,9515,Value,3128240,-11864201,13713615,1849414
8165,2021-02-14,9515,Distribution,213193,-11864201,13926808,2062607
8165,2021-03-31,9515,Value,2915050,-11864201,13926808,2062607
8166,2020-03-31,356,Value,36470,-9174353,16905884,7731531
8166,2020-06-30,356,Value,36880,-9174353,16905884,7731531
8166,2020-09-30,356,Value,36300,-9174353,16905884,7731531
8166,2020-12-31,356,Value,43120,-9174353,16905884,7731531
8166,2021-03-31,356,Value,43490,-9174353,16905884,7731531
8166,2021-06-30,356,Value,43040,-9174353,16905884,7731531
8167,2020-03-31,1390,Value,0,-11365984,4266335,-7099649
8167,2020-06-30,1390,Value,0,-11365984,4266335,-7099649
8167,2020-09-30,1390,Value,0,-11365984,4266335,-7099649
8167,2020-12-31,1390,Value,0,-11365984,4266335,-7099649
8167,2021-03-31,1390,Value,0,-11365984,4266335,-7099649
8167,2021-06-30,1390,Value,0,-11365984,4266335,-7099649
8167,2021-09-30,1390,Value,0,-11365984,4266335,-7099649
8167,2021-12-31,1390,Value,0,-11365984,4266335,-7099649
8171,2020-03-31,6479,Value,2331160,-10000000,13475989,3475989
8171,2020-06-30,6479,Value,2323410,-10000000,13475989,3475989
8171,2020-08-15,6479,Distribution,1041991,-10000000,14517980,4517980
8171,2020-09-30,6479,Value,1513770,-10000000,14517980,4517980
8171,2020-12-31,6479,Value,1517810,-10000000,14517980,4517980
8171,2021-03-31,6479,Value,1520580,-10000000,14517980,4517980
8171,2021-06-30,6479,Value,1510370,-10000000,14517980,4517980
8190,2020-03-31,562,Value,0,-10000000,2900796,-7099204
8190,2020-06-30,562,Value,0,-10000000,2900796,-7099204
8190,2020-09-30,562,Value,0,-10000000,2900796,-7099204
8190,2020-12-31,562,Value,0,-10000000,2900796,-7099204
8190,2021-03-31,562,Value,0,-10000000,2900796,-7099204
8190,2021-06-30,562,Value,0,-10000000,2900796,-7099204
8190,2021-09-30,562,Value,0,-10000000,2900796,-7099204
8190,2021-12-31,562,Value,0,-10000000,2900796,-7099204
8193,2020-03-31,296,Value,3474300,-9390000,13803300,4413300
8193,2020-05-16,296,Distribution,93900,-9390000,13897200,4507200
8193,2020-06-30,296,Value,3756000,-9390000,13897200,4507200
8193,2020-11-14,296,Capital Call,879,-9389121,13897200,4508079
8193,2020-11-14,296,Distribution,713679,-9389121,14610879,5221758
8193,2021-03-31,296,Value,4175730,-9389121,14610879,5221758
8193,2021-05-16,296,Capital Call,121,-9389000,14610879,5221879
8193,2021-05-16,296,Distribution,1062179,-9389000,15673058,6284058
8193,2021-06-30,296,Value,3397870,-9389000,15673058,6284058
8193,2021-08-15,296,Distribution,-911672,-9389000,14761386,5372386
8193,2021-09-30,296,Value,4410010,-9389000,14761386,5372386
8202,2020-09-30,1886,Value,0,-10000000,35474781,25474781
8202,2020-12-31,1886,Value,0,-10000000,35474781,25474781
8202,2021-03-31,1886,Value,0,-10000000,35474781,25474781
8202,2021-06-30,1886,Value,0,-10000000,35474781,25474781
8202,2021-09-30,1886,Value,0,-10000000,35474781,25474781
8202,2021-12-31,1886,Value,0,-10000000,35474781,25474781
8203,2020-03-31,1886,Value,0,-10000000,29889935,19889935
8203,2020-06-30,1886,Value,0,-10000000,29889935,19889935
8203,2020-09-30,1886,Value,0,-10000000,29889935,19889935
8203,2020-12-31,1886,Value,0,-10000000,29889935,19889935
8203,2021-03-31,1886,Value,0,-10000000,29889935,19889935
8203,2021-06-30,1886,Value,0,-10000000,29889935,19889935
8203,2021-09-30,1886,Value,0,-10000000,29889935,19889935
8203,2021-12-31,1886,Value,0,-10000000,29889935,19889935
8205,2020-09-30,1886,Value,0,-9842768,13811954,3969186
8205,2020-12-31,1886,Value,0,-9842768,13811954,3969186
8205,2021-03-31,1886,Value,0,-9842768,13811954,3969186
8205,2021-06-30,1886,Value,0,-9842768,13811954,3969186
8205,2021-09-30,1886,Value,0,-9842768,13811954,3969186
8205,2021-12-31,1886,Value,0,-9842768,13811954,3969186
8215,2021-12-31,14052,Value,0,-10100002,17275000,7174998
8217,2020-05-16,9559,Distribution,500000,-10000000,12600000,2600000
8217,2020-09-30,9559,Value,1233000,-10000000,12600000,2600000
8235,2020-03-31,268,Value,700000,-10000000,13660000,3660000
8235,2020-06-30,268,Value,620000,-10000000,13660000,3660000
8235,2020-09-30,268,Value,560000,-10000000,13660000,3660000
8235,2020-11-15,268,Distribution,380000,-10000000,14040000,4040000
8235,2020-12-31,268,Value,0,-10000000,14040000,4040000
8235,2021-03-31,268,Value,0,-10000000,14040000,4040000
8235,2021-06-30,268,Value,0,-10000000,14040000,4040000
8235,2021-09-30,268,Value,0,-10000000,14040000,4040000
8235,2021-12-31,268,Value,0,-10000000,14040000,4040000
8239,2020-03-31,9577,Value,4397370,-10488825,13672386,3183561
8239,2020-06-30,9577,Value,4396260,-10488825,13672386,3183561
8239,2020-09-30,9577,Value,4391930,-10488825,13672386,3183561
8239,2020-11-15,9577,Distribution,84542,-10488825,13756928,3268103
8239,2020-12-31,9577,Value,4545420,-10488825,13756928,3268103
8239,2021-03-31,9577,Value,4540140,-10488825,13756928,3268103
8239,2021-06-30,9577,Value,4539100,-10488825,13756928,3268103
8249,2020-01-15,6384,Capital Call,0,-9906396,10568566,662170
8249,2020-01-15,6384,Distribution,0,-9906396,10568566,662170
8249,2020-02-29,6384,Value,2338610,-9906396,10568566,662170
8249,2020-04-15,6384,Capital Call,0,-9906396,10568566,662170
8249,2020-04-15,6384,Distribution,132521,-9906396,10701087,794691
8249,2020-05-31,6384,Value,2113410,-9906396,10701087,794691
8249,2020-08-31,6384,Value,2512630,-9906396,10701087,794691
8249,2020-11-30,6384,Value,2507710,-9906396,10701087,794691
8249,2021-01-14,6384,Distribution,10722,-9906396,10711809,805413
8249,2021-02-28,6384,Value,2496980,-9906396,10711809,805413
8249,2021-04-15,6384,Distribution,2809361,-9906396,13521170,3614774
8249,2021-05-31,6384,Value,436420,-9906396,13521170,3614774
8249,2021-07-16,6384,Distribution,45985,-9906396,13567155,3660759
8249,2021-08-31,6384,Value,460130,-9906396,13567155,3660759
8249,2021-10-16,6384,Capital Call,0,-9906396,13567155,3660759
8249,2021-10-16,6384,Distribution,0,-9906396,13567155,3660759
8249,2021-11-30,6384,Value,459760,-9906396,13567155,3660759
8250,2020-02-15,50947,Capital Call,-5976,-11019606,13155385,2135779
8250,2020-02-15,50947,Distribution,45139,-11019606,13200524,2180918
8250,2020-03-31,50947,Value,1207370,-11019606,13200524,2180918
8250,2020-06-30,50947,Value,1162960,-11019606,13200524,2180918
8250,2020-08-15,50947,Capital Call,-6211,-11025817,13200524,2174707
8250,2020-08-15,50947,Distribution,203676,-11025817,13404200,2378383
8250,2020-09-30,50947,Value,971810,-11025817,13404200,2378383
8250,2020-11-15,50947,Distribution,21191,-11025817,13425391,2399574
8250,2020-12-31,50947,Value,970120,-11025817,13425391,2399574
8250,2021-02-14,50947,Distribution,68513,-11025817,13493904,2468087
8250,2021-03-31,50947,Value,947490,-11025817,13493904,2468087
8250,2021-06-30,50947,Value,1031460,-11025817,13493904,2468087
8250,2021-08-15,50947,Distribution,85962,-11025817,13579866,2554049
8250,2021-09-30,50947,Value,936420,-11025817,13579866,2554049
8265,2020-02-15,463,Capital Call,-1775,-9456765,13526333,4069568
8265,2020-02-15,463,Distribution,12905,-9456765,13539238,4082473
8265,2020-03-31,463,Value,0,-9456765,13539238,4082473
8265,2020-06-30,463,Value,0,-9456765,13539238,4082473
8265,2020-08-15,463,Capital Call,-543238,-10000003,13539238,3539235
8265,2020-08-15,463,Distribution,812763,-10000003,14352001,4351998
8265,2020-09-30,463,Value,0,-10000003,14352001,4351998
8265,2020-12-31,463,Value,0,-10000003,14352001,4351998
8265,2021-03-31,463,Value,0,-10000003,14352001,4351998
8265,2021-06-30,463,Value,0,-10000003,14352001,4351998
8265,2021-09-30,463,Value,0,-10000003,14352001,4351998
8265,2021-12-31,463,Value,0,-10000003,14352001,4351998
8267,2020-03-31,7627,Value,6810720,-10101931,1956114,-8145817
8267,2020-06-30,7627,Value,6911460,-10101931,1956114,-8145817
8267,2020-12-31,7627,Value,7034610,-10101931,1956114,-8145817
8267,2021-03-31,7627,Value,5954890,-10101931,1956114,-8145817
8267,2021-06-30,7627,Value,5954890,-10101931,1956114,-8145817
8279,2020-03-31,412,Value,5441740,-10238484,16263849,6025365
8279,2020-09-30,412,Value,5646500,-10238484,16263849,6025365
8279,2020-12-31,412,Value,7489430,-10238484,16263849,6025365
8279,2021-03-31,412,Value,10253820,-10238484,16263849,6025365
8279,2021-05-16,412,Distribution,1253196,-10238484,17517045,7278561
8279,2021-06-30,412,Value,9614940,-10238484,17517045,7278561
8295,2020-03-31,2003,Value,2309000,-11231102,11212123,-18979
8295,2020-06-30,2003,Value,2291830,-11231102,11212123,-18979
8295,2020-09-30,2003,Value,2289450,-11231102,11212123,-18979
8295,2020-12-31,2003,Value,2278500,-11231102,11212123,-18979
8295,2021-03-31,2003,Value,2274870,-11231102,11212123,-18979
8295,2021-05-16,2003,Capital Call,-104660,-11335762,11212123,-123639
8295,2021-05-16,2003,Distribution,104660,-11335762,11316783,-18979
8295,2021-06-30,2003,Value,2272670,-11335762,11316783,-18979
8295,2021-12-31,2003,Value,0,-11335762,11316783,-18979
8321,2020-02-15,18,Capital Call,-283,-9460000,12265815,2805815
8321,2020-02-15,18,Distribution,355349,-9460000,12621164,3161164
8321,2020-03-31,18,Value,2191450,-9460000,12621164,3161164
8321,2020-06-30,18,Value,2502380,-9460000,12621164,3161164
8321,2020-09-30,18,Value,2708500,-9460000,12621164,3161164
8321,2020-11-15,18,Distribution,463074,-9460000,13084238,3624238
8321,2020-12-31,18,Value,2736150,-9460000,13084238,3624238
8321,2021-02-14,18,Distribution,336558,-9460000,13420796,3960796
8321,2021-03-31,18,Value,2595330,-9460000,13420796,3960796
8321,2021-05-16,18,Capital Call,50,-9459950,13420796,3960846
8321,2021-05-16,18,Distribution,461772,-9459950,13882568,4422618
8321,2021-06-30,18,Value,2353090,-9459950,13882568,4422618
8321,2021-08-15,18,Capital Call,-50,-9460000,13882568,4422568
8321,2021-09-30,18,Value,2277060,-9460000,13882568,4422568
8335,2020-03-31,103,Value,433010,-9847238,20946013,11098775
8335,2020-06-30,103,Value,426280,-9847238,20946013,11098775
8335,2020-09-30,103,Value,479380,-9847238,20946013,11098775
8335,2020-11-15,103,Capital Call,-146,-9847384,20946013,11098629
8335,2020-11-15,103,Distribution,146,-9847384,20946159,11098775
8335,2020-12-31,103,Value,475960,-9847384,20946159,11098775
8335,2021-03-31,103,Value,470790,-9847384,20946159,11098775
8335,2021-05-16,103,Capital Call,-24,-9847408,20946159,11098751
8335,2021-05-16,103,Distribution,22994,-9847408,20969153,11121745
8335,2021-06-30,103,Value,535370,-9847408,20969153,11121745
8342,2020-03-31,1973,Value,0,-10920001,14414400,3494399
8342,2020-06-30,1973,Value,0,-10920001,14414400,3494399
8342,2020-09-30,1973,Value,0,-10920001,14414400,3494399
8342,2020-12-31,1973,Value,0,-10920001,14414400,3494399
8342,2021-03-31,1973,Value,0,-10920001,14414400,3494399
8342,2021-06-30,1973,Value,0,-10920001,14414400,3494399
8342,2021-09-30,1973,Value,0,-10920001,14414400,3494399
8342,2021-12-31,1973,Value,0,-10920001,14414400,3494399
8344,2020-03-31,21,Value,3217070,-9694313,2987282,-6707031
8344,2020-06-30,21,Value,3217070,-9694313,2987282,-6707031
8344,2020-09-30,21,Value,3023190,-9694313,2987282,-6707031
8344,2020-12-31,21,Value,2441530,-9694313,2987282,-6707031
8344,2021-02-14,21,Distribution,324961,-9694313,3312243,-6382070
8344,2021-03-31,21,Value,2019620,-9694313,3312243,-6382070
8344,2021-06-30,21,Value,2019620,-9694313,3312243,-6382070
8361,2020-03-31,332,Value,1184990,-9690000,13275000,3585000
8361,2020-06-30,332,Value,1184990,-9690000,13275000,3585000
8361,2020-09-30,332,Value,1184990,-9690000,13275000,3585000
8361,2020-12-31,332,Value,1304990,-9690000,13275000,3585000
8361,2021-02-14,332,Distribution,135000,-9690000,13410000,3720000
8361,2021-03-31,332,Value,1284990,-9690000,13410000,3720000
8361,2021-06-30,332,Value,1284990,-9690000,13410000,3720000
8361,2021-08-15,332,Capital Call,-1500,-9691500,13410000,3718500
8361,2021-08-15,332,Distribution,2000,-9691500,13412000,3720500
8361,2021-09-30,332,Value,1293500,-9691500,13412000,3720500
8363,2020-03-31,2152,Value,1033900,-9625000,21529608,11904608
8363,2020-06-30,2152,Value,925630,-9625000,21529608,11904608
8363,2020-09-30,2152,Value,963050,-9625000,21529608,11904608
8363,2020-11-15,2152,Distribution,0,-9625000,21529608,11904608
8363,2020-12-31,2152,Value,775130,-9625000,21529608,11904608
8363,2021-02-14,2152,Distribution,0,-9625000,21529608,11904608
8363,2021-03-31,2152,Value,880210,-9625000,21529608,11904608
8363,2021-05-16,2152,Distribution,149333,-9625000,21678941,12053941
8363,2021-06-30,2152,Value,715770,-9625000,21678941,12053941
8363,2021-09-30,2152,Value,668430,-9625000,21678941,12053941
8366,2020-02-15,264,Distribution,44679,-9699998,15295712,5595714
8366,2020-03-31,264,Value,286050,-9699998,15295712,5595714
8366,2020-05-16,264,Capital Call,-40000,-9739998,15295712,5555714
8366,2020-05-16,264,Distribution,93490,-9739998,15389202,5649204
8366,2020-06-30,264,Value,292200,-9739998,15389202,5649204
8366,2020-08-15,264,Distribution,194800,-9739998,15584002,5844004
8366,2020-09-30,264,Value,0,-9739998,15584002,5844004
8366,2020-12-31,264,Value,0,-9739998,15584002,5844004
8366,2021-03-31,264,Value,0,-9739998,15584002,5844004
8366,2021-06-30,264,Value,0,-9739998,15584002,5844004
8366,2021-09-30,264,Value,0,-9739998,15584002,5844004
8366,2021-12-31,264,Value,0,-9739998,15584002,5844004
8398,2020-03-31,8235,Value,611550,-10284015,13228271,2944256
8398,2020-05-16,8235,Capital Call,-33994,-10318009,13228271,2910262
8398,2020-05-16,8235,Distribution,444311,-10318009,13672582,3354573
8398,2020-06-30,8235,Value,817210,-10318009,13672582,3354573
8398,2020-08-15,8235,Capital Call,-19643,-10337652,13672582,3334930
8398,2020-08-15,8235,Distribution,416191,-10337652,14088773,3751121
8398,2020-09-30,8235,Value,464310,-10337652,14088773,3751121
8398,2020-12-31,8235,Value,638090,-10337652,14088773,3751121
8398,2021-03-31,8235,Value,462810,-10337652,14088773,3751121
8398,2021-06-30,8235,Value,539240,-10337652,14088773,3751121
8423,2020-03-31,902,Value,3456530,-10185980,22212138,12026158
8423,2020-06-30,902,Value,4576980,-10185980,22212138,12026158
8423,2020-08-15,902,Distribution,999986,-10185980,23212124,13026144
8423,2020-09-30,902,Value,3271420,-10185980,23212124,13026144
8423,2020-11-15,902,Distribution,399994,-10185980,23612118,13426138
8423,2020-12-31,902,Value,3177000,-10185980,23612118,13426138
8423,2021-03-31,902,Value,3380720,-10185980,23612118,13426138
8423,2021-06-30,902,Value,4093740,-10185980,23612118,13426138
8448,2020-03-31,138,Value,6767120,-10273501,12444329,2170828
8448,2020-06-30,138,Value,6561650,-10273501,12444329,2170828
8448,2020-08-15,138,Distribution,353393,-10273501,12797722,2524221
8448,2020-09-30,138,Value,6105520,-10273501,12797722,2524221
8448,2020-12-31,138,Value,6824660,-10273501,12797722,2524221
8448,2021-03-31,138,Value,7543810,-10273501,12797722,2524221
8448,2021-05-16,138,Distribution,469014,-10273501,13266736,2993235
8448,2021-06-30,138,Value,8821290,-10273501,13266736,2993235
8460,2020-02-15,6629,Capital Call,-1625,-9758337,5583132,-4175205
8460,2020-02-15,6629,Distribution,39218,-9758337,5622350,-4135987
8460,2020-03-31,6629,Value,396730,-9758337,5622350,-4135987
8460,2020-06-30,6629,Value,449230,-9758337,5622350,-4135987
8460,2020-08-15,6629,Capital Call,-4409,-9762746,5622350,-4140396
8460,2020-09-30,6629,Value,512780,-9762746,5622350,-4140396
8460,2020-11-15,6629,Capital Call,-11408,-9774154,5622350,-4151804
8460,2020-11-15,6629,Distribution,484879,-9774154,6107229,-3666925
8460,2020-12-31,6629,Value,15000,-9774154,6107229,-3666925
8460,2021-03-31,6629,Value,12490,-9774154,6107229,-3666925
8460,2021-06-30,6629,Value,11990,-9774154,6107229,-3666925
8460,2021-09-30,6629,Value,11530,-9774154,6107229,-3666925
8490,2020-03-31,454,Value,3340880,-9903164,19524130,9620966
8490,2020-06-30,454,Value,3567640,-9903164,19524130,9620966
8490,2020-09-30,454,Value,4161470,-9903164,19524130,9620966
8490,2020-11-15,454,Capital Call,-1740,-9904904,19524130,9619226
8490,2020-11-15,454,Distribution,158545,-9904904,19682675,9777771
8490,2020-12-31,454,Value,4301770,-9904904,19682675,9777771
8490,2021-02-14,454,Capital Call,-302,-9905206,19682675,9777469
8490,2021-02-14,454,Distribution,258248,-9905206,19940923,10035717
8490,2021-03-31,454,Value,4176250,-9905206,19940923,10035717
8490,2021-05-16,454,Capital Call,-34859,-9940065,19940923,10000858
8490,2021-05-16,454,Distribution,3647157,-9940065,23588080,13648015
8490,2021-06-30,454,Value,500410,-9940065,23588080,13648015
8490,2021-09-30,454,Value,419820,-9940065,23588080,13648015
8494,2020-03-31,2147,Value,373330,-8879166,16085838,7206672
8494,2020-06-30,2147,Value,350000,-8879166,16085838,7206672
8494,2020-09-30,2147,Value,334160,-8879166,16085838,7206672
8494,2020-12-31,2147,Value,295830,-8879166,16085838,7206672
8494,2021-03-31,2147,Value,320000,-8879166,16085838,7206672
8494,2021-06-30,2147,Value,52500,-8879166,16085838,7206672
8528,2020-03-31,920,Value,2034990,-9771336,5814678,-3956658
8528,2020-06-30,920,Value,2297560,-9771336,5814678,-3956658
8528,2020-09-30,920,Value,2054360,-9771336,5814678,-3956658
8528,2020-12-31,920,Value,2384030,-9771336,5814678,-3956658
8528,2021-03-31,920,Value,2688770,-9771336,5814678,-3956658
8528,2021-06-30,920,Value,2613780,-9771336,5814678,-3956658
8528,2021-12-31,920,Value,0,-9771336,5814678,-3956658
8553,2020-03-31,4568,Value,0,-8801208,6056827,-2744381
8553,2020-06-30,4568,Value,0,-8801208,6056827,-2744381
8553,2020-09-30,4568,Value,0,-8801208,6056827,-2744381
8553,2020-12-31,4568,Value,0,-8801208,6056827,-2744381
8553,2021-03-31,4568,Value,0,-8801208,6056827,-2744381
8553,2021-06-30,4568,Value,0,-8801208,6056827,-2744381
8553,2021-09-30,4568,Value,0,-8801208,6056827,-2744381
8553,2021-12-31,4568,Value,0,-8801208,6056827,-2744381
8570,2020-03-31,361,Value,383160,-9716820,17636944,7920124
8570,2020-06-30,361,Value,453070,-9716820,17636944,7920124
8570,2020-08-15,361,Distribution,319607,-9716820,17956551,8239731
8570,2020-09-30,361,Value,175290,-9716820,17956551,8239731
8570,2020-12-31,361,Value,179240,-9716820,17956551,8239731
8570,2021-03-31,361,Value,181830,-9716820,17956551,8239731
8570,2021-06-30,361,Value,183150,-9716820,17956551,8239731
8570,2021-09-30,361,Value,183770,-9716820,17956551,8239731
8675,2020-03-31,140,Value,1228550,-13309470,20094175,6784705
8675,2020-05-16,140,Capital Call,-54583,-13364053,20094175,6730122
8675,2020-05-16,140,Distribution,247602,-13364053,20341777,6977724
8675,2020-06-30,140,Value,1025680,-13364053,20341777,6977724
8675,2020-08-15,140,Capital Call,20143,-13343910,20341777,6997867
8675,2020-08-15,140,Distribution,29021,-13343910,20370798,7026888
8675,2020-09-30,140,Value,985320,-13343910,20370798,7026888
8675,2020-11-15,140,Distribution,37809,-13343910,20408607,7064697
8675,2020-12-31,140,Value,988880,-13343910,20408607,7064697
8675,2021-02-14,140,Distribution,12826,-13343910,20421433,7077523
8675,2021-03-31,140,Value,1196950,-13343910,20421433,7077523
8675,2021-06-30,140,Value,1343390,-13343910,20421433,7077523
8679,2020-03-31,140,Value,0,-11018173,15062410,4044237
8679,2020-05-16,140,Distribution,0,-11018173,15062410,4044237
8679,2020-06-30,140,Value,0,-11018173,15062410,4044237
8679,2020-12-31,140,Value,0,-11018173,15062410,4044237
8700,2020-03-31,2225,Distribution,1871805,-8100001,18507092,10407091
8700,2020-06-30,2225,Value,5765660,-8100001,18507092,10407091
8700,2020-09-30,2225,Value,9154020,-8100001,18507092,10407091
8700,2020-12-31,2225,Value,10151230,-8100001,18507092,10407091
8700,2021-02-14,2225,Distribution,2566976,-8100001,21074068,12974067
8700,2021-03-31,2225,Value,14177680,-8100001,21074068,12974067
8710,2020-02-15,231,Distribution,12000,-10000000,11636000,1636000
8710,2020-03-31,231,Value,951000,-10000000,11636000,1636000
8710,2020-06-30,231,Value,1058000,-10000000,11636000,1636000
8710,2020-08-15,231,Distribution,17000,-10000000,11653000,1653000
8710,2020-09-30,231,Value,546000,-10000000,11653000,1653000
8710,2020-12-31,231,Value,1150000,-10000000,11653000,1653000
8710,2021-02-14,231,Distribution,13000,-10000000,11666000,1666000
8710,2021-03-31,231,Value,1179000,-10000000,11666000,1666000
8710,2021-05-16,231,Distribution,20000,-10000000,11686000,1686000
8710,2021-06-30,231,Value,1159000,-10000000,11686000,1686000
8710,2021-08-15,231,Distribution,24000,-10000000,11710000,1710000
8710,2021-09-30,231,Value,620000,-10000000,11710000,1710000
8710,2021-11-15,231,Distribution,114000,-10000000,11824000,1824000
8710,2021-12-31,231,Value,657000,-10000000,11824000,1824000
8723,2020-03-31,770,Value,1664800,-10000000,5081965,-4918035
8723,2020-06-30,770,Value,1627930,-10000000,5081965,-4918035
8723,2020-09-30,770,Value,1759860,-10000000,5081965,-4918035
8723,2020-11-15,770,Distribution,1628027,-10000000,6709992,-3290008
8723,2020-12-31,770,Value,132060,-10000000,6709992,-3290008
8723,2021-03-31,770,Value,131070,-10000000,6709992,-3290008
8723,2021-06-30,770,Value,134040,-10000000,6709992,-3290008
8734,2020-03-31,504,Value,0,-9328584,12441683,3113099
8734,2020-06-30,504,Value,0,-9328584,12441683,3113099
8734,2020-09-30,504,Value,0,-9328584,12441683,3113099
8734,2020-12-31,504,Value,0,-9328584,12441683,3113099
8734,2021-03-31,504,Value,0,-9328584,12441683,3113099
8734,2021-06-30,504,Value,0,-9328584,12441683,3113099
8734,2021-09-30,504,Value,0,-9328584,12441683,3113099
8734,2021-12-31,504,Value,0,-9328584,12441683,3113099
8735,2020-03-31,351,Value,904810,-9390139,13274294,3884155
8735,2020-06-30,351,Value,904810,-9390139,13274294,3884155
8735,2020-09-30,351,Value,998710,-9390139,13274294,3884155
8735,2020-12-31,351,Value,998710,-9390139,13274294,3884155
8735,2021-02-14,351,Capital Call,-2014,-9392153,13274294,3882141
8735,2021-02-14,351,Distribution,96939,-9392153,13371233,3979080
8735,2021-03-31,351,Value,810910,-9392153,13371233,3979080
8735,2021-06-30,351,Value,1092680,-9392153,13371233,3979080
8743,2020-03-31,212,Value,113330,-9700000,14446666,4746666
8743,2020-06-30,212,Value,113330,-9700000,14446666,4746666
8743,2020-09-30,212,Value,113330,-9700000,14446666,4746666
8743,2020-12-31,212,Value,113330,-9700000,14446666,4746666
8743,2021-03-31,212,Value,113330,-9700000,14446666,4746666
8743,2021-06-30,212,Value,113330,-9700000,14446666,4746666
8743,2021-08-15,212,Capital Call,1333,-9698667,14446666,4747999
8743,2021-08-15,212,Distribution,-333,-9698667,14446333,4747666
8743,2021-09-30,212,Value,113990,-9698667,14446333,4747666
8796,2020-02-15,49,Capital Call,-4000,-11466000,16298000,4832000
8796,2020-02-15,49,Distribution,4000,-11466000,16302000,4836000
8796,2020-03-31,49,Value,47990,-11466000,16302000,4836000
8796,2020-05-16,49,Capital Call,-8000,-11474000,16302000,4828000
8796,2020-05-16,49,Distribution,8000,-11474000,16310000,4836000
8796,2020-06-30,49,Value,47990,-11474000,16310000,4836000
8796,2020-09-30,49,Value,47990,-11474000,16310000,4836000
8796,2020-12-31,49,Value,47990,-11474000,16310000,4836000
8796,2021-03-31,49,Value,47990,-11474000,16310000,4836000
8796,2021-06-30,49,Value,47990,-11474000,16310000,4836000
8796,2021-08-15,49,Distribution,800,-11474000,16310800,4836800
8796,2021-09-30,49,Value,48400,-11474000,16310800,4836800
8797,2020-03-31,5197,Value,0,-6086979,3236736,-2850243
8797,2020-06-30,5197,Value,0,-6086979,3236736,-2850243
8797,2020-09-30,5197,Value,0,-6086979,3236736,-2850243
8797,2020-12-31,5197,Value,0,-6086979,3236736,-2850243
8797,2021-03-31,5197,Value,0,-6086979,3236736,-2850243
8797,2021-06-30,5197,Value,0,-6086979,3236736,-2850243
8797,2021-09-30,5197,Value,0,-6086979,3236736,-2850243
8797,2021-12-31,5197,Value,0,-6086979,3236736,-2850243
8799,2020-01-15,233,Capital Call,0,-12802878,15179335,2376457
8799,2020-01-15,233,Distribution,0,-12802878,15179335,2376457
8799,2020-02-29,233,Value,263970,-12802878,15179335,2376457
8799,2020-04-15,233,Capital Call,0,-12802878,15179335,2376457
8799,2020-04-15,233,Distribution,0,-12802878,15179335,2376457
8799,2020-05-31,233,Value,265010,-12802878,15179335,2376457
8799,2020-08-31,233,Value,282720,-12802878,15179335,2376457
8799,2020-10-16,233,Capital Call,-9710,-12812588,15179335,2366747
8799,2020-10-16,233,Distribution,284940,-12812588,15464275,2651687
8799,2020-11-30,233,Value,4970,-12812588,15464275,2651687
8799,2021-02-28,233,Value,0,-12812588,15464275,2651687
8799,2021-08-31,233,Value,0,-12812588,15464275,2651687
8801,2020-03-31,838,Value,1321800,-9935181,8938273,-996908
8801,2020-05-16,838,Distribution,359503,-9935181,9297776,-637405
8801,2020-06-30,838,Value,1227500,-9935181,9297776,-637405
8801,2020-08-15,838,Capital Call,-25000,-9960181,9297776,-662405
8801,2020-08-15,838,Distribution,1046604,-9960181,10344380,384199
8801,2020-09-30,838,Value,1194140,-9960181,10344380,384199
8801,2020-12-31,838,Value,1633140,-9960181,10344380,384199
8801,2021-02-14,838,Capital Call,-25000,-9985181,10344380,359199
8801,2021-03-31,838,Value,1662640,-9985181,10344380,359199
8801,2021-06-30,838,Value,1729910,-9985181,10344380,359199
8804,2020-03-31,18,Value,2152280,-9580159,11417847,1837688
8804,2020-05-16,18,Capital Call,-1844,-9582003,11417847,1835844
8804,2020-05-16,18,Distribution,292828,-9582003,11710675,2128672
8804,2020-06-30,18,Value,2019490,-9582003,11710675,2128672
8804,2020-08-15,18,Capital Call,-6898,-9588901,11710675,2121774
8804,2020-09-30,18,Value,2169720,-9588901,11710675,2121774
8804,2020-11-15,18,Distribution,259978,-9588901,11970653,2381752
8804,2020-12-31,18,Value,2143090,-9588901,11970653,2381752
8804,2021-03-31,18,Value,2226920,-9588901,11970653,2381752
8804,2021-05-16,18,Capital Call,-4195,-9593096,11970653,2377557
8804,2021-05-16,18,Distribution,400315,-9593096,12370968,2777872
8804,2021-06-30,18,Value,1932180,-9593096,12370968,2777872
8807,2020-03-31,613,Value,2210000,-11633333,12506667,873334
8807,2020-06-30,613,Value,2389990,-11633333,12506667,873334
8807,2020-08-15,613,Capital Call,20000,-11613333,12506667,893334
8807,2020-08-15,613,Distribution,166667,-11613333,12673334,1060001
8807,2020-09-30,613,Value,3133330,-11613333,12673334,1060001
8807,2020-11-15,613,Capital Call,-3333,-11616666,12673334,1056668
8807,2020-11-15,613,Distribution,46667,-11616666,12720001,1103335
8807,2020-12-31,613,Value,3293330,-11616666,12720001,1103335
8807,2021-02-14,613,Distribution,2563333,-11616666,15283334,3666668
8807,2021-03-31,613,Value,2093330,-11616666,15283334,3666668
8807,2021-05-16,613,Distribution,-470000,-11616666,14813334,3196668
8807,2021-06-30,613,Value,0,-11616666,14813334,3196668
8807,2021-09-30,613,Value,0,-11616666,14813334,3196668
8813,2020-01-15,681,Distribution,0,-10000000,15519133,5519133
8813,2020-02-29,681,Value,3229120,-10000000,15519133,5519133
8813,2020-04-15,681,Distribution,0,-10000000,15519133,5519133
8813,2020-05-31,681,Value,1204920,-10000000,15519133,5519133
8813,2020-07-16,681,Distribution,1270985,-10000000,16790118,6790118
8813,2020-08-31,681,Value,438950,-10000000,16790118,6790118
8813,2020-10-16,681,Distribution,385944,-10000000,17176062,7176062
8813,2020-11-30,681,Value,84940,-10000000,17176062,7176062
8813,2021-01-14,681,Distribution,82996,-10000000,17259058,7259058
8813,2021-02-28,681,Value,1940,-10000000,17259058,7259058
8813,2021-08-31,681,Value,0,-10000000,17259058,7259058
8813,2021-10-16,681,Distribution,0,-10000000,17259058,7259058
8813,2021-12-31,681,Value,0,-10000000,17259058,7259058
8814,2020-03-31,10352,Value,624000,-9842002,1906000,-7936002
8814,2020-06-30,10352,Value,384000,-9842002,1906000,-7936002
8814,2020-09-30,10352,Value,376000,-9842002,1906000,-7936002
8814,2020-12-31,10352,Value,374000,-9842002,1906000,-7936002
8814,2021-03-31,10352,Value,372000,-9842002,1906000,-7936002
8814,2021-05-16,10352,Distribution,234000,-9842002,2140000,-7702002
8814,2021-06-30,10352,Value,128000,-9842002,2140000,-7702002
8814,2021-09-30,10352,Value,128000,-9842002,2140000,-7702002
8821,2020-03-31,17590,Value,1883400,-9242850,6835090,-2407760
8821,2020-05-16,17590,Distribution,-103724,-9242850,6731366,-2511484
8821,2020-06-30,17590,Value,1830190,-9242850,6731366,-2511484
8821,2020-08-15,17590,Distribution,-159759,-9242850,6571607,-2671243
8821,2020-09-30,17590,Value,1586110,-9242850,6571607,-2671243
8835,2020-02-15,355,Distribution,167894,-9800000,13851946,4051946
8835,2020-03-31,355,Value,4871450,-9800000,13851946,4051946
8835,2020-05-16,355,Distribution,479632,-9800000,14331578,4531578
8835,2020-06-30,355,Value,4022610,-9800000,14331578,4531578
8856,2020-03-31,2238,Value,301550,-9750498,27783425,18032927
8856,2020-06-30,2238,Value,298060,-9750498,27783425,18032927
8856,2020-09-30,2238,Value,295520,-9750498,27783425,18032927
8856,2020-12-31,2238,Value,295520,-9750498,27783425,18032927
8856,2021-03-31,2238,Value,295090,-9750498,27783425,18032927
8856,2021-06-30,2238,Value,295030,-9750498,27783425,18032927
8857,2020-03-31,5020,Distribution,161611,-9300001,12001278,2701277
8857,2020-06-30,5020,Value,1794130,-9300001,12001278,2701277
8857,2020-08-15,5020,Distribution,108533,-9300001,12109811,2809810
8857,2020-09-30,5020,Value,1746510,-9300001,12109811,2809810
8857,2020-12-31,5020,Value,1766510,-9300001,12109811,2809810
8857,2021-02-14,5020,Distribution,133581,-9300001,12243392,2943391
8857,2021-03-31,5020,Value,1933200,-9300001,12243392,2943391
8857,2021-05-16,5020,Distribution,212670,-9300001,12456062,3156061
8857,2021-06-30,5020,Value,1916020,-9300001,12456062,3156061
8880,2020-03-31,423991,Value,2440000,-8760000,7280000,-1480000
8880,2020-06-30,423991,Value,2440000,-8760000,7280000,-1480000
8880,2020-09-30,423991,Value,2440000,-8760000,7280000,-1480000
8880,2020-11-15,423991,Capital Call,-20000,-8780000,7280000,-1500000
8880,2020-12-31,423991,Value,2440000,-8780000,7280000,-1500000
8880,2021-03-31,423991,Value,2440000,-8780000,7280000,-1500000
8880,2021-06-30,423991,Value,2440000,-8780000,7280000,-1500000
8880,2021-08-15,423991,Capital Call,2000,-8778000,7280000,-1498000
8880,2021-08-15,423991,Distribution,2438000,-8778000,9718000,940000
8880,2021-09-30,423991,Value,2432000,-8778000,9718000,940000
8888,2020-03-31,189,Value,5012330,-10000000,18045584,8045584
8888,2020-06-30,189,Value,5850140,-10000000,18045584,8045584
8888,2020-08-15,189,Distribution,2044335,-10000000,20089919,10089919
8888,2020-09-30,189,Value,3802620,-10000000,20089919,10089919
8888,2020-11-15,189,Distribution,288425,-10000000,20378344,10378344
8888,2020-12-31,189,Value,3308280,-10000000,20378344,10378344
8888,2021-03-31,189,Value,3300310,-10000000,20378344,10378344
8888,2021-06-30,189,Value,3298740,-10000000,20378344,10378344
8889,2020-03-31,698,Value,1079100,-9076130,11866379,2790249
8889,2020-05-16,698,Capital Call,-353074,-9429204,11866379,2437175
8889,2020-05-16,698,Distribution,444617,-9429204,12310996,2881792
8889,2020-06-30,698,Value,988760,-9429204,12310996,2881792
8889,2020-09-30,698,Value,950950,-9429204,12310996,2881792
8889,2020-12-31,698,Value,995350,-9429204,12310996,2881792
8893,2020-03-31,600,Value,1493150,-7718236,12433224,4714988
8893,2020-05-16,600,Capital Call,18236,-7700000,12433224,4733224
8893,2020-05-16,600,Distribution,-29293,-7700000,12403931,4703931
8893,2020-06-30,600,Value,1298220,-7700000,12403931,4703931
8894,2020-03-31,10595,Value,419990,-11340000,14150000,2810000
8894,2020-06-30,10595,Value,429990,-11340000,14150000,2810000
8894,2020-09-30,10595,Value,449990,-11340000,14150000,2810000
8894,2020-12-31,10595,Value,200000,-11340000,14150000,2810000
8894,2021-02-14,10595,Distribution,200000,-11340000,14350000,3010000
8894,2021-03-31,10595,Value,0,-11340000,14350000,3010000
8894,2021-06-30,10595,Value,0,-11340000,14350000,3010000
8894,2021-12-31,10595,Value,0,-11340000,14350000,3010000
8902,2020-02-15,10528,Distribution,1291412,-9980000,8438091,-1541909
8902,2020-03-31,10528,Value,2877230,-9980000,8438091,-1541909
8902,2020-06-30,10528,Value,3221540,-9980000,8438091,-1541909
8930,2020-02-15,436,Capital Call,-10091,-11311804,19848637,8536833
8930,2020-03-31,436,Value,524720,-11311804,19848637,8536833
8930,2020-05-16,436,Capital Call,-70636,-11382440,19848637,8466197
8930,2020-05-16,436,Distribution,393542,-11382440,20242179,8859739
8930,2020-06-30,436,Value,201810,-11382440,20242179,8859739
8930,2020-08-15,436,Distribution,100908,-11382440,20343087,8960647
8930,2020-09-30,436,Value,100900,-11382440,20343087,8960647
8930,2020-12-31,436,Value,90810,-11382440,20343087,8960647
8930,2021-03-31,436,Value,100900,-11382440,20343087,8960647
8930,2021-06-30,436,Value,80720,-11382440,20343087,8960647
8930,2021-09-30,436,Value,100900,-11382440,20343087,8960647
8938,2020-02-15,18,Capital Call,-422,-9505006,10706573,1201567
8938,2020-02-15,18,Distribution,476,-9505006,10707049,1202043
8938,2020-03-31,18,Value,3896210,-9505006,10707049,1202043
8938,2020-05-16,18,Distribution,456407,-9505006,11163456,1658450
8938,2020-06-30,18,Value,3944930,-9505006,11163456,1658450
8938,2020-09-30,18,Value,4339700,-9505006,11163456,1658450
8938,2020-11-15,18,Distribution,388872,-9505006,11552328,2047322
8938,2020-12-31,18,Value,4429030,-9505006,11552328,2047322
8938,2021-02-14,18,Distribution,360551,-9505006,11912879,2407873
8938,2021-03-31,18,Value,4440260,-9505006,11912879,2407873
8938,2021-05-16,18,Capital Call,8,-9504998,11912879,2407881
8938,2021-05-16,18,Distribution,471646,-9504998,12384525,2879527
8938,2021-06-30,18,Value,4387050,-9504998,12384525,2879527
8938,2021-09-30,18,Value,4182390,-9504998,12384525,2879527
8939,2020-02-15,18,Capital Call,-66,-9535000,13761996,4226996
8939,2020-02-15,18,Distribution,349287,-9535000,14111283,4576283
8939,2020-03-31,18,Value,3734660,-9535000,14111283,4576283
8939,2020-05-16,18,Distribution,454717,-9535000,14566000,5031000
8939,2020-06-30,18,Value,3838750,-9535000,14566000,5031000
8939,2020-09-30,18,Value,4177530,-9535000,14566000,5031000
8939,2020-11-15,18,Distribution,895044,-9535000,15461044,5926044
8939,2020-12-31,18,Value,4173850,-9535000,15461044,5926044
8939,2021-02-14,18,Distribution,424019,-9535000,15885063,6350063
8939,2021-03-31,18,Value,4337530,-9535000,15885063,6350063
8939,2021-05-16,18,Capital Call,66,-9534934,15885063,6350129
8939,2021-05-16,18,Distribution,576436,-9534934,16461499,6926565
8939,2021-06-30,18,Value,4095210,-9534934,16461499,6926565
8939,2021-08-15,18,Capital Call,-66,-9535000,16461499,6926499
8939,2021-08-15,18,Distribution,483493,-9535000,16944992,7409992
8939,2021-09-30,18,Value,3836170,-9535000,16944992,7409992
8941,2021-12-31,80,Value,0,-9600000,12576000,2976000
8942,2020-02-15,573,Distribution,190000,-9470000,13750000,4280000
8942,2020-03-31,573,Value,1771390,-9470000,13750000,4280000
8942,2020-05-16,573,Distribution,100000,-9470000,13850000,4380000
8942,2020-06-30,573,Value,1518670,-9470000,13850000,4380000
8942,2020-08-15,573,Distribution,160000,-9470000,14010000,4540000
8942,2020-09-30,573,Value,1530390,-9470000,14010000,4540000
8942,2020-11-15,573,Distribution,100000,-9470000,14110000,4640000
8942,2020-12-31,573,Value,1928720,-9470000,14110000,4640000
8942,2021-04-01,573,Distribution,540000,-9470000,14650000,5180000
8942,2021-06-30,573,Value,1618120,-9470000,14650000,5180000
8979,2020-03-31,768,Value,0,-10156446,11087266,930820
8979,2020-06-30,768,Value,0,-10156446,11087266,930820
8979,2020-09-30,768,Value,0,-10156446,11087266,930820
8979,2020-12-31,768,Value,0,-10156446,11087266,930820
8979,2021-03-31,768,Value,0,-10156446,11087266,930820
8979,2021-06-30,768,Value,0,-10156446,11087266,930820
8979,2021-12-31,768,Value,0,-10156446,11087266,930820
8987,2020-02-15,355,Distribution,180172,-9415105,11910879,2495774
8987,2020-03-31,355,Value,1468520,-9415105,11910879,2495774
8987,2020-06-30,355,Value,1441350,-9415105,11910879,2495774
8987,2020-08-15,355,Distribution,151724,-9415105,12062603,2647498
8987,2020-09-30,355,Value,1365460,-9415105,12062603,2647498
8987,2020-12-31,355,Value,1298590,-9415105,12062603,2647498
8998,2020-03-31,10770,Value,10286710,-10000000,15150306,5150306
8998,2020-06-30,10770,Value,11572440,-10000000,15150306,5150306
8998,2020-08-15,10770,Distribution,738768,-10000000,15889074,5889074
8998,2020-09-30,10770,Value,12898150,-10000000,15889074,5889074
8998,2020-11-15,10770,Distribution,14776132,-10000000,30665206,20665206
8998,2020-12-31,10770,Value,2696500,-10000000,30665206,20665206
8998,2021-03-31,10770,Value,3000390,-10000000,30665206,20665206
8998,2021-05-16,10770,Distribution,256000,-10000000,30921206,20921206
8998,2021-06-30,10770,Value,2096450,-10000000,30921206,20921206
9008,2020-06-30,2396,Value,299000,-9643000,25477000,15834000
9011,2020-02-15,1886,Distribution,350010,-9426195,10047347,621152
9011,2020-03-31,1886,Value,6147980,-9426195,10047347,621152
9011,2020-05-16,1886,Capital Call,-74,-9426269,10047347,621078
9011,2020-05-16,1886,Distribution,114,-9426269,10047461,621192
9011,2020-06-30,1886,Value,6836590,-9426269,10047461,621192
9011,2020-08-15,1886,Capital Call,484,-9425785,10047461,621676
9011,2020-08-15,1886,Distribution,199446,-9425785,10246907,821122
9011,2020-09-30,1886,Value,6939070,-9425785,10246907,821122
9011,2020-11-15,1886,Capital Call,-484,-9426269,10246907,820638
9011,2020-11-15,1886,Distribution,700763,-9426269,10947670,1521401
9011,2020-12-31,1886,Value,7370400,-9426269,10947670,1521401
9011,2021-02-14,1886,Capital Call,462,-9425807,10947670,1521863
9011,2021-02-14,1886,Distribution,999157,-9425807,11946827,2521020
9011,2021-03-31,1886,Value,7225450,-9425807,11946827,2521020
9011,2021-05-16,1886,Capital Call,-13,-9425820,11946827,2521007
9011,2021-05-16,1886,Distribution,700091,-9425820,12646918,3221098
9011,2021-06-30,1886,Value,6980230,-9425820,12646918,3221098
9011,2021-08-15,1886,Capital Call,-179,-9425999,12646918,3220919
9011,2021-08-15,1886,Distribution,500466,-9425999,13147384,3721385
9011,2021-09-30,1886,Value,7084580,-9425999,13147384,3721385
9013,2020-03-31,1886,Value,1831160,-9499996,10956597,1456601
9013,2020-06-30,1886,Value,1983960,-9499996,10956597,1456601
9013,2020-08-15,1886,Distribution,250000,-9499996,11206597,1706601
9013,2020-09-30,1886,Value,1941390,-9499996,11206597,1706601
9013,2020-11-15,1886,Capital Call,6,-9499990,11206597,1706607
9013,2020-11-15,1886,Distribution,349994,-9499990,11556591,2056601
9013,2020-12-31,1886,Value,1746520,-9499990,11556591,2056601
9013,2021-02-14,1886,Capital Call,-9,-9499999,11556591,2056592
9013,2021-02-14,1886,Distribution,38,-9499999,11556629,2056630
9013,2021-03-31,1886,Value,1904870,-9499999,11556629,2056630
9013,2021-05-16,1886,Capital Call,8,-9499991,11556629,2056638
9013,2021-05-16,1886,Distribution,588552,-9499991,12145181,2645190
9013,2021-06-30,1886,Value,415700,-9499991,12145181,2645190
9013,2021-08-15,1886,Capital Call,-5,-9499996,12145181,2645185
9013,2021-08-15,1886,Distribution,6265,-9499996,12151446,2651450
9013,2021-09-30,1886,Value,160430,-9499996,12151446,2651450
9017,2020-02-15,5571,Distribution,128507,-7500000,15558824,8058824
9017,2020-03-31,5571,Value,1306840,-7500000,15558824,8058824
9017,2020-06-30,5571,Value,1419010,-7500000,15558824,8058824
9017,2020-08-15,5571,Distribution,160634,-7500000,15719458,8219458
9017,2020-09-30,5571,Value,1308730,-7500000,15719458,8219458
9017,2020-11-15,5571,Distribution,145292,-7500000,15864750,8364750
9017,2020-12-31,5571,Value,1296000,-7500000,15864750,8364750
9017,2021-02-14,5571,Distribution,68887,-7500000,15933637,8433637
9017,2021-03-31,5571,Value,1018520,-7500000,15933637,8433637
9017,2021-05-16,5571,Distribution,128507,-7500000,16062144,8562144
9017,2021-06-30,5571,Value,898170,-7500000,16062144,8562144
9017,2021-08-15,5571,Distribution,432606,-7500000,16494750,8994750
9017,2021-09-30,5571,Value,497250,-7500000,16494750,8994750
9042,2020-03-31,2115,Value,365520,-10798135,13850947,3052812
9042,2020-06-30,2115,Value,362740,-10798135,13850947,3052812
9042,2020-09-30,2115,Value,366240,-10798135,13850947,3052812
9042,2020-12-31,2115,Value,295490,-10798135,13850947,3052812
9042,2021-03-31,2115,Value,291640,-10798135,13850947,3052812
9047,2021-12-31,10859,Value,0,-5658547,0,-5658547
9058,2020-03-31,10896,Value,0,-10701626,13527524,2825898
9058,2020-06-30,10896,Value,0,-10701626,13527524,2825898
9058,2020-09-30,10896,Value,0,-10701626,13527524,2825898
9058,2020-12-31,10896,Value,0,-10701626,13527524,2825898
9058,2021-03-31,10896,Value,0,-10701626,13527524,2825898
9058,2021-06-30,10896,Value,0,-10701626,13527524,2825898
9058,2021-09-30,10896,Value,0,-10701626,13527524,2825898
9058,2021-12-31,10896,Value,0,-10701626,13527524,2825898
9098,2020-02-15,6747,Capital Call,-17323,-8639454,13312640,4673186
9098,2020-02-15,6747,Distribution,203219,-8639454,13515859,4876405
9098,2020-03-31,6747,Value,1834280,-8639454,13515859,4876405
9098,2020-05-16,6747,Capital Call,-4723,-8644177,13515859,4871682
9098,2020-05-16,6747,Distribution,36426,-8644177,13552285,4908108
9098,2020-06-30,6747,Value,2119810,-8644177,13552285,4908108
9098,2020-08-15,6747,Capital Call,-4921,-8649098,13552285,4903187
9098,2020-08-15,6747,Distribution,173103,-8649098,13725388,5076290
9098,2020-09-30,6747,Value,2165100,-8649098,13725388,5076290
9098,2020-11-15,6747,Capital Call,-9445,-8658543,13725388,5066845
9098,2020-11-15,6747,Distribution,313824,-8658543,14039212,5380669
9098,2020-12-31,6747,Value,2357830,-8658543,14039212,5380669
9098,2021-02-14,6747,Capital Call,-12599,-8671142,14039212,5368070
9098,2021-02-14,6747,Distribution,141768,-8671142,14180980,5509838
9098,2021-03-31,6747,Value,2352790,-8671142,14180980,5509838
9098,2021-05-16,6747,Capital Call,-9445,-8680587,14180980,5500393
9098,2021-05-16,6747,Distribution,62143,-8680587,14243123,5562536
9098,2021-06-30,6747,Value,3310810,-8680587,14243123,5562536
9137,2020-03-31,733,Value,1383910,-11458602,13252650,1794048
9137,2020-06-30,733,Value,1647500,-11458602,13252650,1794048
9137,2020-09-30,733,Value,1437270,-11458602,13252650,1794048
9137,2020-12-31,733,Value,1447500,-11458602,13252650,1794048
9137,2021-02-14,733,Distribution,252679,-11458602,13505329,2046727
9137,2021-03-31,733,Value,1167230,-11458602,13505329,2046727
9137,2021-05-16,733,Distribution,111223,-11458602,13616552,2157950
9137,2021-06-30,733,Value,1126220,-11458602,13616552,2157950
9150,2020-02-15,534,Capital Call,-3116,-10117720,14005992,3888272
9150,2020-02-15,534,Distribution,100477,-10117720,14106469,3988749
9150,2020-03-31,534,Value,2332770,-10117720,14106469,3988749
9150,2020-05-16,534,Distribution,236934,-10117720,14343403,4225683
9150,2020-06-30,534,Value,2135310,-10117720,14343403,4225683
9150,2020-09-30,534,Capital Call,-11423,-10129143,14343403,4214260
9150,2020-09-30,534,Distribution,55941,-10129143,14399344,4270201
9150,2020-12-31,534,Value,2121640,-10129143,14399344,4270201
9150,2021-03-31,534,Value,2137570,-10129143,14399344,4270201
9150,2021-05-16,534,Capital Call,-3257,-10132400,14399344,4266944
9150,2021-05-16,534,Distribution,58757,-10132400,14458101,4325701
9150,2021-06-30,534,Value,2137570,-10132400,14458101,4325701
9202,2021-12-31,460,Value,0,-9772263,5802070,-3970193
9203,2021-12-31,10781,Value,0,-11686613,11972302,285689
9212,2020-03-31,162111,Value,2348290,-9900000,17311734,7411734
9212,2020-06-30,162111,Value,2036030,-9900000,17311734,7411734
9212,2020-09-30,162111,Value,2075720,-9900000,17311734,7411734
9212,2021-03-31,162111,Value,3600270,-9900000,17311734,7411734
9220,2020-02-15,6372,Distribution,22658,-11390012,15804617,4414605
9220,2020-03-31,6372,Value,780790,-11390012,15804617,4414605
9220,2020-05-16,6372,Distribution,138930,-11390012,15943547,4553535
9220,2020-06-30,6372,Value,689580,-11390012,15943547,4553535
9220,2020-08-15,6372,Distribution,160712,-11390012,16104259,4714247
9220,2020-09-30,6372,Value,576530,-11390012,16104259,4714247
9220,2020-12-31,6372,Value,576530,-11390012,16104259,4714247
9229,2021-12-31,211,Value,0,-6959866,1721326,-5238540
9380,2020-03-31,32667,Value,1528770,-8801841,12382781,3580940
9380,2020-06-30,32667,Value,1349480,-8801841,12382781,3580940
9380,2020-08-15,32667,Distribution,80372,-8801841,12463153,3661312
9380,2020-09-30,32667,Value,1376540,-8801841,12463153,3661312
9380,2020-11-15,32667,Distribution,388463,-8801841,12851616,4049775
9380,2020-12-31,32667,Value,1190690,-8801841,12851616,4049775
9380,2021-03-31,32667,Value,1262540,-8801841,12851616,4049775
9380,2021-05-16,32667,Distribution,66976,-8801841,12918592,4116751
9380,2021-06-30,32667,Value,1336010,-8801841,12918592,4116751
9416,2021-12-31,567,Value,0,-9290001,20021807,10731806
9436,2020-02-15,2562,Distribution,751200,-8000000,13454400,5454400
9436,2020-03-31,2562,Value,1766400,-8000000,13454400,5454400
9436,2020-06-30,2562,Value,1603200,-8000000,13454400,5454400
9436,2020-08-15,2562,Distribution,1600,-8000000,13456000,5456000
9436,2020-09-30,2562,Value,1640000,-8000000,13456000,5456000
9441,2020-02-15,2562,Distribution,876750,-7500000,21897000,14397000
9441,2020-03-31,2562,Value,3319500,-7500000,21897000,14397000
9441,2020-06-30,2562,Value,2949750,-7500000,21897000,14397000
9441,2020-08-15,2562,Distribution,655500,-7500000,22552500,15052500
9441,2020-09-30,2562,Value,2137500,-7500000,22552500,15052500
9441,2021-06-30,2562,Value,2107500,-7500000,22552500,15052500
9452,2020-02-15,24353,Distribution,127500,-10265000,17875000,7610000
9452,2020-03-31,24353,Value,5840000,-10265000,17875000,7610000
9452,2020-06-30,24353,Value,7202500,-10265000,17875000,7610000
9452,2020-09-30,24353,Value,6522500,-10265000,17875000,7610000
9452,2020-11-15,24353,Distribution,30000,-10265000,17905000,7640000
9452,2020-12-31,24353,Value,6612500,-10265000,17905000,7640000
9452,2021-03-31,24353,Value,6442500,-10265000,17905000,7640000
9452,2021-05-16,24353,Distribution,45000,-10265000,17950000,7685000
9452,2021-06-30,24353,Value,6597500,-10265000,17950000,7685000
9452,2021-08-15,24353,Distribution,960000,-10265000,18910000,8645000
9452,2021-09-30,24353,Value,5676060,-10265000,18910000,8645000
9455,2020-02-15,1314,Capital Call,-25000,-9674998,12499645,2824647
9455,2020-02-15,1314,Distribution,456148,-9674998,12955793,3280795
9455,2020-03-31,1314,Value,7356870,-9674998,12955793,3280795
9455,2020-05-16,1314,Capital Call,-25000,-9699998,12955793,3255795
9455,2020-05-16,1314,Distribution,667857,-9699998,13623650,3923652
9455,2020-06-30,1314,Value,7464150,-9699998,13623650,3923652
9455,2020-08-15,1314,Distribution,908890,-9699998,14532540,4832542
9455,2020-09-30,1314,Value,7406920,-9699998,14532540,4832542
9455,2020-11-15,1314,Distribution,912770,-9699998,15445310,5745312
9455,2020-12-31,1314,Value,8412810,-9699998,15445310,5745312
9455,2021-02-14,1314,Distribution,540290,-9699998,15985600,6285602
9455,2021-03-31,1314,Value,8530180,-9699998,15985600,6285602
9455,2021-05-16,1314,Distribution,532530,-9699998,16518130,6818132
9455,2021-06-30,1314,Value,8711570,-9699998,16518130,6818132
9455,2021-08-15,1314,Distribution,23280,-9699998,16541410,6841412
9455,2021-09-30,1314,Value,8123750,-9699998,16541410,6841412
9513,2020-03-31,2566,Value,7787570,-10000000,5522350,-4477650
9513,2020-06-30,2566,Value,7654830,-10000000,5522350,-4477650
9513,2020-09-30,2566,Value,7611920,-10000000,5522350,-4477650
9513,2020-12-31,2566,Value,8108240,-10000000,5522350,-4477650
9513,2021-02-14,2566,Distribution,7346,-10000000,5529696,-4470304
9513,2021-03-31,2566,Value,8161860,-10000000,5529696,-4470304
9513,2021-06-30,2566,Value,8167800,-10000000,5529696,-4470304
9528,2020-02-15,6881,Capital Call,2000,-8298001,11257289,2959288
9528,2020-02-15,6881,Distribution,-2713,-8298001,11254576,2956575
9528,2020-03-31,6881,Value,145210,-8298001,11254576,2956575
9528,2020-05-16,6881,Capital Call,-2000,-8300001,11254576,2954575
9528,2020-05-16,6881,Distribution,163733,-8300001,11418309,3118308
9528,2020-06-30,6881,Value,51460,-8300001,11418309,3118308
9528,2020-09-30,6881,Capital Call,16000,-8284001,11418309,3134308
9528,2020-09-30,6881,Distribution,-22011,-8284001,11396298,3112297
9528,2020-12-31,6881,Value,50530,-8284001,11396298,3112297
9528,2021-02-14,6881,Capital Call,-24000,-8308001,11396298,3088297
9528,2021-02-14,6881,Distribution,33017,-8308001,11429315,3121314
9528,2021-03-31,6881,Value,44860,-8308001,11429315,3121314
9538,2020-02-15,8146,Capital Call,-2661,-10206373,8876394,-1329979
9538,2020-02-15,8146,Distribution,2660,-10206373,8879054,-1327319
9538,2020-03-31,8146,Value,489460,-10206373,8879054,-1327319
9538,2020-06-30,8146,Value,320040,-10206373,8879054,-1327319
9538,2020-09-30,8146,Value,333990,-10206373,8879054,-1327319
9538,2020-12-31,8146,Value,130880,-10206373,8879054,-1327319
9538,2021-03-31,8146,Value,124750,-10206373,8879054,-1327319
9538,2021-06-30,8146,Value,218790,-10206373,8879054,-1327319
9549,2020-03-31,673,Value,6688240,-8868353,20447791,11579438
9549,2020-06-30,673,Value,6664410,-8868353,20447791,11579438
9549,2020-12-31,673,Value,6664410,-8868353,20447791,11579438
9549,2021-03-31,673,Value,6432660,-8868353,20447791,11579438
9549,2021-06-30,673,Value,6432660,-8868353,20447791,11579438
9622,2020-03-31,9526,Value,235720,-10188082,1594135,-8593947
9622,2020-06-30,9526,Value,237160,-10188082,1594135,-8593947
9622,2020-09-30,9526,Value,197500,-10188082,1594135,-8593947
9622,2020-12-31,9526,Value,197500,-10188082,1594135,-8593947
9647,2020-03-31,133,Value,195320,-10809809,9993854,-815955
9647,2020-06-30,133,Value,181690,-10809809,9993854,-815955
9647,2020-09-30,133,Value,165450,-10809809,9993854,-815955
9647,2020-12-31,133,Value,163220,-10809809,9993854,-815955
9647,2021-03-31,133,Value,197620,-10809809,9993854,-815955
9647,2021-05-16,133,Distribution,180920,-10809809,10174774,-635035
9647,2021-06-30,133,Value,18160,-10809809,10174774,-635035
9651,2020-02-15,5698,Capital Call,3770,-11185711,23732744,12547033
9651,2020-03-31,5698,Value,504230,-11185711,23732744,12547033
9651,2020-06-30,5698,Value,511220,-11185711,23732744,12547033
9651,2020-09-30,5698,Value,522880,-11185711,23732744,12547033
9651,2020-12-31,5698,Value,510480,-11185711,23732744,12547033
9651,2021-03-31,5698,Value,507140,-11185711,23732744,12547033
9651,2021-06-30,5698,Value,505320,-11185711,23732744,12547033
9657,2020-02-15,2281,Distribution,-1915,-9720545,13648573,3928028
9657,2020-03-31,2281,Value,1420280,-9720545,13648573,3928028
9657,2020-06-30,2281,Value,1232930,-9720545,13648573,3928028
9657,2020-09-30,2281,Value,997390,-9720545,13648573,3928028
9657,2020-12-31,2281,Value,1075640,-9720545,13648573,3928028
9657,2021-03-31,2281,Value,1077830,-9720545,13648573,3928028
9657,2021-06-30,2281,Value,1099310,-9720545,13648573,3928028
9693,2020-02-15,643,Capital Call,-9000,-12344002,7727876,-4616126
9693,2020-02-15,643,Distribution,1117833,-12344002,8845709,-3498293
9693,2020-03-31,643,Value,7985330,-12344002,8845709,-3498293
9693,2020-06-30,643,Value,8727200,-12344002,8845709,-3498293
9693,2020-08-15,643,Capital Call,-8000,-12352002,8845709,-3506293
9693,2020-08-15,643,Distribution,389880,-12352002,9235589,-3116413
9693,2020-09-30,643,Value,9517210,-12352002,9235589,-3116413
9693,2020-11-15,643,Distribution,573133,-12352002,9808722,-2543280
9693,2020-12-31,643,Value,8955200,-12352002,9808722,-2543280
9693,2021-03-31,643,Value,18014150,-12352002,9808722,-2543280
9693,2021-06-30,643,Value,20285680,-12352002,9808722,-2543280
9693,2021-08-15,643,Distribution,2845901,-12352002,12654623,302621
9693,2021-09-30,643,Value,16350340,-12352002,12654623,302621
9693,2021-11-15,643,Distribution,4375078,-12352002,17029701,4677699
9693,2021-12-31,643,Value,7941100,-12352002,17029701,4677699
9727,2020-03-31,308,Value,4992530,-11714292,10199665,-1514627
9727,2020-06-30,308,Value,5810280,-11714292,10199665,-1514627
9727,2020-09-30,308,Value,5265010,-11714292,10199665,-1514627
9727,2020-12-31,308,Value,5265010,-11714292,10199665,-1514627
9727,2021-03-31,308,Value,7493120,-11714292,10199665,-1514627
9727,2021-06-30,308,Value,7493120,-11714292,10199665,-1514627
9727,2021-09-30,308,Value,5834380,-11714292,10199665,-1514627
9789,2020-02-15,711,Capital Call,120336,-9999998,9093415,-906583
9789,2020-03-31,711,Value,2531560,-9999998,9093415,-906583
9789,2020-05-16,711,Distribution,191346,-9999998,9284761,-715237
9789,2020-06-30,711,Value,1995850,-9999998,9284761,-715237
9789,2020-08-15,711,Capital Call,-107597,-10107595,9284761,-822834
9789,2020-08-15,711,Distribution,45390,-10107595,9330151,-777444
9789,2020-09-30,711,Value,2010620,-10107595,9330151,-777444
9789,2020-12-30,711,Capital Call,-9658,-10117253,9330151,-787102
9789,2020-12-30,711,Distribution,9658,-10117253,9339809,-777444
9789,2021-03-31,711,Value,2275370,-10117253,9339809,-777444
9789,2021-06-30,711,Value,2274280,-10117253,9339809,-777444
9831,2020-03-31,355,Value,945640,-9600000,12045755,2445755
9831,2020-06-30,355,Value,962870,-9600000,12045755,2445755
9831,2020-09-30,355,Value,969590,-9600000,12045755,2445755
9831,2020-11-15,355,Distribution,144315,-9600000,12190070,2590070
9831,2020-12-31,355,Value,782930,-9600000,12190070,2590070
9831,2021-03-31,355,Value,814030,-9600000,12190070,2590070
9883,2020-03-31,2575,Value,294540,-10000000,3854926,-6145074
9883,2020-06-30,2575,Value,208960,-10000000,3854926,-6145074
9883,2020-09-30,2575,Value,8190,-10000000,3854926,-6145074
9883,2020-11-15,2575,Distribution,-1,-10000000,3854925,-6145075
9883,2020-12-31,2575,Value,8190,-10000000,3854925,-6145075
9883,2021-02-14,2575,Distribution,1,-10000000,3854926,-6145074
9883,2021-03-31,2575,Value,8190,-10000000,3854926,-6145074
9883,2021-06-30,2575,Value,8190,-10000000,3854926,-6145074
9883,2021-09-30,2575,Value,8190,-10000000,3854926,-6145074
9933,2020-02-15,11813,Distribution,348000,-9150000,13340454,4190454
9933,2020-03-31,11813,Value,5828170,-9150000,13340454,4190454
9933,2020-05-16,11813,Distribution,360000,-9150000,13700454,4550454
9933,2020-06-30,11813,Value,5451550,-9150000,13700454,4550454
9933,2020-08-15,11813,Distribution,340000,-9150000,14040454,4890454
9933,2020-09-30,11813,Value,5698930,-9150000,14040454,4890454
9933,2020-11-15,11813,Distribution,207619,-9150000,14248073,5098073
9933,2020-12-31,11813,Value,6088400,-9150000,14248073,5098073
9933,2021-02-14,11813,Distribution,692144,-9150000,14940217,5790217
9933,2021-03-31,11813,Value,5396250,-9150000,14940217,5790217
9933,2021-05-16,11813,Distribution,373687,-9150000,15313904,6163904
9933,2021-06-30,11813,Value,7828360,-9150000,15313904,6163904
9933,2021-08-15,11813,Distribution,577480,-9150000,15891384,6741384
9933,2021-09-30,11813,Value,8059240,-9150000,15891384,6741384
9947,2020-08-15,11832,Distribution,285870,-9528998,16104010,6575012
9947,2021-03-31,11832,Value,952900,-9528998,16104010,6575012
9947,2021-05-16,11832,Distribution,-181051,-9528998,15922959,6393961
9947,2021-06-30,11832,Value,1153000,-9528998,15922959,6393961
9947,2021-08-15,11832,Capital Call,29000,-9499998,15922959,6422961
9947,2021-08-15,11832,Distribution,892041,-9499998,16815000,7315002
9947,2021-12-31,11832,Value,0,-9499998,16815000,7315002
9957,2020-03-31,395,Value,2099720,-10243750,25046210,14802460
9957,2020-05-16,395,Distribution,181438,-10243750,25227648,14983898
9957,2020-06-30,395,Value,2532910,-10243750,25227648,14983898
9957,2020-08-15,395,Distribution,2120490,-10243750,27348138,17104388
9957,2020-09-30,395,Value,514860,-10243750,27348138,17104388
9957,2020-12-31,395,Value,309980,-10243750,27348138,17104388
9957,2021-03-31,395,Value,309980,-10243750,27348138,17104388
9957,2021-06-30,395,Value,309980,-10243750,27348138,17104388
9973,2020-02-15,5782,Capital Call,-11210,-10475498,13204660,2729162
9973,2020-02-15,5782,Distribution,344231,-10475498,13548891,3073393
9973,2020-03-31,5782,Value,1166150,-10475498,13548891,3073393
9973,2020-05-16,5782,Capital Call,-10089,-10485587,13548891,3063304
9973,2020-06-30,5782,Value,1166150,-10485587,13548891,3063304
9973,2020-08-15,5782,Capital Call,-10089,-10495676,13548891,3053215
9973,2020-09-30,5782,Value,1046010,-10495676,13548891,3053215
9973,2020-11-15,5782,Capital Call,-8827,-10504503,13548891,3044388
9973,2020-11-15,5782,Distribution,183945,-10504503,13732836,3228333
9973,2020-12-31,5782,Value,843330,-10504503,13732836,3228333
9973,2021-02-14,5782,Capital Call,-10089,-10514592,13732836,3218244
9973,2021-03-31,5782,Value,913810,-10514592,13732836,3218244
9973,2021-05-16,5782,Capital Call,1106154,-9408438,13732836,4324398
9973,2021-06-30,5782,Value,1026290,-9408438,13732836,4324398
9975,2020-05-31,849,Value,407310,-9647584,27803678,18156094
9975,2020-07-16,849,Distribution,77139,-9647584,27880817,18233233
9975,2020-08-31,849,Value,330080,-9647584,27880817,18233233
9975,2020-11-30,849,Value,390800,-9647584,27880817,18233233
9975,2021-02-28,849,Value,390800,-9647584,27880817,18233233
9975,2021-05-31,849,Value,375350,-9647584,27880817,18233233
9975,2021-08-31,849,Value,375250,-9647584,27880817,18233233
9975,2021-10-16,849,Capital Call,-352416,-10000000,27880817,17880817
9975,2021-10-16,849,Distribution,1018186,-10000000,28899003,18899003
9975,2021-11-30,849,Value,389000,-10000000,28899003,18899003
10002,2020-03-31,2305,Value,1335030,-9438677,14521947,5083270
10002,2020-06-30,2305,Value,1146250,-9438677,14521947,5083270
10002,2020-08-15,2305,Distribution,18295,-9438677,14540242,5101565
10002,2020-09-30,2305,Value,1222340,-9438677,14540242,5101565
10002,2020-11-15,2305,Distribution,7159,-9438677,14547401,5108724
10002,2020-12-31,2305,Value,1592730,-9438677,14547401,5108724
10002,2021-03-31,2305,Value,1970280,-9438677,14547401,5108724
10002,2021-06-30,2305,Value,1687120,-9438677,14547401,5108724
10005,2020-03-31,2005,Value,24180,-8857491,3909818,-4947673
10005,2020-06-30,2005,Value,53030,-8857491,3909818,-4947673
10005,2020-08-15,2005,Distribution,51580,-8857491,3961398,-4896093
10005,2020-09-30,2005,Value,0,-8857491,3961398,-4896093
10005,2021-03-31,2005,Value,0,-8857491,3961398,-4896093
10005,2021-06-30,2005,Value,0,-8857491,3961398,-4896093
10005,2021-09-30,2005,Value,0,-8857491,3961398,-4896093
10005,2021-12-31,2005,Value,0,-8857491,3961398,-4896093
10053,2020-02-15,538,Capital Call,60000,-9700002,13136958,3436956
10053,2020-02-15,538,Distribution,-80760,-9700002,13056198,3356196
10053,2020-03-31,538,Value,6887000,-9700002,13056198,3356196
10053,2020-05-16,538,Capital Call,-60000,-9760002,13056198,3296196
10053,2020-05-16,538,Distribution,598040,-9760002,13654238,3894236
10053,2020-06-30,538,Value,7622560,-9760002,13654238,3894236
10053,2020-08-15,538,Capital Call,-40000,-9800002,13654238,3854236
10053,2020-08-15,538,Distribution,2055160,-9800002,15709398,5909396
10053,2020-09-30,538,Value,6487600,-9800002,15709398,5909396
10053,2020-11-15,538,Distribution,1381800,-9800002,17091198,7291196
10053,2020-12-31,538,Value,5419400,-9800002,17091198,7291196
10053,2021-03-31,538,Value,7448000,-9800002,17091198,7291196
10053,2021-05-16,538,Distribution,29400,-9800002,17120598,7320596
10053,2021-06-30,538,Value,7820400,-9800002,17120598,7320596
10053,2021-08-15,538,Distribution,1744400,-9800002,18864998,9064996
10053,2021-09-30,538,Value,5840800,-9800002,18864998,9064996
10054,2020-06-30,701,Value,4948980,-9931700,4302982,-5628718
10054,2020-08-15,701,Distribution,239230,-9931700,4542212,-5389488
10054,2020-09-30,701,Value,4806550,-9931700,4542212,-5389488
10054,2020-12-31,701,Value,4550300,-9931700,4542212,-5389488
10069,2020-02-15,11324,Capital Call,-4977,-10707645,25552826,14845181
10069,2020-03-31,11324,Value,796060,-10707645,25552826,14845181
10069,2020-06-30,11324,Value,853520,-10707645,25552826,14845181
10069,2020-08-15,11324,Capital Call,-7879,-10715524,25552826,14837302
10069,2020-09-30,11324,Value,845550,-10715524,25552826,14837302
10069,2020-11-15,11324,Capital Call,-1269,-10716793,25552826,14836033
10069,2020-12-31,11324,Value,822980,-10716793,25552826,14836033
10069,2021-02-14,11324,Capital Call,-7037,-10723830,25552826,14828996
10069,2021-03-31,11324,Value,829450,-10723830,25552826,14828996
10086,2020-03-31,1360,Value,3094570,-9073302,7927207,-1146095
10086,2020-06-30,1360,Value,2749780,-9073302,7927207,-1146095
10086,2020-08-15,1360,Distribution,170506,-9073302,8097713,-975589
10086,2020-09-30,1360,Value,2637170,-9073302,8097713,-975589
10086,2020-11-15,1360,Distribution,556276,-9073302,8653989,-419313
10086,2020-12-31,1360,Value,2006450,-9073302,8653989,-419313
10086,2021-02-14,1360,Distribution,85253,-9073302,8739242,-334060
10086,2021-03-31,1360,Value,1950750,-9073302,8739242,-334060
10086,2021-05-16,1360,Distribution,44758,-9073302,8784000,-289302
10086,2021-06-30,1360,Value,1932960,-9073302,8784000,-289302
10086,2021-08-15,1360,Distribution,42626,-9073302,8826626,-246676
10086,2021-09-30,1360,Value,1982990,-9073302,8826626,-246676
10097,2021-12-31,12680,Value,0,-11546665,13920000,2373335
10106,2020-02-15,2182,Distribution,226540,-10465767,10977266,511499
10106,2020-03-31,2182,Value,101790,-10465767,10977266,511499
10106,2020-06-30,2182,Value,98920,-10465767,10977266,511499
10106,2020-09-30,2182,Distribution,123875,-10465767,11101141,635374
10106,2020-12-31,2182,Value,90370,-10465767,11101141,635374
10106,2021-03-31,2182,Value,0,-10465767,11101141,635374
10106,2021-06-30,2182,Value,0,-10465767,11101141,635374
10106,2021-09-30,2182,Value,0,-10465767,11101141,635374
10106,2021-12-31,2182,Value,0,-10465767,11101141,635374
10109,2020-03-31,2250,Value,525680,-8547124,13232258,4685134
10109,2020-06-30,2250,Value,524430,-8547124,13232258,4685134
10109,2020-09-30,2250,Capital Call,-1416799,-9963923,13232258,3268335
10109,2020-09-30,2250,Distribution,161575,-9963923,13393833,3429910
10109,2020-09-30,2250,Value,429070,-9963923,13393833,3429910
10109,2020-12-31,2250,Value,407940,-9963923,13393833,3429910
10109,2021-03-31,2250,Value,406590,-9963923,13393833,3429910
10109,2021-05-16,2250,Capital Call,-7174,-9971097,13393833,3422736
10109,2021-05-16,2250,Distribution,97873,-9971097,13491706,3520609
10109,2021-06-30,2250,Value,323450,-9971097,13491706,3520609
10111,2020-03-31,24459,Value,2971520,-11530624,5808173,-5722451
10111,2020-06-30,24459,Value,3041500,-11530624,5808173,-5722451
10111,2020-09-30,24459,Value,3093170,-11530624,5808173,-5722451
10111,2020-12-31,24459,Value,3273960,-11530624,5808173,-5722451
10111,2021-03-31,24459,Value,4201410,-11530624,5808173,-5722451
10111,2021-06-30,24459,Value,4208540,-11530624,5808173,-5722451
10112,2020-02-15,1480,Distribution,56934,-10857807,27377230,16519423
10112,2020-03-31,1480,Value,80050,-10857807,27377230,16519423
10112,2020-06-30,1480,Value,67230,-10857807,27377230,16519423
10112,2020-09-30,1480,Value,67210,-10857807,27377230,16519423
10112,2020-12-31,1480,Value,67750,-10857807,27377230,16519423
10112,2021-03-31,1480,Value,68060,-10857807,27377230,16519423
10112,2021-12-31,1480,Value,0,-10857807,27377230,16519423
10113,2020-03-31,2616,Value,16528370,-9500000,71320860,61820860
10113,2020-06-30,2616,Value,20567700,-9500000,71320860,61820860
10113,2020-09-30,2616,Value,23100080,-9500000,71320860,61820860
10113,2020-12-31,2616,Value,14641280,-9500000,71320860,61820860
10113,2021-03-31,2616,Value,31510390,-9500000,71320860,61820860
10113,2021-06-30,2616,Value,59768890,-9500000,71320860,61820860
10145,2020-02-15,795,Distribution,460258,-10000000,14298305,4298305
10145,2020-03-31,795,Value,2419100,-10000000,14298305,4298305
10145,2020-05-16,795,Distribution,916017,-10000000,15214322,5214322
10145,2020-06-30,795,Value,1338070,-10000000,15214322,5214322
10145,2020-08-15,795,Distribution,751610,-10000000,15965932,5965932
10145,2020-09-30,795,Value,1142830,-10000000,15965932,5965932
10170,2020-03-31,5777,Value,255810,-9944398,14142798,4198400
10170,2020-06-30,5777,Value,218240,-9944398,14142798,4198400
10170,2020-09-30,5777,Value,272470,-9944398,14142798,4198400
10170,2020-12-31,5777,Value,283690,-9944398,14142798,4198400
10170,2021-03-31,5777,Value,287000,-9944398,14142798,4198400
10170,2021-05-16,5777,Distribution,149792,-9944398,14292590,4348192
10170,2021-06-30,5777,Value,116660,-9944398,14292590,4348192
10177,2020-03-31,13975,Value,0,-10202480,4261184,-5941296
10177,2020-06-30,13975,Value,0,-10202480,4261184,-5941296
10177,2020-09-30,13975,Value,0,-10202480,4261184,-5941296
10177,2020-12-31,13975,Value,0,-10202480,4261184,-5941296
10177,2021-03-31,13975,Value,0,-10202480,4261184,-5941296
10177,2021-06-30,13975,Value,0,-10202480,4261184,-5941296
10177,2021-09-30,13975,Value,0,-10202480,4261184,-5941296
10177,2021-12-31,13975,Value,0,-10202480,4261184,-5941296
10199,2020-03-31,44,Value,43690,-10947794,20398919,9451125
10199,2020-06-30,44,Value,43550,-10947794,20398919,9451125
10199,2020-09-30,44,Value,42600,-10947794,20398919,9451125
10199,2020-11-15,44,Capital Call,-1293,-10949087,20398919,9449832
10199,2020-11-15,44,Distribution,24713,-10949087,20423632,9474545
10199,2020-12-31,44,Value,20180,-10949087,20423632,9474545
10199,2021-02-14,44,Distribution,4611,-10949087,20428243,9479156
10199,2021-03-31,44,Value,15490,-10949087,20428243,9479156
10204,2020-03-31,12208,Value,300000,-10000000,18800001,8800001
10204,2020-06-30,12208,Value,300000,-10000000,18800001,8800001
10204,2020-09-30,12208,Value,400000,-10000000,18800001,8800001
10204,2020-12-31,12208,Value,400000,-10000000,18800001,8800001
10204,2021-03-31,12208,Value,400000,-10000000,18800001,8800001
10204,2021-07-01,12208,Distribution,200000,-10000000,19000001,9000001
10204,2021-09-30,12208,Value,300000,-10000000,19000001,9000001
10210,2020-01-15,86,Capital Call,0,-10838096,15459354,4621258
10210,2020-01-15,86,Distribution,20238,-10838096,15479592,4641496
10210,2020-02-29,86,Value,198450,-10838096,15479592,4641496
10210,2020-04-15,86,Capital Call,0,-10838096,15479592,4641496
10210,2020-04-15,86,Distribution,0,-10838096,15479592,4641496
10210,2020-05-31,86,Value,200790,-10838096,15479592,4641496
10210,2020-08-31,86,Value,199840,-10838096,15479592,4641496
10210,2020-11-30,86,Value,199330,-10838096,15479592,4641496
10210,2021-02-28,86,Value,126480,-10838096,15479592,4641496
10210,2021-05-31,86,Value,127780,-10838096,15479592,4641496
10210,2021-08-31,86,Value,98620,-10838096,15479592,4641496
10210,2021-10-16,86,Capital Call,0,-10838096,15479592,4641496
10210,2021-10-16,86,Distribution,0,-10838096,15479592,4641496
10210,2021-11-30,86,Value,93350,-10838096,15479592,4641496
10223,2020-02-15,80,Distribution,27692,-9720000,14532510,4812510
10223,2020-03-31,80,Value,1728520,-9720000,14532510,4812510
10223,2020-06-30,80,Value,1302550,-9720000,14532510,4812510
10223,2020-09-30,80,Value,1566230,-9720000,14532510,4812510
10223,2020-11-15,80,Distribution,5457,-9720000,14537967,4817967
10223,2020-12-31,80,Value,1560770,-9720000,14537967,4817967
10223,2021-02-14,80,Capital Call,-5457,-9725457,14537967,4812510
10223,2021-02-14,80,Distribution,0,-9725457,14537967,4812510
10223,2021-03-31,80,Value,1729960,-9725457,14537967,4812510
10223,2021-05-16,80,Distribution,37233,-9725457,14575200,4849743
10223,2021-06-30,80,Value,1791700,-9725457,14575200,4849743
10224,2020-03-31,581,Value,2050770,-13191263,10241559,-2949704
10224,2020-06-30,581,Value,1936290,-13191263,10241559,-2949704
10224,2020-09-30,581,Value,1863740,-13191263,10241559,-2949704
10224,2020-12-31,581,Value,1938650,-13191263,10241559,-2949704
10224,2021-03-31,581,Value,1938180,-13191263,10241559,-2949704
10224,2021-06-30,581,Value,1886010,-13191263,10241559,-2949704
10271,2020-03-31,384,Value,97000,-9700000,14453000,4753000
10271,2020-06-30,384,Value,0,-9700000,14453000,4753000
10271,2020-09-30,384,Value,0,-9700000,14453000,4753000
10271,2020-12-31,384,Value,0,-9700000,14453000,4753000
10271,2021-03-31,384,Value,0,-9700000,14453000,4753000
10271,2021-06-30,384,Value,0,-9700000,14453000,4753000
10271,2021-09-30,384,Value,0,-9700000,14453000,4753000
10271,2021-12-31,384,Value,0,-9700000,14453000,4753000
10274,2020-02-15,140,Capital Call,422370,-10419631,19964458,9544827
10274,2020-02-15,140,Distribution,-778153,-10419631,19186305,8766674
10274,2020-03-31,140,Value,146010,-10419631,19186305,8766674
10274,2020-06-30,140,Value,147860,-10419631,19186305,8766674
10274,2020-09-30,140,Value,153530,-10419631,19186305,8766674
10274,2020-12-31,140,Value,161500,-10419631,19186305,8766674
10274,2021-02-14,140,Distribution,17996,-10419631,19204301,8784670
10274,2021-03-31,140,Value,136370,-10419631,19204301,8784670
10274,2021-06-30,140,Value,136230,-10419631,19204301,8784670
10293,2020-03-31,12340,Value,877690,-13035234,9153915,-3881319
10293,2020-06-30,12340,Value,863890,-13035234,9153915,-3881319
10293,2020-08-15,12340,Capital Call,-118126,-13153360,9153915,-3999445
10293,2020-09-30,12340,Value,1036130,-13153360,9153915,-3999445
10293,2020-12-31,12340,Value,906610,-13153360,9153915,-3999445
10293,2021-03-31,12340,Value,1085060,-13153360,9153915,-3999445
10293,2021-06-30,12340,Value,1082180,-13153360,9153915,-3999445
10308,2020-03-31,47256,Value,1127250,-9903037,10228111,325074
10308,2020-06-30,47256,Value,1280890,-9903037,10228111,325074
10308,2020-09-30,47256,Value,1378270,-9903037,10228111,325074
10311,2020-02-15,506,Distribution,100000,-9500000,12804389,3304389
10311,2020-03-31,506,Value,3752000,-9500000,12804389,3304389
10311,2020-05-16,506,Distribution,250000,-9500000,13054389,3554389
10311,2020-06-30,506,Value,3314080,-9500000,13054389,3554389
10311,2020-08-15,506,Distribution,400000,-9500000,13454389,3954389
10311,2020-09-30,506,Value,3448120,-9500000,13454389,3954389
10311,2020-11-15,506,Capital Call,-100000,-9600000,13454389,3854389
10311,2020-11-15,506,Distribution,630000,-9600000,14084389,4484389
10311,2020-12-31,506,Value,3432870,-9600000,14084389,4484389
10311,2021-02-14,506,Distribution,450000,-9600000,14534389,4934389
10311,2021-03-31,506,Value,2982870,-9600000,14534389,4934389
10311,2021-05-16,506,Distribution,350000,-9600000,14884389,5284389
10311,2021-06-30,506,Value,3671420,-9600000,14884389,5284389
10312,2020-03-31,368,Value,1995530,-10000000,6107001,-3892999
10312,2020-05-16,368,Distribution,2145,-10000000,6109146,-3890854
10312,2020-06-30,368,Value,1592800,-10000000,6109146,-3890854
10312,2020-08-15,368,Distribution,67,-10000000,6109213,-3890787
10312,2020-09-30,368,Value,1418510,-10000000,6109213,-3890787
10312,2020-12-31,368,Value,1623710,-10000000,6109213,-3890787
10312,2021-03-31,368,Value,1647810,-10000000,6109213,-3890787
10312,2021-06-30,368,Value,1762930,-10000000,6109213,-3890787
10317,2020-02-15,5296,Distribution,197700,-6590000,8764699,2174699
10317,2020-03-31,5296,Value,922600,-6590000,8764699,2174699
10317,2020-06-30,5296,Value,856700,-6590000,8764699,2174699
10317,2020-09-30,5296,Value,856700,-6590000,8764699,2174699
10317,2020-11-15,5296,Distribution,65900,-6590000,8830599,2240599
10317,2020-12-31,5296,Value,790800,-6590000,8830599,2240599
10317,2021-03-31,5296,Value,856700,-6590000,8830599,2240599
10317,2021-05-16,5296,Distribution,395400,-6590000,9225999,2635999
10317,2021-06-30,5296,Value,659000,-6590000,9225999,2635999
10318,2020-02-15,455,Distribution,36122,-9284222,15390213,6105991
10318,2020-03-31,455,Value,889440,-9284222,15390213,6105991
10318,2020-06-30,455,Value,844160,-9284222,15390213,6105991
10318,2020-09-30,455,Value,954150,-9284222,15390213,6105991
10319,2020-03-31,275,Value,12011970,-9577342,2643996,-6933346
10319,2020-06-30,275,Value,11996740,-9577342,2643996,-6933346
10319,2020-09-30,275,Distribution,2539311,-9577342,5183307,-4394035
10319,2020-12-31,275,Value,9519310,-9577342,5183307,-4394035
10319,2021-03-31,275,Value,9992130,-9577342,5183307,-4394035
10319,2021-06-30,275,Value,9992130,-9577342,5183307,-4394035
10333,2020-02-15,1759,Capital Call,-99000,-12038000,18744231,6706231
10333,2020-02-15,1759,Distribution,338408,-12038000,19082639,7044639
10333,2020-03-31,1759,Value,1926080,-12038000,19082639,7044639
10333,2020-06-30,1759,Value,1685320,-12038000,19082639,7044639
10333,2020-09-30,1759,Value,1685320,-12038000,19082639,7044639
10333,2020-11-15,1759,Distribution,924518,-12038000,20007157,7969157
10333,2020-12-31,1759,Value,842660,-12038000,20007157,7969157
10333,2021-02-14,1759,Capital Call,-52000,-12090000,20007157,7917157
10333,2021-02-14,1759,Distribution,606294,-12090000,20613451,8523451
10333,2021-03-31,1759,Value,241800,-12090000,20613451,8523451
10333,2021-05-16,1759,Capital Call,-4000,-12094000,20613451,8519451
10333,2021-05-16,1759,Distribution,6820,-12094000,20620271,8526271
10333,2021-06-30,1759,Value,241880,-12094000,20620271,8526271
10333,2021-08-15,1759,Capital Call,-6000,-12100000,20620271,8520271
10333,2021-08-15,1759,Distribution,10230,-12100000,20630501,8530501
10333,2021-09-30,1759,Value,242000,-12100000,20630501,8530501
10339,2020-03-31,6217,Value,4449510,-9753566,12949250,3195684
10339,2020-06-30,6217,Value,5123900,-9753566,12949250,3195684
10339,2020-08-15,6217,Distribution,46997,-9753566,12996247,3242681
10339,2020-09-30,6217,Value,5564580,-9753566,12996247,3242681
10339,2020-11-15,6217,Distribution,688557,-9753566,13684804,3931238
10339,2020-12-31,6217,Value,5994340,-9753566,13684804,3931238
10339,2021-03-31,6217,Value,6280710,-9753566,13684804,3931238
10339,2021-05-16,6217,Distribution,1115611,-9753566,14800415,5046849
10339,2021-06-30,6217,Value,6326000,-9753566,14800415,5046849
10350,2020-03-31,245,Value,5283150,-9650769,6496479,-3154290
10350,2020-06-30,245,Value,5186090,-9650769,6496479,-3154290
10350,2020-08-15,245,Capital Call,-65000,-9715769,6496479,-3219290
10350,2020-09-30,245,Value,5365340,-9715769,6496479,-3219290
10350,2020-12-31,245,Value,5528900,-9715769,6496479,-3219290
10350,2021-03-31,245,Value,5692490,-9715769,6496479,-3219290
10350,2021-05-16,245,Distribution,772374,-9715769,7268853,-2446916
10350,2021-06-30,245,Value,5201530,-9715769,7268853,-2446916
10350,2021-12-31,245,Value,0,-9715769,7268853,-2446916
10354,2020-03-31,431,Value,0,-10805000,20447500,9642500
10354,2020-06-30,431,Value,0,-10805000,20447500,9642500
10354,2020-09-30,431,Value,0,-10805000,20447500,9642500
10354,2020-12-31,431,Value,0,-10805000,20447500,9642500
10354,2021-03-31,431,Value,0,-10805000,20447500,9642500
10354,2021-06-30,431,Value,0,-10805000,20447500,9642500
10354,2021-09-30,431,Value,0,-10805000,20447500,9642500
10358,2020-01-15,8072,Distribution,0,-10000000,36021246,26021246
10358,2020-02-29,8072,Value,6366880,-10000000,36021246,26021246
10358,2020-04-15,8072,Distribution,0,-10000000,36021246,26021246
10358,2020-05-31,8072,Value,6228730,-10000000,36021246,26021246
10358,2020-08-31,8072,Value,6233330,-10000000,36021246,26021246
10358,2020-11-30,8072,Value,6485560,-10000000,36021246,26021246
10358,2021-02-28,8072,Value,6493850,-10000000,36021246,26021246
10358,2021-05-31,8072,Value,30618970,-10000000,36021246,26021246
10358,2021-07-16,8072,Distribution,2817851,-10000000,38839097,28839097
10358,2021-08-31,8072,Value,30854390,-10000000,38839097,28839097
10358,2021-10-16,8072,Distribution,2808024,-10000000,41647121,31647121
10358,2021-11-30,8072,Value,30476400,-10000000,41647121,31647121
10368,2020-03-31,12475,Value,0,-8064014,23362784,15298770
10368,2020-06-30,12475,Value,0,-8064014,23362784,15298770
10368,2020-09-30,12475,Value,0,-8064014,23362784,15298770
10368,2020-11-15,12475,Distribution,44805,-8064014,23407589,15343575
10368,2020-12-31,12475,Value,0,-8064014,23407589,15343575
10368,2021-12-31,12475,Value,0,-8064014,23407589,15343575
10371,2020-03-31,8426,Value,602070,-8528001,9858000,1329999
10396,2020-06-30,212,Value,829850,-9981398,14896943,4915545
10396,2020-12-31,212,Value,937390,-9981398,14896943,4915545
10415,2020-02-15,8966,Distribution,79893,-9341116,6010951,-3330165
10415,2020-03-31,8966,Value,1063910,-9341116,6010951,-3330165
10415,2020-06-30,8966,Value,1415280,-9341116,6010951,-3330165
10415,2020-09-30,8966,Distribution,28124,-9341116,6039075,-3302041
10415,2020-12-31,8966,Value,1091550,-9341116,6039075,-3302041
10415,2021-03-31,8966,Value,1066250,-9341116,6039075,-3302041
10415,2021-06-30,8966,Value,1066250,-9341116,6039075,-3302041
10425,2020-03-31,455,Value,48740,-10974379,17966958,6992579
10425,2020-06-30,455,Value,43790,-10974379,17966958,6992579
10425,2020-09-30,455,Value,43630,-10974379,17966958,6992579
10425,2020-12-31,455,Value,40850,-10974379,17966958,6992579
10425,2021-03-31,455,Value,41990,-10974379,17966958,6992579
10425,2021-06-30,455,Value,37750,-10974379,17966958,6992579
10425,2021-12-31,455,Value,0,-10974379,17966958,6992579
10482,2020-03-31,12961,Value,4616140,-9968325,10005728,37403
10482,2020-05-16,12961,Capital Call,-1092,-9969417,10005728,36311
10482,2020-05-16,12961,Distribution,372832,-9969417,10378560,409143
10482,2020-06-30,12961,Value,4250280,-9969417,10378560,409143
10482,2020-09-30,12961,Value,4255530,-9969417,10378560,409143
10482,2020-12-31,12961,Value,4322700,-9969417,10378560,409143
10482,2021-03-31,12961,Value,4392320,-9969417,10378560,409143
10482,2021-06-30,12961,Value,4449760,-9969417,10378560,409143
10483,2020-03-31,12961,Value,3831990,-9912570,2953625,-6958945
10483,2020-06-30,12961,Value,3758230,-9912570,2953625,-6958945
10483,2020-12-31,12961,Value,3686270,-9912570,2953625,-6958945
10485,2020-03-31,12961,Value,1091170,-11285471,7797594,-3487877
10485,2020-05-16,12961,Distribution,133466,-11285471,7931060,-3354411
10485,2020-06-30,12961,Value,935510,-11285471,7931060,-3354411
10485,2020-12-31,12961,Value,927530,-11285471,7931060,-3354411
10485,2021-03-31,12961,Value,689950,-11285471,7931060,-3354411
10485,2021-06-30,12961,Value,680330,-11285471,7931060,-3354411
10486,2020-03-31,1373,Value,6200000,-10480001,13899999,3419998
10486,2020-05-16,1373,Distribution,1800000,-10480001,15699999,5219998
10486,2020-06-30,1373,Value,4800000,-10480001,15699999,5219998
10486,2020-08-15,1373,Distribution,440000,-10480001,16139999,5659998
10486,2020-09-30,1373,Value,5760000,-10480001,16139999,5659998
10486,2020-11-15,1373,Distribution,5360000,-10480001,21499999,11019998
10486,2020-12-31,1373,Value,0,-10480001,21499999,11019998
10486,2021-03-31,1373,Value,0,-10480001,21499999,11019998
10486,2021-06-30,1373,Value,0,-10480001,21499999,11019998
10486,2021-09-30,1373,Value,0,-10480001,21499999,11019998
10544,2020-02-15,18,Capital Call,-307,-9307000,13605734,4298734
10544,2020-02-15,18,Distribution,448,-9307000,13606182,4299182
10544,2020-03-31,18,Value,5353440,-9307000,13606182,4299182
10544,2020-05-16,18,Distribution,765133,-9307000,14371315,5064315
10544,2020-06-30,18,Value,5390950,-9307000,14371315,5064315
10544,2020-08-15,18,Distribution,378571,-9307000,14749886,5442886
10544,2020-09-30,18,Value,5592330,-9307000,14749886,5442886
10544,2020-11-15,18,Distribution,446494,-9307000,15196380,5889380
10544,2020-12-31,18,Value,6425820,-9307000,15196380,5889380
10544,2021-02-14,18,Distribution,552374,-9307000,15748754,6441754
10544,2021-03-31,18,Value,7039550,-9307000,15748754,6441754
10544,2021-05-16,18,Capital Call,307,-9306693,15748754,6442061
10544,2021-05-16,18,Distribution,769583,-9306693,16518337,7211644
10544,2021-06-30,18,Value,6893250,-9306693,16518337,7211644
10544,2021-08-15,18,Distribution,867988,-9306693,17386325,8079632
10544,2021-09-30,18,Value,6376230,-9306693,17386325,8079632
10545,2020-02-15,18,Capital Call,448,-9133000,9079339,-53661
10545,2020-02-15,18,Distribution,-445,-9133000,9078894,-54106
10545,2020-03-31,18,Value,6224980,-9133000,9078894,-54106
10545,2020-05-16,18,Distribution,566933,-9133000,9645827,512827
10545,2020-06-30,18,Value,6547550,-9133000,9645827,512827
10545,2020-09-30,18,Value,7251600,-9133000,9645827,512827
10545,2020-11-15,18,Distribution,854996,-9133000,10500823,1367823
10545,2020-12-31,18,Value,7170600,-9133000,10500823,1367823
10545,2021-02-14,18,Distribution,386127,-9133000,10886950,1753950
10545,2021-03-31,18,Value,7450850,-9133000,10886950,1753950
10545,2021-05-16,18,Capital Call,19,-9132981,10886950,1753969
10545,2021-05-16,18,Distribution,430029,-9132981,11316979,2183998
10545,2021-06-30,18,Value,7711490,-9132981,11316979,2183998
10545,2021-08-15,18,Distribution,592469,-9132981,11909448,2776467
10545,2021-09-30,18,Value,7138990,-9132981,11909448,2776467
10565,2020-02-15,579,Capital Call,-8337,-9022030,11492878,2470848
10565,2020-02-15,579,Distribution,176975,-9022030,11669853,2647823
10565,2020-03-31,579,Value,3441430,-9022030,11669853,2647823
10565,2020-05-16,579,Capital Call,-27967,-9049997,11669853,2619856
10565,2020-05-16,579,Distribution,312345,-9049997,11982198,2932201
10565,2020-06-30,579,Value,3674300,-9049997,11982198,2932201
10565,2020-12-30,579,Capital Call,-54000,-9103997,11982198,2878201
10565,2020-12-30,579,Distribution,1522674,-9103997,13504872,4400875
10565,2021-06-30,579,Value,4214240,-9103997,13504872,4400875
10565,2021-08-15,579,Capital Call,-4000,-9107997,13504872,4396875
10565,2021-08-15,579,Distribution,447672,-9107997,13952544,4844547
10565,2021-09-30,579,Value,3849040,-9107997,13952544,4844547
10566,2020-02-15,579,Capital Call,-10000,-10335002,13714697,3379695
10566,2020-02-15,579,Distribution,78393,-10335002,13793090,3458088
10566,2020-03-31,579,Value,1973980,-10335002,13793090,3458088
10566,2020-05-16,579,Capital Call,-25000,-10360002,13793090,3433088
10566,2020-05-16,579,Distribution,545149,-10360002,14338239,3978237
10566,2020-06-30,579,Value,1761200,-10360002,14338239,3978237
10580,2020-03-31,5309,Value,19490,-8966928,17519325,8552397
10580,2020-06-30,5309,Value,19220,-8966928,17519325,8552397
10580,2020-09-30,5309,Value,18590,-8966928,17519325,8552397
10580,2020-12-31,5309,Value,22100,-8966928,17519325,8552397
10580,2021-03-31,5309,Value,22890,-8966928,17519325,8552397
10580,2021-05-16,5309,Capital Call,-22354,-8989282,17519325,8530043
10580,2021-05-16,5309,Distribution,22354,-8989282,17541679,8552397
10580,2021-06-30,5309,Value,22900,-8989282,17541679,8552397
10580,2021-12-31,5309,Value,0,-8989282,17541679,8552397
10603,2020-03-31,2476,Value,102450,-9314000,33046070,23732070
10603,2020-06-30,2476,Value,93140,-9314000,33046070,23732070
10603,2020-09-30,2476,Value,93140,-9314000,33046070,23732070
10603,2020-11-15,2476,Capital Call,4000,-9310000,33046070,23736070
10603,2020-11-15,2476,Distribution,-14192,-9310000,33031878,23721878
10603,2020-12-31,2476,Value,0,-9310000,33031878,23721878
10603,2021-03-31,2476,Value,0,-9310000,33031878,23721878
10603,2021-06-30,2476,Value,0,-9310000,33031878,23721878
10603,2021-09-30,2476,Value,0,-9310000,33031878,23721878
10603,2021-12-31,2476,Value,0,-9310000,33031878,23721878
10605,2020-03-31,1503,Value,0,-8898071,13268232,4370161
10605,2020-06-30,1503,Value,0,-8898071,13268232,4370161
10605,2020-09-30,1503,Value,0,-8898071,13268232,4370161
10605,2020-12-31,1503,Value,0,-8898071,13268232,4370161
10605,2021-03-31,1503,Value,0,-8898071,13268232,4370161
10605,2021-06-30,1503,Value,0,-8898071,13268232,4370161
10605,2021-09-30,1503,Value,0,-8898071,13268232,4370161
10605,2021-12-31,1503,Value,0,-8898071,13268232,4370161
10627,2020-03-31,8003,Value,2491020,-10584181,8326336,-2257845
10627,2020-05-16,8003,Capital Call,-39945,-10624126,8326336,-2297790
10627,2020-05-16,8003,Distribution,157457,-10624126,8483793,-2140333
10627,2020-06-30,8003,Value,2361880,-10624126,8483793,-2140333
10627,2020-09-30,8003,Value,2320670,-10624126,8483793,-2140333
10627,2020-12-31,8003,Value,2312240,-10624126,8483793,-2140333
10627,2021-03-31,8003,Value,2311170,-10624126,8483793,-2140333
10627,2021-06-30,8003,Value,2308930,-10624126,8483793,-2140333
10641,2020-03-31,2500,Value,866040,-10000000,15975192,5975192
10641,2020-06-30,2500,Value,978720,-10000000,15975192,5975192
10641,2020-08-15,2500,Distribution,801900,-10000000,16777092,6777092
10641,2020-09-30,2500,Value,178530,-10000000,16777092,6777092
10641,2020-11-15,2500,Distribution,21909,-10000000,16799001,6799001
10641,2020-12-31,2500,Value,145620,-10000000,16799001,6799001
10641,2021-02-14,2500,Distribution,30972,-10000000,16829973,6829973
10641,2021-03-31,2500,Value,152900,-10000000,16829973,6829973
10655,2020-02-15,910,Capital Call,-3049,-10537828,15408119,4870291
10655,2020-02-15,910,Distribution,352944,-10537828,15761063,5223235
10655,2020-03-31,910,Value,2851950,-10537828,15761063,5223235
10655,2020-05-16,910,Capital Call,-2305,-10540133,15761063,5220930
10655,2020-05-16,910,Distribution,94070,-10540133,15855133,5315000
10655,2020-06-30,910,Value,2939830,-10540133,15855133,5315000
10655,2020-08-15,910,Capital Call,-1952,-10542085,15855133,5313048
10655,2020-08-15,910,Distribution,207765,-10542085,16062898,5520813
10655,2020-09-30,910,Value,2941100,-10542085,16062898,5520813
10655,2020-11-15,910,Capital Call,-2035,-10544120,16062898,5518778
10655,2020-11-15,910,Distribution,417342,-10544120,16480240,5936120
10655,2020-12-31,910,Value,3001620,-10544120,16480240,5936120
10655,2021-02-14,910,Capital Call,-2565,-10546685,16480240,5933555
10655,2021-02-14,910,Distribution,151918,-10546685,16632158,6085473
10655,2021-03-31,910,Value,3279990,-10546685,16632158,6085473
10655,2021-05-16,910,Capital Call,-4271,-10550956,16632158,6081202
10655,2021-05-16,910,Distribution,326937,-10550956,16959095,6408139
10655,2021-06-30,910,Value,3288300,-10550956,16959095,6408139
10663,2020-03-31,5772,Value,772000,-10235735,9066563,-1169172
10663,2020-06-30,5772,Value,362400,-10235735,9066563,-1169172
10663,2020-08-15,5772,Capital Call,0,-10235735,9066563,-1169172
10663,2020-08-15,5772,Distribution,0,-10235735,9066563,-1169172
10663,2020-09-30,5772,Value,343800,-10235735,9066563,-1169172
10663,2020-12-30,5772,Capital Call,-50507,-10286242,9066563,-1219679
10663,2021-03-31,5772,Value,447400,-10286242,9066563,-1219679
10663,2021-06-30,5772,Value,383600,-10286242,9066563,-1219679
10678,2020-03-31,439,Value,353970,-9246117,16002412,6756295
10678,2020-06-30,439,Value,423700,-9246117,16002412,6756295
10678,2020-09-30,439,Value,492270,-9246117,16002412,6756295
10678,2020-12-31,439,Value,523920,-9246117,16002412,6756295
10678,2021-02-14,439,Capital Call,-1302,-9247419,16002412,6754993
10678,2021-02-14,439,Distribution,32665,-9247419,16035077,6787658
10678,2021-03-31,439,Value,495130,-9247419,16035077,6787658
10678,2021-06-30,439,Value,494780,-9247419,16035077,6787658
10682,2020-03-31,435,Value,110320,-9059301,15799586,6740285
10682,2020-06-30,435,Value,110540,-9059301,15799586,6740285
10682,2020-09-30,435,Value,111010,-9059301,15799586,6740285
10682,2020-12-31,435,Value,109500,-9059301,15799586,6740285
10682,2021-03-31,435,Value,109530,-9059301,15799586,6740285
10686,2020-06-30,9389,Value,1360000,-10000000,9090000,-910000
10693,2020-03-31,709,Value,0,-10274747,11951371,1676624
10693,2020-06-30,709,Value,0,-10274747,11951371,1676624
10693,2020-09-30,709,Value,0,-10274747,11951371,1676624
10693,2020-12-31,709,Value,0,-10274747,11951371,1676624
10693,2021-03-31,709,Value,0,-10274747,11951371,1676624
10693,2021-06-30,709,Value,0,-10274747,11951371,1676624
10693,2021-09-30,709,Value,0,-10274747,11951371,1676624
10693,2021-12-31,709,Value,0,-10274747,11951371,1676624
10704,2020-02-15,6733,Capital Call,-19861,-9793357,16858283,7064926
10704,2020-02-15,6733,Distribution,103367,-9793357,16961650,7168293
10704,2020-03-31,6733,Value,899460,-9793357,16961650,7168293
10704,2020-05-16,6733,Distribution,86992,-9793357,17048642,7255285
10704,2020-06-30,6733,Value,934310,-9793357,17048642,7255285
10704,2020-09-30,6733,Value,942010,-9793357,17048642,7255285
10704,2020-11-15,6733,Distribution,326973,-9793357,17375615,7582258
10704,2020-12-31,6733,Value,907500,-9793357,17375615,7582258
10704,2021-02-14,6733,Capital Call,-6798,-9800155,17375615,7575460
10704,2021-02-14,6733,Distribution,380701,-9800155,17756316,7956161
10704,2021-03-31,6733,Value,769600,-9800155,17756316,7956161
10704,2021-06-30,6733,Value,1041700,-9800155,17756316,7956161
10704,2021-08-15,6733,Distribution,909304,-9800155,18665620,8865465
10704,2021-09-30,6733,Value,266060,-9800155,18665620,8865465
10707,2020-03-31,355,Value,389990,-9780000,16170000,6390000
10707,2020-09-30,355,Value,450000,-9780000,16170000,6390000
10707,2020-12-31,355,Value,360000,-9780000,16170000,6390000
10707,2021-02-14,355,Distribution,360000,-9780000,16530000,6750000
10707,2021-03-31,355,Value,0,-9780000,16530000,6750000
10707,2021-06-30,355,Value,0,-9780000,16530000,6750000
10707,2021-09-30,355,Value,0,-9780000,16530000,6750000
10714,2020-02-15,13022,Distribution,1200501,-10000000,36865281,26865281
10714,2020-03-31,13022,Value,1378820,-10000000,36865281,26865281
10714,2020-06-30,13022,Value,1326070,-10000000,36865281,26865281
10714,2020-08-15,13022,Distribution,859447,-10000000,37724728,27724728
10714,2020-09-30,13022,Value,507350,-10000000,37724728,27724728
10714,2020-12-31,13022,Value,500810,-10000000,37724728,27724728
10714,2021-03-31,13022,Value,623770,-10000000,37724728,27724728
10714,2021-06-30,13022,Value,660670,-10000000,37724728,27724728
10727,2020-03-31,178,Value,1417870,-8858786,22140141,13281355
10727,2020-06-30,178,Value,1471820,-8858786,22140141,13281355
10727,2020-09-30,178,Value,1541390,-8858786,22140141,13281355
10727,2020-11-15,178,Capital Call,-8527,-8867313,22140141,13272828
10727,2020-11-15,178,Distribution,86599,-8867313,22226740,13359427
10727,2020-12-31,178,Value,1507910,-8867313,22226740,13359427
10727,2021-03-31,178,Value,1682690,-8867313,22226740,13359427
10727,2021-06-30,178,Value,1894640,-8867313,22226740,13359427
10727,2021-09-30,178,Value,1798440,-8867313,22226740,13359427
10743,2020-03-31,23,Value,1531460,-10291769,13712386,3420617
10743,2020-06-30,23,Value,1845840,-10291769,13712386,3420617
10743,2020-08-15,23,Distribution,700000,-10291769,14412386,4120617
10743,2020-09-30,23,Value,1144350,-10291769,14412386,4120617
10743,2020-12-31,23,Value,1148620,-10291769,14412386,4120617
10743,2021-02-14,23,Distribution,230000,-10291769,14642386,4350617
10743,2021-03-31,23,Value,898400,-10291769,14642386,4350617
10743,2021-06-30,23,Value,910970,-10291769,14642386,4350617
10746,2020-01-15,2105,Capital Call,0,-10131467,7913306,-2218161
10746,2020-02-29,2105,Value,6191710,-10131467,7913306,-2218161
10746,2020-04-15,2105,Capital Call,0,-10131467,7913306,-2218161
10746,2020-05-31,2105,Value,6002920,-10131467,7913306,-2218161
10746,2020-07-16,2105,Distribution,617915,-10131467,8531221,-1600246
10746,2020-08-31,2105,Value,5218460,-10131467,8531221,-1600246
10746,2020-11-30,2105,Value,5906020,-10131467,8531221,-1600246
10746,2021-01-14,2105,Capital Call,-104338,-10235805,8531221,-1704584
10746,2021-01-14,2105,Distribution,2845028,-10235805,11376249,1140444
10746,2021-02-28,2105,Value,3165330,-10235805,11376249,1140444
10746,2021-04-15,2105,Distribution,377156,-10235805,11753405,1517600
10746,2021-05-31,2105,Value,2193920,-10235805,11753405,1517600
10746,2021-08-31,2105,Value,2057440,-10235805,11753405,1517600
10746,2021-10-16,2105,Capital Call,0,-10235805,11753405,1517600
10746,2021-10-16,2105,Distribution,0,-10235805,11753405,1517600
10746,2021-11-30,2105,Value,1862310,-10235805,11753405,1517600
10747,2020-09-30,305,Value,0,-8835037,13709533,4874496
10747,2020-12-31,305,Value,0,-8835037,13709533,4874496
10747,2021-03-31,305,Value,0,-8835037,13709533,4874496
10747,2021-06-30,305,Value,0,-8835037,13709533,4874496
10753,2020-01-20,515145,Distribution,38986,-7794834,9056515,1261681
10753,2020-03-31,515145,Capital Call,-1345166,-9140000,9056515,-83485
10753,2020-03-31,515145,Distribution,1563249,-9140000,10619764,1479764
10753,2020-03-31,515145,Value,3782790,-9140000,10619764,1479764
10753,2020-05-16,515145,Capital Call,-69000,-9209000,10619764,1410764
10753,2020-05-16,515145,Distribution,53,-9209000,10619817,1410817
10753,2020-06-30,515145,Value,4401900,-9209000,10619817,1410817
10753,2020-08-15,515145,Distribution,41441,-9209000,10661258,1452258
10753,2020-09-30,515145,Value,4505960,-9209000,10661258,1452258
10753,2020-11-15,515145,Capital Call,-22000,-9231000,10661258,1430258
10753,2020-11-15,515145,Distribution,467634,-9231000,11128892,1897892
10753,2020-12-31,515145,Value,3826240,-9231000,11128892,1897892
10753,2021-04-01,515145,Capital Call,22000,-9209000,11128892,1919892
10753,2021-04-01,515145,Distribution,-467634,-9209000,10661258,1452258
10753,2021-06-30,515145,Value,2648500,-9209000,10661258,1452258
10777,2020-02-15,733,Distribution,11500,-9490250,11449751,1959501
10777,2020-03-31,733,Value,1762750,-9490250,11449751,1959501
10777,2020-06-30,733,Value,1898250,-9490250,11449751,1959501
10777,2020-08-15,733,Distribution,377000,-9490250,11826751,2336501
10777,2020-09-30,733,Value,1560000,-9490250,11826751,2336501
10777,2020-11-15,733,Distribution,98750,-9490250,11925501,2435251
10777,2020-12-31,733,Value,1508000,-9490250,11925501,2435251
10797,2020-02-15,22872,Capital Call,-23608,-9556669,17174556,7617887
10797,2020-02-15,22872,Distribution,541493,-9556669,17716049,8159380
10797,2020-03-31,22872,Value,2679240,-9556669,17716049,8159380
10797,2020-09-30,22872,Value,2837500,-9556669,17716049,8159380
10809,2020-02-15,70,Capital Call,-40434,-10905305,21176170,10270865
10809,2020-02-15,70,Distribution,318073,-10905305,21494243,10588938
10809,2020-03-31,70,Value,337400,-10905305,21494243,10588938
10809,2020-06-30,70,Value,337400,-10905305,21494243,10588938
10809,2020-09-30,70,Value,417960,-10905305,21494243,10588938
10809,2020-12-31,70,Value,450250,-10905305,21494243,10588938
10809,2021-03-31,70,Value,437960,-10905305,21494243,10588938
10809,2021-06-30,70,Value,468980,-10905305,21494243,10588938
10814,2020-03-31,13191,Value,2240640,-10152876,6962456,-3190420
10814,2020-06-30,13191,Value,1935790,-10152876,6962456,-3190420
10814,2020-12-31,13191,Value,1758020,-10152876,6962456,-3190420
10814,2021-02-14,13191,Capital Call,-6564,-10159440,6962456,-3196984
10814,2021-02-14,13191,Distribution,878655,-10159440,7841111,-2318329
10814,2021-03-31,13191,Value,919070,-10159440,7841111,-2318329
10814,2021-05-16,13191,Distribution,251518,-10159440,8092629,-2066811
10814,2021-06-30,13191,Value,919070,-10159440,8092629,-2066811
10814,2021-08-15,13191,Capital Call,438,-10159002,8092629,-2066373
10814,2021-08-15,13191,Distribution,-226516,-10159002,7866113,-2292889
10814,2021-09-30,13191,Value,706050,-10159002,7866113,-2292889
10831,2020-03-31,1986,Value,0,-9999998,5486070,-4513928
10831,2020-06-30,1986,Value,0,-9999998,5486070,-4513928
10831,2020-09-30,1986,Value,0,-9999998,5486070,-4513928
10831,2020-12-31,1986,Value,0,-9999998,5486070,-4513928
10831,2021-03-31,1986,Value,0,-9999998,5486070,-4513928
10831,2021-06-30,1986,Value,0,-9999998,5486070,-4513928
10831,2021-09-30,1986,Value,0,-9999998,5486070,-4513928
10831,2021-12-31,1986,Value,0,-9999998,5486070,-4513928
10832,2020-03-31,13198,Value,0,-6931800,13341596,6409796
10832,2020-06-30,13198,Value,0,-6931800,13341596,6409796
10832,2020-09-30,13198,Value,0,-6931800,13341596,6409796
10832,2020-12-31,13198,Value,0,-6931800,13341596,6409796
10832,2021-03-31,13198,Value,0,-6931800,13341596,6409796
10832,2021-06-30,13198,Value,0,-6931800,13341596,6409796
10832,2021-09-30,13198,Value,0,-6931800,13341596,6409796
10832,2021-12-31,13198,Value,0,-6931800,13341596,6409796
10842,2020-02-15,812,Capital Call,-9409,-9737235,13988573,4251338
10842,2020-03-31,812,Value,4453620,-9737235,13988573,4251338
10842,2020-05-16,812,Capital Call,-10081,-9747316,13988573,4241257
10842,2020-05-16,812,Distribution,145161,-9747316,14133734,4386418
10842,2020-06-30,812,Value,3600130,-9747316,14133734,4386418
10842,2020-08-15,812,Capital Call,-9409,-9756725,14133734,4377009
10842,2020-08-15,812,Distribution,49059,-9756725,14182793,4426068
10842,2020-09-30,812,Value,3632390,-9756725,14182793,4426068
10842,2020-11-15,812,Capital Call,-9409,-9766134,14182793,4416659
10842,2020-11-15,812,Distribution,63172,-9766134,14245965,4479831
10842,2020-12-31,812,Value,3882390,-9766134,14245965,4479831
10842,2021-02-14,812,Capital Call,-8737,-9774871,14245965,4471094
10842,2021-02-14,812,Distribution,543011,-9774871,14788976,5014105
10842,2021-03-31,812,Value,3958330,-9774871,14788976,5014105
10842,2021-05-16,812,Capital Call,-8737,-9783608,14788976,5005368
10842,2021-05-16,812,Distribution,160618,-9783608,14949594,5165986
10842,2021-06-30,812,Value,4428760,-9783608,14949594,5165986
10852,2020-01-15,12267,Capital Call,0,-9363959,20695215,11331256
10852,2020-01-15,12267,Distribution,0,-9363959,20695215,11331256
10852,2020-02-29,12267,Value,1993510,-9363959,20695215,11331256
10852,2020-04-15,12267,Capital Call,0,-9363959,20695215,11331256
10852,2020-04-15,12267,Distribution,0,-9363959,20695215,11331256
10852,2020-05-31,12267,Value,2008890,-9363959,20695215,11331256
10852,2020-08-31,12267,Value,2008080,-9363959,20695215,11331256
10852,2020-10-16,12267,Distribution,2004755,-9363959,22699970,13336011
10852,2020-11-30,12267,Value,48080,-9363959,22699970,13336011
10852,2021-01-14,12267,Distribution,73643,-9363959,22773613,13409654
10852,2021-02-28,12267,Value,0,-9363959,22773613,13409654
10852,2021-05-31,12267,Value,0,-9363959,22773613,13409654
10852,2021-08-31,12267,Value,0,-9363959,22773613,13409654
10852,2021-12-31,12267,Value,0,-9363959,22773613,13409654
10854,2020-03-31,449,Value,6724630,-8844312,16796455,7952143
10854,2020-06-30,449,Value,6726870,-8844312,16796455,7952143
10854,2020-08-15,449,Distribution,82709,-8844312,16879164,8034852
10854,2020-09-30,449,Value,7124580,-8844312,16879164,8034852
10854,2020-12-31,449,Value,7875110,-8844312,16879164,8034852
10854,2021-04-01,449,Distribution,3271231,-8844312,20150395,11306083
10854,2021-06-30,449,Value,1861410,-8844312,20150395,11306083
10858,2020-03-31,969,Value,0,-10000014,15003022,5003008
10858,2020-06-30,969,Value,0,-10000014,15003022,5003008
10858,2020-09-30,969,Value,0,-10000014,15003022,5003008
10858,2020-12-31,969,Value,0,-10000014,15003022,5003008
10858,2021-03-31,969,Value,0,-10000014,15003022,5003008
10858,2021-06-30,969,Value,0,-10000014,15003022,5003008
10858,2021-09-30,969,Value,0,-10000014,15003022,5003008
10858,2021-12-31,969,Value,0,-10000014,15003022,5003008
10860,2020-03-31,739,Value,666920,-9842128,18749213,8907085
10860,2020-06-30,739,Value,909020,-9842128,18749213,8907085
10860,2020-09-30,739,Value,909310,-9842128,18749213,8907085
10860,2020-11-15,739,Capital Call,-19216,-9861344,18749213,8887869
10860,2020-11-15,739,Distribution,19216,-9861344,18768429,8907085
10860,2020-12-31,739,Value,909310,-9861344,18768429,8907085
10860,2021-03-31,739,Value,932790,-9861344,18768429,8907085
10860,2021-06-30,739,Value,1163230,-9861344,18768429,8907085
10860,2021-09-30,739,Value,1163230,-9861344,18768429,8907085
10878,2020-03-31,291,Value,2351630,-10000000,15520307,5520307
10878,2020-06-30,291,Value,2478290,-10000000,15520307,5520307
10878,2020-09-30,291,Value,2518320,-10000000,15520307,5520307
10878,2020-12-31,291,Value,2074260,-10000000,15520307,5520307
10878,2021-03-31,291,Value,1996800,-10000000,15520307,5520307
10878,2021-06-30,291,Value,2435490,-10000000,15520307,5520307
10881,2020-02-15,424,Capital Call,-519,-9470850,10734772,1263922
10881,2020-02-15,424,Distribution,246092,-9470850,10980864,1510014
10881,2020-03-31,424,Value,1511990,-9470850,10980864,1510014
10881,2020-05-16,424,Capital Call,-25,-9470875,10980864,1509989
10881,2020-05-16,424,Distribution,17131,-9470875,10997995,1527120
10881,2020-06-30,424,Value,1582190,-9470875,10997995,1527120
10881,2020-08-15,424,Capital Call,-994,-9471869,10997995,1526126
10881,2020-08-15,424,Distribution,9514,-9471869,11007509,1535640
10881,2020-09-30,424,Value,1766580,-9471869,11007509,1535640
10881,2020-12-31,424,Value,2014770,-9471869,11007509,1535640
10911,2020-03-31,1886,Value,1104020,-10000000,14229137,4229137
10911,2020-05-16,1886,Distribution,-137,-10000000,14229000,4229000
10911,2020-06-30,1886,Value,757250,-10000000,14229000,4229000
10911,2020-09-30,1886,Value,670210,-10000000,14229000,4229000
10911,2020-12-31,1886,Value,613000,-10000000,14229000,4229000
10911,2021-03-31,1886,Value,606000,-10000000,14229000,4229000
10911,2021-05-16,1886,Distribution,140000,-10000000,14369000,4369000
10911,2021-06-30,1886,Value,458000,-10000000,14369000,4369000
10911,2021-08-15,1886,Distribution,137,-10000000,14369137,4369137
10911,2021-09-30,1886,Value,448750,-10000000,14369137,4369137
10917,2020-03-31,366,Value,0,-10402820,9793426,-609394
10917,2020-06-30,366,Value,0,-10402820,9793426,-609394
10917,2020-09-30,366,Value,0,-10402820,9793426,-609394
10917,2020-12-31,366,Value,0,-10402820,9793426,-609394
10917,2021-03-31,366,Value,0,-10402820,9793426,-609394
10917,2021-06-30,366,Value,0,-10402820,9793426,-609394
10917,2021-09-30,366,Value,0,-10402820,9793426,-609394
10917,2021-12-31,366,Value,0,-10402820,9793426,-609394
10932,2020-02-15,6322,Distribution,1707692,-9984615,19138461,9153846
10932,2020-03-31,6322,Value,1246150,-9984615,19138461,9153846
10932,2020-05-16,6322,Distribution,292308,-9984615,19430769,9446154
10932,2020-06-30,6322,Value,599990,-9984615,19430769,9446154
10932,2020-09-30,6322,Value,492300,-9984615,19430769,9446154
10932,2020-12-30,6322,Distribution,261538,-9984615,19692307,9707692
10932,2021-03-31,6322,Value,0,-9984615,19692307,9707692
10932,2021-06-30,6322,Value,0,-9984615,19692307,9707692
10932,2021-09-30,6322,Value,0,-9984615,19692307,9707692
10932,2021-12-31,6322,Value,0,-9984615,19692307,9707692
10944,2020-02-15,7567,Distribution,448423,-4931891,7280741,2348850
10944,2020-03-31,7567,Value,102670,-4931891,7280741,2348850
10944,2020-06-30,7567,Value,531820,-4931891,7280741,2348850
10944,2020-09-30,7567,Value,631910,-4931891,7280741,2348850
10944,2020-12-31,7567,Value,680730,-4931891,7280741,2348850
10944,2021-03-31,7567,Value,680730,-4931891,7280741,2348850
10948,2020-02-15,52,Distribution,38500,-10000000,41730029,31730029
10948,2020-03-31,52,Value,6914010,-10000000,41730029,31730029
10948,2020-05-16,52,Distribution,493079,-10000000,42223108,32223108
10948,2020-06-30,52,Value,9080410,-10000000,42223108,32223108
10948,2020-08-15,52,Distribution,2231658,-10000000,44454766,34454766
10948,2020-09-30,52,Value,6119310,-10000000,44454766,34454766
10948,2020-11-15,52,Distribution,959,-10000000,44455725,34455725
10948,2020-12-31,52,Value,12946430,-10000000,44455725,34455725
10948,2021-02-14,52,Distribution,996246,-10000000,45451971,35451971
10948,2021-03-31,52,Value,10705790,-10000000,45451971,35451971
10948,2021-05-16,52,Distribution,834331,-10000000,46286302,36286302
10948,2021-06-30,52,Value,8231290,-10000000,46286302,36286302
10948,2021-09-30,52,Value,7358630,-10000000,46286302,36286302
10949,2020-03-31,8787,Value,3514670,-9355000,22504389,13149389
10949,2020-05-16,8787,Distribution,1671739,-9355000,24176128,14821128
10949,2020-06-30,8787,Value,1870060,-9355000,24176128,14821128
10949,2020-09-30,8787,Value,1870060,-9355000,24176128,14821128
10949,2020-12-31,8787,Value,1864450,-9355000,24176128,14821128
10949,2021-02-14,8787,Distribution,1283506,-9355000,25459634,16104634
10949,2021-03-31,8787,Value,582810,-9355000,25459634,16104634
10949,2021-06-30,8787,Value,582810,-9355000,25459634,16104634
10949,2021-08-15,8787,Distribution,401330,-9355000,25860964,16505964
10949,2021-09-30,8787,Value,597780,-9355000,25860964,16505964
10950,2020-02-15,8787,Distribution,51676,-9066000,14518292,5452292
10950,2020-03-31,8787,Value,6827600,-9066000,14518292,5452292
10950,2020-06-30,8787,Value,7161230,-9066000,14518292,5452292
10950,2020-08-15,8787,Capital Call,-142000,-9208000,14518292,5310292
10950,2020-08-15,8787,Distribution,-39,-9208000,14518253,5310253
10950,2020-09-30,8787,Value,8328630,-9208000,14518253,5310253
10950,2020-12-31,8787,Value,8825860,-9208000,14518253,5310253
10950,2021-02-14,8787,Distribution,112338,-9208000,14630591,5422591
10950,2021-03-31,8787,Value,10529340,-9208000,14630591,5422591
10950,2021-05-16,8787,Distribution,80110,-9208000,14710701,5502701
10950,2021-06-30,8787,Value,11988810,-9208000,14710701,5502701
10950,2021-09-30,8787,Value,13898550,-9208000,14710701,5502701
10972,2020-05-16,479,Capital Call,-399000,-10638000,17155445,6517445
10972,2020-05-16,479,Distribution,429170,-10638000,17584615,6946615
10972,2020-09-30,479,Value,5526440,-10638000,17584615,6946615
10972,2020-11-15,479,Distribution,2585034,-10638000,20169649,9531649
10972,2020-12-31,479,Value,3570110,-10638000,20169649,9531649
10972,2021-03-31,479,Value,3570110,-10638000,20169649,9531649
10972,2021-05-16,479,Distribution,79785,-10638000,20249434,9611434
10972,2021-06-30,479,Value,3765850,-10638000,20249434,9611434
10972,2021-09-30,479,Capital Call,-5000,-10643000,20249434,9606434
10972,2021-09-30,479,Distribution,2105124,-10643000,22354558,11711558
10972,2021-12-31,479,Value,1715650,-10643000,22354558,11711558
10983,2020-02-15,18601,Capital Call,-25097,-9867421,4484315,-5383106
10983,2020-02-15,18601,Distribution,189223,-9867421,4673538,-5193883
10983,2020-03-31,18601,Value,9513760,-9867421,4673538,-5193883
10983,2020-05-16,18601,Capital Call,-51736,-9919157,4673538,-5245619
10983,2020-05-16,18601,Distribution,902716,-9919157,5576254,-4342903
10983,2020-06-30,18601,Value,8775930,-9919157,5576254,-4342903
10983,2020-09-30,18601,Value,8945660,-9919157,5576254,-4342903
10983,2020-11-15,18601,Capital Call,-112058,-10031215,5576254,-4454961
10983,2020-11-15,18601,Distribution,839381,-10031215,6415635,-3615580
10983,2020-12-31,18601,Value,8383320,-10031215,6415635,-3615580
10983,2021-02-14,18601,Capital Call,-23112,-10054327,6415635,-3638692
10983,2021-02-14,18601,Distribution,198484,-10054327,6614119,-3440208
10983,2021-03-31,18601,Value,8371470,-10054327,6614119,-3440208
10983,2021-05-16,18601,Capital Call,-57091,-10111418,6614119,-3497299
10983,2021-05-16,18601,Distribution,295502,-10111418,6909621,-3201797
10983,2021-06-30,18601,Value,8622140,-10111418,6909621,-3201797
10985,2020-03-31,588,Value,636790,-9242527,12154657,2912130
10985,2020-06-30,588,Value,417170,-9242527,12154657,2912130
10985,2020-09-30,588,Value,544870,-9242527,12154657,2912130
10985,2020-12-31,588,Value,650890,-9242527,12154657,2912130
10985,2021-03-31,588,Value,650890,-9242527,12154657,2912130
10985,2021-06-30,588,Value,849360,-9242527,12154657,2912130
11003,2020-03-31,273,Value,893720,-8574374,9052545,478171
11003,2020-06-30,273,Value,893720,-8574374,9052545,478171
11003,2020-09-30,273,Value,893720,-8574374,9052545,478171
11003,2020-11-15,273,Distribution,53724,-8574374,9106269,531895
11003,2020-12-31,273,Value,1182970,-8574374,9106269,531895
11003,2021-03-31,273,Value,1268720,-8574374,9106269,531895
11003,2021-05-16,273,Capital Call,-20966,-8595340,9106269,510929
11003,2021-06-30,273,Value,2067670,-8595340,9106269,510929
11008,2020-02-15,46046,Capital Call,-25624,-10089689,19819978,9730289
11008,2020-02-15,46046,Distribution,1049058,-10089689,20869036,10779347
11008,2020-03-31,46046,Value,231500,-10089689,20869036,10779347
11008,2020-05-16,46046,Capital Call,-9730,-10099419,20869036,10769617
11008,2020-05-16,46046,Distribution,22795,-10099419,20891831,10792412
11008,2020-06-30,46046,Value,208930,-10099419,20891831,10792412
11008,2020-09-30,46046,Capital Call,-69564,-10168983,20891831,10722848
11008,2020-09-30,46046,Distribution,163922,-10168983,21055753,10886770
11008,2020-12-31,46046,Value,110430,-10168983,21055753,10886770
11008,2021-02-14,46046,Capital Call,-1020,-10170003,21055753,10885750
11008,2021-02-14,46046,Distribution,1020,-10170003,21056773,10886770
11008,2021-03-31,46046,Value,27070,-10170003,21056773,10886770
11008,2021-05-16,46046,Distribution,9220,-10170003,21065993,10895990
11008,2021-06-30,46046,Value,27070,-10170003,21065993,10895990
11016,2020-03-31,2017,Value,13488770,-11136661,8369294,-2767367
11016,2020-05-16,2017,Capital Call,-506584,-11643245,8369294,-3273951
11016,2020-05-16,2017,Distribution,388755,-11643245,8758049,-2885196
11016,2020-06-30,2017,Value,14046410,-11643245,8758049,-2885196
11016,2020-08-15,2017,Capital Call,328627,-11314618,8758049,-2556569
11016,2020-08-15,2017,Distribution,-247490,-11314618,8510559,-2804059
11016,2020-09-30,2017,Value,13627350,-11314618,8510559,-2804059
11016,2020-12-31,2017,Value,14868670,-11314618,8510559,-2804059
11016,2021-03-31,2017,Value,22157450,-11314618,8510559,-2804059
11016,2021-06-30,2017,Value,29451520,-11314618,8510559,-2804059
11018,2020-02-15,8547,Capital Call,-339757,-9304789,8355966,-948823
11018,2020-02-15,8547,Distribution,1297828,-9304789,9653794,349005
11018,2020-03-31,8547,Value,206650,-9304789,9653794,349005
11018,2020-06-30,8547,Value,173020,-9304789,9653794,349005
11018,2020-09-30,8547,Distribution,61823,-9304789,9715617,410828
11018,2020-12-31,8547,Value,194060,-9304789,9715617,410828
11018,2021-03-31,8547,Value,109340,-9304789,9715617,410828
11018,2021-05-16,8547,Distribution,95927,-9304789,9811544,506755
11018,2021-06-30,8547,Value,109340,-9304789,9811544,506755
11037,2020-03-31,17808,Value,7271030,-9499995,3589776,-5910219
11037,2020-06-30,17808,Value,7237670,-9499995,3589776,-5910219
11037,2020-09-30,17808,Value,7234930,-9499995,3589776,-5910219
11037,2020-12-31,17808,Value,7269930,-9499995,3589776,-5910219
11037,2021-03-31,17808,Value,7268400,-9499995,3589776,-5910219
11037,2021-06-30,17808,Value,7264400,-9499995,3589776,-5910219
11097,2020-02-15,475912,Capital Call,-28000,-13094002,20582870,7488868
11097,2020-02-15,475912,Distribution,482757,-13094002,21065627,7971625
11097,2020-03-31,475912,Value,2012540,-13094002,21065627,7971625
11097,2020-06-30,475912,Value,2045280,-13094002,21065627,7971625
11097,2020-08-15,475912,Capital Call,-10000,-13104002,21065627,7961625
11097,2020-08-15,475912,Distribution,206096,-13104002,21271723,8167721
11097,2020-09-30,475912,Value,1994420,-13104002,21271723,8167721
11097,2020-11-15,475912,Capital Call,4000,-13100002,21271723,8171721
11097,2020-11-15,475912,Distribution,343277,-13100002,21615000,8514998
11097,2020-12-31,475912,Value,1310000,-13100002,21615000,8514998
11097,2021-03-31,475912,Value,1310000,-13100002,21615000,8514998
11098,2020-12-31,599,Value,8500,-8500000,11474998,2974998
11098,2021-02-14,599,Capital Call,-40000,-8540000,11474998,2934998
11098,2021-02-14,599,Distribution,54000,-8540000,11528998,2988998
11098,2021-03-31,599,Value,119560,-8540000,11528998,2988998
11098,2021-06-30,599,Value,9390,-8540000,11528998,2988998
11098,2021-09-30,599,Value,51240,-8540000,11528998,2988998
11196,2020-02-15,725,Distribution,933333,-9840000,21626667,11786667
11196,2020-03-31,725,Value,7013330,-9840000,21626667,11786667
11196,2020-05-16,725,Distribution,4253333,-9840000,25880000,16040000
11196,2020-06-30,725,Value,4186660,-9840000,25880000,16040000
11196,2020-08-15,725,Distribution,346667,-9840000,26226667,16386667
11196,2020-09-30,725,Value,4066660,-9840000,26226667,16386667
11249,2020-03-31,13823,Value,9254940,-12286400,14550156,2263756
11249,2020-05-16,13823,Distribution,87282,-12286400,14637438,2351038
11249,2020-06-30,13823,Value,8393820,-12286400,14637438,2351038
11249,2020-09-30,13823,Value,8380450,-12286400,14637438,2351038
11249,2020-12-31,13823,Value,8373770,-12286400,14637438,2351038
11249,2021-03-31,13823,Value,9783880,-12286400,14637438,2351038
11249,2021-06-30,13823,Value,8113130,-12286400,14637438,2351038
11249,2021-08-15,13823,Capital Call,-1580592,-13866992,14637438,770446
11249,2021-09-30,13823,Value,12041630,-13866992,14637438,770446
11336,2020-02-15,12,Capital Call,-251,-9730248,7711024,-2019224
11336,2020-02-15,12,Distribution,-146,-9730248,7710878,-2019370
11336,2020-03-31,12,Value,452260,-9730248,7710878,-2019370
11336,2020-05-16,12,Capital Call,251,-9729997,7710878,-2019119
11336,2020-05-16,12,Distribution,146,-9729997,7711024,-2018973
11336,2020-06-30,12,Value,276330,-9729997,7711024,-2018973
11336,2020-09-30,12,Value,276330,-9729997,7711024,-2018973
11336,2020-11-15,12,Distribution,194600,-9729997,7905624,-1824373
11336,2020-12-31,12,Value,116760,-9729997,7905624,-1824373
11336,2021-02-14,12,Capital Call,-251,-9730248,7905624,-1824624
11336,2021-02-14,12,Distribution,-122,-9730248,7905502,-1824746
11336,2021-03-31,12,Value,124790,-9730248,7905502,-1824746
11336,2021-05-16,12,Capital Call,251,-9729997,7905502,-1824495
11336,2021-05-16,12,Distribution,122,-9729997,7905624,-1824373
11336,2021-06-30,12,Value,123570,-9729997,7905624,-1824373
11336,2021-09-30,12,Value,123570,-9729997,7905624,-1824373
11336,2021-12-31,12,Value,120650,-9729997,7905624,-1824373
11359,2020-02-15,802,Distribution,88000,-9999998,13224000,3224002
11359,2020-03-31,802,Value,2911000,-9999998,13224000,3224002
11359,2020-09-30,802,Value,3184000,-9999998,13224000,3224002
11359,2020-12-31,802,Value,3431000,-9999998,13224000,3224002
11420,2020-02-15,212,Capital Call,2857,-10971430,22942855,11971425
11420,2020-02-15,212,Distribution,837143,-10971430,23779998,12808568
11420,2020-03-31,212,Value,531420,-10971430,23779998,12808568
11420,2020-05-16,212,Distribution,-11429,-10971430,23768569,12797139
11420,2020-06-30,212,Value,739990,-10971430,23768569,12797139
11420,2020-09-30,212,Value,739990,-10971430,23768569,12797139
11420,2020-11-15,212,Distribution,517143,-10971430,24285712,13314282
11420,2020-12-31,212,Value,739990,-10971430,24285712,13314282
11420,2021-03-31,212,Value,739990,-10971430,24285712,13314282
11420,2021-06-30,212,Value,739990,-10971430,24285712,13314282
11420,2021-08-15,212,Capital Call,286,-10971144,24285712,13314568
11420,2021-09-30,212,Value,739420,-10971144,24285712,13314568
11435,2020-03-31,458,Value,2071720,-8729616,11671556,2941940
11435,2020-05-16,458,Distribution,29513,-8729616,11701069,2971453
11435,2020-06-30,458,Value,1993020,-8729616,11701069,2971453
11435,2020-08-15,458,Distribution,114829,-8729616,11815898,3086282
11435,2020-09-30,458,Value,1997210,-8729616,11815898,3086282
11435,2020-11-15,458,Distribution,158387,-8729616,11974285,3244669
11435,2020-12-31,458,Value,2314580,-8729616,11974285,3244669
11435,2021-02-14,458,Distribution,122969,-8729616,12097254,3367638
11435,2021-03-31,458,Value,2187360,-8729616,12097254,3367638
11469,2020-03-31,372,Value,359970,-9138094,15936708,6798614
11469,2020-05-16,372,Capital Call,-30677,-9168771,15936708,6767937
11469,2020-05-16,372,Distribution,245520,-9168771,16182228,7013457
11469,2020-06-30,372,Value,128610,-9168771,16182228,7013457
11469,2020-12-31,372,Value,119560,-9168771,16182228,7013457
11469,2021-03-31,372,Value,123910,-9168771,16182228,7013457
11469,2021-06-30,372,Value,123910,-9168771,16182228,7013457
11503,2020-02-15,111,Capital Call,-88000,-10030000,9248000,-782000
11503,2020-02-15,111,Distribution,1908000,-10030000,11156000,1126000
11503,2020-03-31,111,Value,4379990,-10030000,11156000,1126000
11503,2020-05-16,111,Distribution,408000,-10030000,11564000,1534000
11503,2020-06-30,111,Value,4825990,-10030000,11564000,1534000
11503,2020-08-15,111,Distribution,542000,-10030000,12106000,2076000
11503,2020-09-30,111,Value,5209990,-10030000,12106000,2076000
11503,2020-11-15,111,Distribution,532000,-10030000,12638000,2608000
11503,2020-12-31,111,Value,5093990,-10030000,12638000,2608000
11503,2021-02-14,111,Distribution,200000,-10030000,12838000,2808000
11503,2021-03-31,111,Value,5343990,-10030000,12838000,2808000
11503,2021-05-16,111,Distribution,380000,-10030000,13218000,3188000
11503,2021-06-30,111,Value,5169990,-10030000,13218000,3188000
11503,2021-08-15,111,Capital Call,600,-10029400,13218000,3188600
11503,2021-08-15,111,Distribution,670200,-10029400,13888200,3858800
11503,2021-09-30,111,Value,4435190,-10029400,13888200,3858800
11509,2020-02-15,350,Capital Call,-742,-9757151,12869172,3112021
11509,2020-02-15,350,Distribution,29943,-9757151,12899115,3141964
11509,2020-03-31,350,Value,1980750,-9757151,12899115,3141964
11509,2020-05-16,350,Capital Call,-4365,-9761516,12899115,3137599
11509,2020-05-16,350,Distribution,2733,-9761516,12901848,3140332
11509,2020-06-30,350,Value,2299320,-9761516,12901848,3140332
11509,2020-08-15,350,Capital Call,-521,-9762037,12901848,3139811
11509,2020-08-15,350,Distribution,325,-9762037,12902173,3140136
11509,2020-09-30,350,Value,2407580,-9762037,12902173,3140136
11509,2020-11-15,350,Capital Call,-3793,-9765830,12902173,3136343
11509,2020-11-15,350,Distribution,9562,-9765830,12911735,3145905
11509,2020-12-31,350,Value,1969640,-9765830,12911735,3145905
11509,2021-02-14,350,Capital Call,-2563,-9768393,12911735,3143342
11509,2021-02-14,350,Distribution,648684,-9768393,13560419,3792026
11509,2021-03-31,350,Value,1603540,-9768393,13560419,3792026
11509,2021-05-16,350,Capital Call,-1507,-9769900,13560419,3790519
11509,2021-05-16,350,Distribution,1282,-9769900,13561701,3791801
11509,2021-06-30,350,Value,1770780,-9769900,13561701,3791801
11510,2020-02-15,211,Capital Call,-663,-11952038,14503886,2551848
11510,2020-02-15,211,Distribution,350586,-11952038,14854472,2902434
11510,2020-03-31,211,Value,2640740,-11952038,14854472,2902434
11510,2020-05-16,211,Capital Call,-17317,-11969355,14854472,2885117
11510,2020-05-16,211,Distribution,474059,-11969355,15328531,3359176
11510,2020-06-30,211,Value,2510650,-11969355,15328531,3359176
11510,2020-08-15,211,Capital Call,-11,-11969366,15328531,3359165
11510,2020-08-15,211,Distribution,283285,-11969366,15611816,3642450
11510,2020-09-30,211,Value,2401430,-11969366,15611816,3642450
11510,2020-11-15,211,Capital Call,-411,-11969777,15611816,3642039
11510,2020-11-15,211,Distribution,209493,-11969777,15821309,3851532
11510,2020-12-31,211,Value,2399540,-11969777,15821309,3851532
11510,2021-02-14,211,Capital Call,2188,-11967589,15821309,3853720
11510,2021-02-14,211,Distribution,88615,-11967589,15909924,3942335
11510,2021-03-31,211,Value,2372590,-11967589,15909924,3942335
11510,2021-05-16,211,Distribution,252458,-11967589,16162382,4194793
11510,2021-06-30,211,Value,2057160,-11967589,16162382,4194793
11535,2020-03-31,144,Value,2340000,-9130000,8850000,-280000
11535,2020-06-30,144,Value,2409990,-9130000,8850000,-280000
11535,2020-08-15,144,Capital Call,-70000,-9200000,8850000,-350000
11535,2020-08-15,144,Distribution,470000,-9200000,9320000,120000
11535,2020-09-30,144,Value,1979990,-9200000,9320000,120000
11535,2020-11-15,144,Distribution,1350000,-9200000,10670000,1470000
11535,2020-12-31,144,Value,0,-9200000,10670000,1470000
11535,2021-03-31,144,Value,0,-9200000,10670000,1470000
11535,2021-06-30,144,Value,0,-9200000,10670000,1470000
11535,2021-09-30,144,Value,0,-9200000,10670000,1470000
11535,2021-12-31,144,Value,0,-9200000,10670000,1470000
11581,2020-02-15,1314,Distribution,130550,-9325000,12823737,3498737
11581,2020-03-31,1314,Value,1872450,-9325000,12823737,3498737
11581,2020-05-16,1314,Distribution,31705,-9325000,12855442,3530442
11581,2020-06-30,1314,Value,1939320,-9325000,12855442,3530442
11581,2020-08-15,1314,Capital Call,-30000,-9355000,12855442,3500442
11581,2020-08-15,1314,Distribution,30132,-9355000,12885574,3530574
11581,2020-09-30,1314,Value,2099260,-9355000,12885574,3530574
11581,2020-11-15,1314,Distribution,332102,-9355000,13217676,3862676
11581,2020-12-31,1314,Value,1935540,-9355000,13217676,3862676
11581,2021-02-14,1314,Distribution,123486,-9355000,13341162,3986162
11581,2021-03-31,1314,Value,1914030,-9355000,13341162,3986162
11581,2021-05-16,1314,Distribution,148744,-9355000,13489906,4134906
11581,2021-06-30,1314,Value,1884090,-9355000,13489906,4134906
11583,2020-02-15,1314,Capital Call,-50000,-9274999,13426989,4151990
11583,2020-02-15,1314,Distribution,386270,-9274999,13813259,4538260
11583,2020-03-31,1314,Value,4324000,-9274999,13813259,4538260
11583,2020-05-16,1314,Distribution,249497,-9274999,14062756,4787757
11583,2020-06-30,1314,Value,4762710,-9274999,14062756,4787757
11583,2020-08-15,1314,Distribution,117792,-9274999,14180548,4905549
11583,2020-09-30,1314,Value,4971400,-9274999,14180548,4905549
11583,2020-11-15,1314,Distribution,278250,-9274999,14458798,5183799
11583,2020-12-31,1314,Value,5246860,-9274999,14458798,5183799
11583,2021-02-14,1314,Capital Call,-25000,-9299999,14458798,5158799
11583,2021-02-14,1314,Distribution,417482,-9299999,14876280,5576281
11583,2021-03-31,1314,Value,5268450,-9299999,14876280,5576281
11583,2021-05-16,1314,Distribution,392460,-9299999,15268740,5968741
11583,2021-06-30,1314,Value,5393070,-9299999,15268740,5968741
11583,2021-08-15,1314,Distribution,-604500,-9299999,14664240,5364241
11583,2021-09-30,1314,Value,5303790,-9299999,14664240,5364241
11601,2020-02-15,2562,Distribution,275400,-8500000,15117250,6617250
11601,2020-03-31,2562,Value,2736150,-8500000,15117250,6617250
11601,2020-06-30,2562,Value,2173450,-8500000,15117250,6617250
11601,2020-08-15,2562,Distribution,369750,-8500000,15487000,6987000
11601,2020-09-30,2562,Value,1938000,-8500000,15487000,6987000
11602,2020-02-15,2562,Distribution,453050,-8500000,6882450,-1617550
11602,2020-03-31,2562,Value,2251650,-8500000,6882450,-1617550
11602,2020-06-30,2562,Value,2292450,-8500000,6882450,-1617550
11602,2020-08-15,2562,Distribution,2550,-8500000,6885000,-1615000
11602,2020-09-30,2562,Value,1836000,-8500000,6885000,-1615000
11602,2021-02-14,2562,Distribution,340000,-8500000,7225000,-1275000
11602,2021-06-30,2562,Value,1130500,-8500000,7225000,-1275000
11623,2020-03-31,2129,Value,0,-10000000,18000000,8000000
11623,2020-06-30,2129,Value,0,-10000000,18000000,8000000
11623,2020-09-30,2129,Value,0,-10000000,18000000,8000000
11623,2020-12-31,2129,Value,0,-10000000,18000000,8000000
11623,2021-03-31,2129,Value,0,-10000000,18000000,8000000
11623,2021-06-30,2129,Value,0,-10000000,18000000,8000000
11623,2021-09-30,2129,Value,0,-10000000,18000000,8000000
11623,2021-12-31,2129,Value,0,-10000000,18000000,8000000
11631,2020-03-31,140,Capital Call,-28000,-13199334,17856001,4656667
11631,2020-03-31,140,Distribution,112667,-13199334,17968668,4769334
11631,2020-06-30,140,Value,660660,-13199334,17968668,4769334
11631,2020-09-30,140,Value,622000,-13199334,17968668,4769334
11631,2020-12-31,140,Value,642000,-13199334,17968668,4769334
11631,2021-03-31,140,Value,855330,-13199334,17968668,4769334
11631,2021-06-30,140,Value,1311330,-13199334,17968668,4769334
11651,2020-03-31,124,Value,1428760,-9444479,13036868,3592389
11651,2020-05-16,124,Capital Call,-166110,-9610589,13036868,3426279
11651,2020-06-30,124,Value,1570310,-9610589,13036868,3426279
11651,2020-09-30,124,Value,1666160,-9610589,13036868,3426279
11651,2020-12-31,124,Value,1829390,-9610589,13036868,3426279
11651,2021-03-31,124,Value,1784340,-9610589,13036868,3426279
11651,2021-06-30,124,Value,1953470,-9610589,13036868,3426279
11651,2021-09-30,124,Value,1994340,-9610589,13036868,3426279
11776,2020-03-31,14497,Value,753490,-9850000,48354355,38504355
11776,2020-06-30,14497,Value,664220,-9850000,48354355,38504355
11776,2020-09-30,14497,Value,689330,-9850000,48354355,38504355
11776,2020-12-31,14497,Value,1069890,-9850000,48354355,38504355
11776,2021-03-31,14497,Value,1558980,-9850000,48354355,38504355
11776,2021-06-30,14497,Value,1667520,-9850000,48354355,38504355
11793,2020-03-31,80,Value,0,-7800000,9828000,2028000
11793,2020-06-30,80,Value,0,-7800000,9828000,2028000
11793,2020-09-30,80,Value,0,-7800000,9828000,2028000
11793,2020-12-31,80,Value,0,-7800000,9828000,2028000
11793,2021-03-31,80,Value,0,-7800000,9828000,2028000
11793,2021-06-30,80,Value,0,-7800000,9828000,2028000
11793,2021-09-30,80,Value,0,-7800000,9828000,2028000
11793,2021-12-31,80,Value,0,-7800000,9828000,2028000
11795,2020-03-31,661,Value,831680,-11018302,12412499,1394197
11795,2020-06-30,661,Value,898040,-11018302,12412499,1394197
11795,2020-09-30,661,Value,948490,-11018302,12412499,1394197
11795,2020-12-31,661,Value,1019840,-11018302,12412499,1394197
11795,2021-03-31,661,Value,942210,-11018302,12412499,1394197
11800,2020-02-15,1360,Capital Call,-6667,-9286669,11666665,2379996
11800,2020-03-31,1360,Value,166660,-9286669,11666665,2379996
11800,2020-05-16,1360,Capital Call,6667,-9280002,11666665,2386663
11800,2020-06-30,1360,Value,166660,-9280002,11666665,2386663
11800,2020-09-30,1360,Value,166660,-9280002,11666665,2386663
11800,2020-12-31,1360,Value,166660,-9280002,11666665,2386663
11800,2021-02-14,1360,Distribution,113333,-9280002,11779998,2499996
11800,2021-03-31,1360,Value,166660,-9280002,11779998,2499996
11800,2021-06-30,1360,Value,166660,-9280002,11779998,2499996
11852,2020-02-15,5782,Capital Call,-9021,-9512986,9037612,-475374
11852,2020-03-31,5782,Value,5835320,-9512986,9037612,-475374
11852,2020-05-16,5782,Capital Call,-131606,-9644592,9037612,-606980
11852,2020-05-16,5782,Distribution,798441,-9644592,9836053,191461
11852,2020-06-30,5782,Value,5159460,-9644592,9836053,191461
11852,2020-08-15,5782,Capital Call,-5745,-9650337,9836053,185716
11852,2020-08-15,5782,Distribution,348238,-9650337,10184291,533954
11852,2020-09-30,5782,Value,4240830,-9650337,10184291,533954
11852,2020-11-15,5782,Capital Call,-69716,-9720053,10184291,464238
11852,2020-11-15,5782,Distribution,210196,-9720053,10394487,674434
11852,2020-12-31,5782,Value,4377530,-9720053,10394487,674434
11852,2021-02-14,5782,Capital Call,-8119,-9728172,10394487,666315
11852,2021-03-31,5782,Value,4912940,-9728172,10394487,666315
11852,2021-05-16,5782,Capital Call,589052,-9139120,10394487,1255367
11852,2021-06-30,5782,Value,5415200,-9139120,10394487,1255367
11855,2020-02-15,5782,Capital Call,-35007,-12285429,11488328,-797101
11855,2020-02-15,5782,Distribution,686116,-12285429,12174444,-110985
11855,2020-03-31,5782,Value,11760540,-12285429,12174444,-110985
11855,2020-05-16,5782,Capital Call,-11482,-12296911,12174444,-122467
11855,2020-05-16,5782,Distribution,476614,-12296911,12651058,354147
11855,2020-06-30,5782,Value,11283920,-12296911,12651058,354147
11855,2020-08-15,5782,Capital Call,-77519,-12374430,12651058,276628
11855,2020-08-15,5782,Distribution,1368167,-12374430,14019225,1644795
11855,2020-09-30,5782,Value,9694990,-12374430,14019225,1644795
11855,2020-11-15,5782,Capital Call,-11482,-12385912,14019225,1633313
11855,2020-11-15,5782,Distribution,665238,-12385912,14684463,2298551
11855,2020-12-31,5782,Value,10597250,-12385912,14684463,2298551
11855,2021-02-14,5782,Capital Call,-36211,-12422123,14684463,2262340
11855,2021-02-14,5782,Distribution,1541316,-12422123,16225779,3803656
11855,2021-03-31,5782,Value,11310810,-12422123,16225779,3803656
11855,2021-05-16,5782,Capital Call,748333,-11673790,16225779,4551989
11855,2021-06-30,5782,Value,12910000,-11673790,16225779,4551989
11859,2020-03-31,289,Value,1101430,-10516650,4964342,-5552308
11859,2020-05-16,289,Distribution,13136,-10516650,4977478,-5539172
11859,2020-06-30,289,Value,912440,-10516650,4977478,-5539172
11859,2020-09-30,289,Value,769800,-10516650,4977478,-5539172
11859,2020-11-15,289,Distribution,69671,-10516650,5047149,-5469501
11859,2020-12-31,289,Value,539920,-10516650,5047149,-5469501
11859,2021-03-31,289,Value,560670,-10516650,5047149,-5469501
11895,2020-02-15,7,Distribution,11880,-9900000,12660120,2760120
11895,2020-03-31,7,Value,2999700,-9900000,12660120,2760120
11895,2020-05-16,7,Distribution,1980,-9900000,12662100,2762100
11895,2020-06-30,7,Value,3628350,-9900000,12662100,2762100
11895,2020-08-15,7,Capital Call,-25000,-9925000,12662100,2737100
11895,2020-08-15,7,Distribution,299950,-9925000,12962050,3037050
11895,2020-09-30,7,Value,3690110,-9925000,12962050,3037050
11919,2020-03-31,920,Value,8771160,-10080034,9535206,-544828
11919,2020-06-30,920,Value,8705820,-10080034,9535206,-544828
11919,2020-09-30,920,Value,8976590,-10080034,9535206,-544828
11919,2020-11-15,920,Distribution,1178755,-10080034,10713961,633927
11919,2020-12-31,920,Value,8321090,-10080034,10713961,633927
11919,2021-12-31,920,Value,0,-10080034,10713961,633927
11923,2020-02-14,7949,Capital Call,-50000,-11360000,7012201,-4347799
11923,2020-02-14,7949,Distribution,31000,-11360000,7043201,-4316799
11923,2020-06-30,7949,Value,2272000,-11360000,7043201,-4316799
11923,2020-09-30,7949,Capital Call,-50000,-11410000,7043201,-4366799
11923,2020-09-30,7949,Distribution,1172000,-11410000,8215201,-3194799
11923,2020-12-31,7949,Value,1483300,-11410000,8215201,-3194799
11923,2021-03-31,7949,Value,1369200,-11410000,8215201,-3194799
11923,2021-06-30,7949,Value,1369200,-11410000,8215201,-3194799
11930,2021-12-31,545,Value,0,-13333481,6721407,-6612074
11962,2020-02-15,475912,Capital Call,-13540,-10967724,18852459,7884735
11962,2020-02-15,475912,Distribution,614403,-10967724,19466862,8499138
11962,2020-03-31,475912,Value,821340,-10967724,19466862,8499138
11962,2020-07-01,475912,Capital Call,-8714,-10976438,19466862,8490424
11962,2020-07-01,475912,Distribution,27540,-10976438,19494402,8517964
11962,2020-09-30,475912,Value,1223670,-10976438,19494402,8517964
11963,2020-03-31,7252,Value,3458090,-7968246,11132553,3164307
11963,2020-05-16,7252,Capital Call,-125159,-8093405,11132553,3039148
11963,2020-05-16,7252,Distribution,202826,-8093405,11335379,3241974
11963,2020-06-30,7252,Value,5088510,-8093405,11335379,3241974
11963,2020-08-15,7252,Capital Call,-29548,-8122953,11335379,3212426
11963,2020-08-15,7252,Distribution,649003,-8122953,11984382,3861429
11963,2020-09-30,7252,Value,4736280,-8122953,11984382,3861429
11963,2020-12-31,7252,Value,5514400,-8122953,11984382,3861429
11963,2021-02-14,7252,Capital Call,-128748,-8251701,11984382,3732681
11963,2021-02-14,7252,Distribution,576644,-8251701,12561026,4309325
11963,2021-03-31,7252,Value,5785760,-8251701,12561026,4309325
11963,2021-05-16,7252,Capital Call,-11197,-8262898,12561026,4298128
11963,2021-05-16,7252,Distribution,269644,-8262898,12830670,4567772
11963,2021-06-30,7252,Value,6631880,-8262898,12830670,4567772
11965,2020-02-15,888,Capital Call,-11000,-10721998,12318667,1596669
11965,2020-02-15,888,Distribution,33000,-10721998,12351667,1629669
11965,2020-03-31,888,Value,3968330,-10721998,12351667,1629669
11965,2020-05-16,888,Capital Call,-11000,-10732998,12351667,1618669
11965,2020-05-16,888,Distribution,17333,-10732998,12369000,1636002
11965,2020-06-30,888,Value,3952330,-10732998,12369000,1636002
11965,2020-08-15,888,Capital Call,-16000,-10748998,12369000,1620002
11965,2020-09-30,888,Value,3260000,-10748998,12369000,1620002
11965,2020-11-15,888,Capital Call,-11000,-10759998,12369000,1609002
11965,2020-11-15,888,Distribution,46000,-10759998,12415000,1655002
11965,2020-12-31,888,Value,3168000,-10759998,12415000,1655002
11965,2021-02-14,888,Capital Call,-11000,-10770998,12415000,1644002
11965,2021-03-31,888,Value,2876660,-10770998,12415000,1644002
11965,2021-05-16,888,Capital Call,-11000,-10781998,12415000,1633002
11965,2021-06-30,888,Value,3282000,-10781998,12415000,1633002
12071,2020-02-14,617,Distribution,1119,-9652597,13500121,3847524
12071,2020-09-30,617,Value,0,-9652597,13500121,3847524
12071,2020-12-31,617,Value,0,-9652597,13500121,3847524
12071,2021-03-31,617,Value,0,-9652597,13500121,3847524
12071,2021-06-30,617,Value,0,-9652597,13500121,3847524
12071,2021-09-30,617,Value,0,-9652597,13500121,3847524
12071,2021-12-31,617,Value,0,-9652597,13500121,3847524
12075,2020-01-15,26707,Capital Call,0,-11384368,3976704,-7407664
12075,2020-01-15,26707,Distribution,0,-11384368,3976704,-7407664
12075,2020-02-29,26707,Value,4588540,-11384368,3976704,-7407664
12075,2020-04-15,26707,Capital Call,0,-11384368,3976704,-7407664
12075,2020-04-15,26707,Distribution,0,-11384368,3976704,-7407664
12075,2020-05-31,26707,Value,3671310,-11384368,3976704,-7407664
12075,2020-08-31,26707,Value,3941490,-11384368,3976704,-7407664
12075,2020-11-30,26707,Value,4355160,-11384368,3976704,-7407664
12075,2021-02-28,26707,Value,4355160,-11384368,3976704,-7407664
12075,2021-05-31,26707,Value,4440320,-11384368,3976704,-7407664
12075,2021-08-31,26707,Value,5209880,-11384368,3976704,-7407664
12075,2021-10-16,26707,Capital Call,0,-11384368,3976704,-7407664
12075,2021-10-16,26707,Distribution,0,-11384368,3976704,-7407664
12075,2021-11-30,26707,Value,5569090,-11384368,3976704,-7407664
12124,2020-03-31,8512,Value,865560,-9527000,16689133,7162133
12124,2020-05-16,8512,Distribution,169996,-9527000,16859129,7332129
12124,2020-06-30,8512,Value,724310,-9527000,16859129,7332129
12124,2020-09-30,8512,Value,729190,-9527000,16859129,7332129
12124,2020-12-31,8512,Value,747100,-9527000,16859129,7332129
12124,2021-02-14,8512,Distribution,164974,-9527000,17024103,7497103
12124,2021-03-31,8512,Value,544900,-9527000,17024103,7497103
12124,2021-06-30,8512,Value,546580,-9527000,17024103,7497103
12134,2020-02-15,2147,Capital Call,7500,-10475000,14045000,3570000
12134,2020-02-15,2147,Distribution,1885000,-10475000,15930000,5455000
12134,2020-03-31,2147,Value,1062490,-10475000,15930000,5455000
12134,2020-05-16,2147,Distribution,-385000,-10475000,15545000,5070000
12134,2020-06-30,2147,Value,1227490,-10475000,15545000,5070000
12134,2020-09-30,2147,Value,1342500,-10475000,15545000,5070000
12134,2020-11-15,2147,Capital Call,-15000,-10490000,15545000,5055000
12134,2020-11-15,2147,Distribution,32500,-10490000,15577500,5087500
12134,2020-12-31,2147,Value,1482490,-10490000,15577500,5087500
12134,2021-02-14,2147,Distribution,200000,-10490000,15777500,5287500
12134,2021-03-31,2147,Value,1354990,-10490000,15777500,5287500
12134,2021-05-16,2147,Distribution,255000,-10490000,16032500,5542500
12134,2021-06-30,2147,Value,1154990,-10490000,16032500,5542500
12134,2021-08-15,2147,Capital Call,-1250,-10491250,16032500,5541250
12134,2021-08-15,2147,Distribution,353500,-10491250,16386000,5894750
12134,2021-09-30,2147,Value,832990,-10491250,16386000,5894750
12143,2020-02-15,7626,Capital Call,-158130,-10748283,19989268,9240985
12143,2020-03-31,7626,Value,5484150,-10748283,19989268,9240985
12143,2020-06-30,7626,Value,6666460,-10748283,19989268,9240985
12143,2020-08-15,7626,Distribution,1052771,-10748283,21042039,10293756
12143,2020-09-30,7626,Value,6903490,-10748283,21042039,10293756
12143,2020-11-15,7626,Capital Call,-100045,-10848328,21042039,10193711
12143,2020-11-15,7626,Distribution,449516,-10848328,21491555,10643227
12143,2020-12-31,7626,Value,7907400,-10848328,21491555,10643227
12158,2020-02-15,18,Capital Call,-11,-9740237,19332398,9592161
12158,2020-02-15,18,Distribution,171492,-9740237,19503890,9763653
12158,2020-03-31,18,Value,6247680,-9740237,19503890,9763653
12158,2020-05-16,18,Distribution,1376340,-9740237,20880230,11139993
12158,2020-06-30,18,Value,6729370,-9740237,20880230,11139993
12158,2020-08-15,18,Distribution,853488,-9740237,21733718,11993481
12158,2020-09-30,18,Value,5694520,-9740237,21733718,11993481
12158,2020-11-15,18,Distribution,449674,-9740237,22183392,12443155
12158,2020-12-31,18,Value,6537310,-9740237,22183392,12443155
12158,2021-03-31,18,Value,6806160,-9740237,22183392,12443155
12158,2021-05-16,18,Capital Call,226,-9740011,22183392,12443381
12158,2021-05-16,18,Distribution,-514,-9740011,22182878,12442867
12158,2021-06-30,18,Value,6824190,-9740011,22182878,12442867
12158,2021-09-30,18,Value,8123290,-9740011,22182878,12442867
12196,2020-02-15,812,Capital Call,-8562,-9710810,12348742,2637932
12196,2020-02-15,812,Distribution,97032,-9710810,12445774,2734964
12196,2020-03-31,812,Value,1379370,-9710810,12445774,2734964
12196,2020-05-16,812,Capital Call,-7610,-9718420,12445774,2727354
12196,2020-05-16,812,Distribution,119863,-9718420,12565637,2847217
12196,2020-06-30,812,Value,1069250,-9718420,12565637,2847217
12196,2020-08-15,812,Capital Call,-7610,-9726030,12565637,2839607
12196,2020-08-15,812,Distribution,15221,-9726030,12580858,2854828
12196,2020-09-30,812,Value,1102540,-9726030,12580858,2854828
12196,2020-11-15,812,Capital Call,-7610,-9733640,12580858,2847218
12196,2020-11-15,812,Distribution,65639,-9733640,12646497,2912857
12196,2020-12-31,812,Value,1104450,-9733640,12646497,2912857
12196,2021-02-14,812,Capital Call,-6659,-9740299,12646497,2906198
12196,2021-02-14,812,Distribution,56126,-9740299,12702623,2962324
12196,2021-03-31,812,Value,1190060,-9740299,12702623,2962324
12196,2021-05-16,812,Capital Call,-7610,-9747909,12702623,2954714
12196,2021-05-16,812,Distribution,103691,-9747909,12806314,3058405
12196,2021-06-30,812,Value,1108250,-9747909,12806314,3058405
12212,2020-02-15,812,Capital Call,-10811,-9081082,15386486,6305404
12212,2020-02-15,812,Distribution,372973,-9081082,15759459,6678377
12212,2020-03-31,812,Value,4975670,-9081082,15759459,6678377
12212,2020-05-16,812,Distribution,327027,-9081082,16086486,7005404
12212,2020-06-30,812,Value,4113510,-9081082,16086486,7005404
12212,2020-08-15,812,Capital Call,-18919,-9100001,16086486,6986485
12212,2020-08-15,812,Distribution,521622,-9100001,16608108,7508107
12212,2020-09-30,812,Value,4172970,-9100001,16608108,7508107
12212,2020-11-15,812,Capital Call,-10811,-9110812,16608108,7497296
12212,2020-11-15,812,Distribution,1105405,-9110812,17713513,8602701
12212,2020-12-31,812,Value,3067560,-9110812,17713513,8602701
12212,2021-02-14,812,Capital Call,-8108,-9118920,17713513,8594593
12212,2021-02-14,812,Distribution,262162,-9118920,17975675,8856755
12212,2021-03-31,812,Value,4662160,-9118920,17975675,8856755
12212,2021-05-16,812,Capital Call,-8108,-9127028,17975675,8848647
12212,2021-05-16,812,Distribution,243243,-9127028,18218918,9091890
12212,2021-06-30,812,Value,6172970,-9127028,18218918,9091890
12213,2020-02-15,812,Capital Call,-3360,-4586691,5635080,1048389
12213,2020-03-31,812,Value,900530,-4586691,5635080,1048389
12213,2020-05-16,812,Capital Call,-6720,-4593411,5635080,1041669
12213,2020-06-30,812,Value,756040,-4593411,5635080,1041669
12213,2020-08-15,812,Capital Call,-3360,-4596771,5635080,1038309
12213,2020-08-15,812,Distribution,20161,-4596771,5655241,1058470
12213,2020-09-30,812,Value,762760,-4596771,5655241,1058470
12213,2020-11-15,812,Capital Call,-3360,-4600131,5655241,1055110
12213,2020-11-15,812,Distribution,10081,-4600131,5665322,1065191
12213,2020-12-31,812,Value,816530,-4600131,5665322,1065191
12213,2021-02-14,812,Distribution,10081,-4600131,5675403,1075272
12213,2021-03-31,812,Value,877010,-4600131,5675403,1075272
12213,2021-05-16,812,Capital Call,-6720,-4606851,5675403,1068552
12213,2021-06-30,812,Value,700600,-4606851,5675403,1068552
12228,2020-02-15,18,Capital Call,-1466,-9593006,17853869,8260863
12228,2020-02-15,18,Distribution,2729,-9593006,17856598,8263592
12228,2020-03-31,18,Value,4918890,-9593006,17856598,8263592
12228,2020-05-16,18,Distribution,319343,-9593006,18175941,8582935
12228,2020-06-30,18,Value,5138870,-9593006,18175941,8582935
12228,2020-08-15,18,Distribution,180581,-9593006,18356522,8763516
12228,2020-09-30,18,Value,5160710,-9593006,18356522,8763516
12228,2020-12-31,18,Value,5504130,-9593006,18356522,8763516
12228,2021-03-31,18,Value,6753450,-9593006,18356522,8763516
12228,2021-05-16,18,Capital Call,7,-9592999,18356522,8763523
12228,2021-05-16,18,Distribution,-14,-9592999,18356508,8763509
12228,2021-06-30,18,Value,7000650,-9592999,18356508,8763509
12228,2021-09-30,18,Value,7303970,-9592999,18356508,8763509
12229,2020-02-15,6506,Capital Call,0,-9889687,6983805,-2905882
12229,2020-02-15,6506,Distribution,0,-9889687,6983805,-2905882
12229,2020-03-31,6506,Value,4549340,-9889687,6983805,-2905882
12229,2020-05-16,6506,Capital Call,0,-9889687,6983805,-2905882
12229,2020-05-16,6506,Distribution,0,-9889687,6983805,-2905882
12229,2020-06-30,6506,Value,4657500,-9889687,6983805,-2905882
12229,2020-09-30,6506,Value,4679080,-9889687,6983805,-2905882
12229,2020-11-15,6506,Capital Call,-60428,-9950115,6983805,-2966310
12229,2020-11-15,6506,Distribution,102703,-9950115,7086508,-2863607
12229,2020-12-31,6506,Value,4656740,-9950115,7086508,-2863607
12229,2021-03-31,6506,Value,4854200,-9950115,7086508,-2863607
12229,2021-05-16,6506,Capital Call,-99199,-10049314,7086508,-2962806
12229,2021-05-16,6506,Distribution,4835000,-10049314,11921508,1872194
12229,2021-06-30,6506,Value,21030,-10049314,11921508,1872194
12229,2021-09-30,6506,Value,19950,-10049314,11921508,1872194
12230,2020-03-31,2067,Value,0,-9999999,83393986,73393987
12230,2020-06-30,2067,Value,0,-9999999,83393986,73393987
12230,2020-09-30,2067,Value,0,-9999999,83393986,73393987
12230,2020-12-31,2067,Value,0,-9999999,83393986,73393987
12230,2021-12-31,2067,Value,0,-9999999,83393986,73393987
12245,2020-02-15,710,Capital Call,-260000,-11556000,16816356,5260356
12245,2020-02-15,710,Distribution,1123179,-11556000,17939535,6383535
12245,2020-03-31,710,Value,4403990,-11556000,17939535,6383535
12245,2020-05-16,710,Capital Call,251745,-11304255,17939535,6635280
12245,2020-05-16,710,Distribution,-391278,-11304255,17548257,6244002
12245,2020-06-30,710,Value,5277270,-11304255,17548257,6244002
12245,2020-09-30,710,Value,5939530,-11304255,17548257,6244002
12245,2020-11-15,710,Distribution,2599979,-11304255,20148236,8843981
12245,2020-12-31,710,Value,4402790,-11304255,20148236,8843981
12245,2021-02-14,710,Distribution,543351,-11304255,20691587,9387332
12245,2021-03-31,710,Value,6127750,-11304255,20691587,9387332
12245,2021-05-16,710,Capital Call,613255,-10691000,20691587,10000587
12245,2021-05-16,710,Distribution,-1122779,-10691000,19568808,8877808
12245,2021-06-30,710,Value,6843300,-10691000,19568808,8877808
12247,2020-02-15,375,Distribution,1586444,-9743357,14800788,5057431
12247,2020-03-31,375,Value,10434500,-9743357,14800788,5057431
12247,2020-05-16,375,Distribution,778924,-9743357,15579712,5836355
12247,2020-06-30,375,Value,11506810,-9743357,15579712,5836355
12247,2020-08-15,375,Distribution,399771,-9743357,15979483,6236126
12247,2020-09-30,375,Value,12665980,-9743357,15979483,6236126
12247,2020-11-15,375,Distribution,1120698,-9743357,17100181,7356824
12247,2020-12-31,375,Value,16124660,-9743357,17100181,7356824
12247,2021-02-14,375,Distribution,1350797,-9743357,18450978,8707621
12247,2021-03-31,375,Value,18573770,-9743357,18450978,8707621
12247,2021-05-16,375,Distribution,2075092,-9743357,20526070,10782713
12247,2021-06-30,375,Value,18739650,-9743357,20526070,10782713
12250,2020-03-31,12055,Value,4062840,-10072804,5361452,-4711352
12250,2020-05-16,12055,Distribution,2079354,-10072804,7440806,-2631998
12250,2020-06-30,12055,Value,2162880,-10072804,7440806,-2631998
12250,2020-09-30,12055,Value,2081410,-10072804,7440806,-2631998
12250,2020-11-15,12055,Distribution,91997,-10072804,7532803,-2540001
12250,2020-12-31,12055,Value,1882540,-10072804,7532803,-2540001
12250,2021-06-30,12055,Value,1890270,-10072804,7532803,-2540001
12283,2020-02-15,9110,Capital Call,-5335,-9990336,20780781,10790445
12283,2020-02-15,9110,Distribution,3072574,-9990336,23853355,13863019
12283,2020-03-31,9110,Value,6604660,-9990336,23853355,13863019
12283,2020-05-16,9110,Capital Call,-11665,-10002001,23853355,13851354
12283,2020-05-16,9110,Distribution,4102234,-10002001,27955589,17953588
12283,2020-06-30,9110,Value,2862570,-10002001,27955589,17953588
12283,2020-08-15,9110,Capital Call,-5000,-10007001,27955589,17948588
12283,2020-08-15,9110,Distribution,675438,-10007001,28631027,18624026
12283,2020-09-30,9110,Value,2304610,-10007001,28631027,18624026
12283,2020-11-15,9110,Capital Call,-1910,-10008911,28631027,18622116
12283,2020-11-15,9110,Distribution,281259,-10008911,28912286,18903375
12283,2020-12-31,9110,Value,2130040,-10008911,28912286,18903375
12283,2021-02-14,9110,Capital Call,-20593,-10029504,28912286,18882782
12283,2021-02-14,9110,Distribution,404461,-10029504,29316747,19287243
12283,2021-03-31,9110,Value,1650160,-10029504,29316747,19287243
12283,2021-05-16,9110,Capital Call,-496,-10030000,29316747,19286747
12283,2021-05-16,9110,Distribution,1945,-10030000,29318692,19288692
12283,2021-06-30,9110,Value,1705100,-10030000,29318692,19288692
12283,2021-08-15,9110,Capital Call,-1000,-10031000,29318692,19287692
12283,2021-08-15,9110,Distribution,62106,-10031000,29380798,19349798
12283,2021-09-30,9110,Value,1435430,-10031000,29380798,19349798
12288,2020-03-31,814,Value,1490180,-10775000,20056585,9281585
12288,2020-06-30,814,Value,1427680,-10775000,20056585,9281585
12288,2020-09-30,814,Value,1353340,-10775000,20056585,9281585
12288,2020-11-15,814,Distribution,265065,-10775000,20321650,9546650
12288,2020-12-31,814,Value,1117360,-10775000,20321650,9546650
12288,2021-02-14,814,Distribution,205803,-10775000,20527453,9752453
12288,2021-03-31,814,Value,972980,-10775000,20527453,9752453
12288,2021-06-30,814,Value,989140,-10775000,20527453,9752453
12288,2021-09-30,814,Value,1196020,-10775000,20527453,9752453
12296,2020-03-31,541,Value,117950,-9580165,4986401,-4593764
12296,2020-06-30,541,Value,117540,-9580165,4986401,-4593764
12296,2020-08-15,541,Distribution,133140,-9580165,5119541,-4460624
12296,2020-09-30,541,Value,0,-9580165,5119541,-4460624
12296,2021-03-31,541,Value,0,-9580165,5119541,-4460624
12296,2021-06-30,541,Value,0,-9580165,5119541,-4460624
12296,2021-09-30,541,Value,0,-9580165,5119541,-4460624
12296,2021-12-31,541,Value,0,-9580165,5119541,-4460624
12323,2020-03-31,1430,Value,1766890,-9900000,12286899,2386899
12323,2020-06-30,1430,Value,2004130,-9900000,12286899,2386899
12323,2020-09-30,1430,Value,2099310,-9900000,12286899,2386899
12323,2020-12-31,1430,Value,2066200,-9900000,12286899,2386899
12323,2021-03-31,1430,Value,2202750,-9900000,12286899,2386899
12323,2021-06-30,1430,Value,2197930,-9900000,12286899,2386899
12333,2020-03-31,11164,Value,302580,-9556829,6834455,-2722374
12333,2020-06-30,11164,Value,300750,-9556829,6834455,-2722374
12333,2020-09-30,11164,Value,296490,-9556829,6834455,-2722374
12333,2020-12-31,11164,Value,291880,-9556829,6834455,-2722374
12333,2021-03-31,11164,Value,290110,-9556829,6834455,-2722374
12333,2021-05-16,11164,Distribution,278787,-9556829,7113242,-2443587
12333,2021-06-30,11164,Value,0,-9556829,7113242,-2443587
12333,2021-12-31,11164,Value,0,-9556829,7113242,-2443587
12358,2020-03-31,1632,Value,103030,-10305119,41933108,31627989
12358,2020-06-30,1632,Value,103730,-10305119,41933108,31627989
12358,2020-12-31,1632,Value,112010,-10305119,41933108,31627989
12358,2021-03-31,1632,Value,112540,-10305119,41933108,31627989
12358,2021-12-31,1632,Value,0,-10305119,41933108,31627989
12374,2020-03-31,633,Value,9935920,-10294203,461223,-9832980
12374,2020-06-30,633,Value,10038860,-10294203,461223,-9832980
12374,2020-09-30,633,Value,13024180,-10294203,461223,-9832980
12374,2020-12-31,633,Value,22288960,-10294203,461223,-9832980
12374,2021-03-31,633,Value,18685990,-10294203,461223,-9832980
12374,2021-05-16,633,Distribution,984935,-10294203,1446158,-8848045
12374,2021-06-30,633,Value,22333450,-10294203,1446158,-8848045
12386,2020-03-31,15275,Value,286010,-9418009,20412762,10994753
12386,2020-05-16,15275,Distribution,187013,-9418009,20599775,11181766
12386,2020-06-30,15275,Value,230070,-9418009,20599775,11181766
12386,2020-09-30,15275,Value,262680,-9418009,20599775,11181766
12386,2020-12-31,15275,Value,331410,-9418009,20599775,11181766
12386,2021-02-14,15275,Distribution,87823,-9418009,20687598,11269589
12386,2021-03-31,15275,Value,285490,-9418009,20687598,11269589
12397,2021-12-31,23146,Value,0,-10041253,188652,-9852601
12403,2020-03-31,916,Value,810850,-10439278,12791274,2351996
12403,2020-05-16,916,Capital Call,-112556,-10551834,12791274,2239440
12403,2020-05-16,916,Distribution,660785,-10551834,13452059,2900225
12403,2020-06-30,916,Value,109920,-10551834,13452059,2900225
12403,2020-09-30,916,Value,108940,-10551834,13452059,2900225
12403,2020-12-31,916,Value,21860,-10551834,13452059,2900225
12403,2021-03-31,916,Value,47460,-10551834,13452059,2900225
12407,2020-03-31,268,Value,4230000,-10000000,5240001,-4759999
12407,2020-06-30,268,Value,4340000,-10000000,5240001,-4759999
12407,2020-09-30,268,Value,4480000,-10000000,5240001,-4759999
12407,2020-11-15,268,Distribution,270000,-10000000,5510001,-4489999
12407,2020-12-31,268,Value,3200000,-10000000,5510001,-4489999
12407,2021-02-14,268,Capital Call,-40000,-10040000,5510001,-4529999
12407,2021-02-14,268,Distribution,2220000,-10040000,7730001,-2309999
12407,2021-03-31,268,Value,979990,-10040000,7730001,-2309999
12407,2021-06-30,268,Value,0,-10040000,7730001,-2309999
12407,2021-09-30,268,Value,0,-10040000,7730001,-2309999
12415,2020-03-31,2102,Value,8008580,-10465999,9547083,-918916
12415,2020-05-16,2102,Capital Call,-5969,-10471968,9547083,-924885
12415,2020-05-16,2102,Distribution,1107980,-10471968,10655063,183095
12415,2020-06-30,2102,Value,6841400,-10471968,10655063,183095
12415,2020-09-30,2102,Distribution,1852302,-10471968,12507365,2035397
12415,2020-12-31,2102,Value,4359570,-10471968,12507365,2035397
12415,2021-03-31,2102,Value,4197640,-10471968,12507365,2035397
12415,2021-06-30,2102,Value,3871090,-10471968,12507365,2035397
12730,2020-03-31,6388,Capital Call,-350000,-9400000,5284295,-4115705
12730,2020-03-31,6388,Distribution,-1495,-9400000,5282800,-4117200
12730,2020-06-30,6388,Value,8544600,-9400000,5282800,-4117200
12730,2020-09-30,6388,Value,9982800,-9400000,5282800,-4117200
12730,2020-11-15,6388,Distribution,300800,-9400000,5583600,-3816400
12730,2020-12-31,6388,Value,9983740,-9400000,5583600,-3816400
12730,2021-02-14,6388,Distribution,2500400,-9400000,8084000,-1316000
12730,2021-03-31,6388,Value,8666800,-9400000,8084000,-1316000
12730,2021-05-16,6388,Distribution,5198200,-9400000,13282200,3882200
12730,2021-06-30,6388,Value,3412200,-9400000,13282200,3882200
12730,2021-09-30,6388,Value,3515600,-9400000,13282200,3882200
12730,2021-11-15,6388,Distribution,742600,-9400000,14024800,4624800
12730,2021-12-31,6388,Value,2265400,-9400000,14024800,4624800
12736,2020-02-15,741,Capital Call,-4699,-9500000,11784713,2284713
12736,2020-02-15,741,Distribution,5736,-9500000,11790449,2290449
12736,2020-03-31,741,Value,1368000,-9500000,11790449,2290449
12736,2020-05-16,741,Distribution,-10450,-9500000,11779999,2279999
12736,2020-06-30,741,Value,1434500,-9500000,11779999,2279999
12736,2020-09-30,741,Value,1995000,-9500000,11779999,2279999
12736,2020-11-15,741,Capital Call,-2784,-9502784,11779999,2277215
12736,2020-11-15,741,Distribution,700025,-9502784,12480024,2977240
12736,2020-12-31,741,Value,1445580,-9502784,12480024,2977240
12736,2021-02-14,741,Capital Call,-216,-9503000,12480024,2977024
12736,2021-02-14,741,Distribution,265,-9503000,12480289,2977289
12736,2021-03-31,741,Value,1426400,-9503000,12480289,2977289
12736,2021-06-30,741,Value,1332320,-9503000,12480289,2977289
12736,2021-09-30,741,Value,1415940,-9503000,12480289,2977289
12744,2020-03-31,6138,Value,415880,-9724607,20311951,10587344
12744,2020-06-30,6138,Value,330750,-9724607,20311951,10587344
12744,2020-08-15,6138,Distribution,249890,-9724607,20561841,10837234
12744,2020-09-30,6138,Value,73480,-9724607,20561841,10837234
12744,2020-12-31,6138,Value,90410,-9724607,20561841,10837234
12744,2021-03-31,6138,Value,95200,-9724607,20561841,10837234
12744,2021-06-30,6138,Value,93860,-9724607,20561841,10837234
12744,2021-09-30,6138,Value,83920,-9724607,20561841,10837234
12767,2020-03-31,173,Value,478980,-9035800,22020160,12984360
12767,2020-06-30,173,Value,478980,-9035800,22020160,12984360
12767,2020-08-15,173,Distribution,77125,-9035800,22097285,13061485
12767,2020-09-30,173,Value,401850,-9035800,22097285,13061485
12767,2020-12-31,173,Value,401850,-9035800,22097285,13061485
12767,2021-03-31,173,Value,492210,-9035800,22097285,13061485
12767,2021-06-30,173,Value,401850,-9035800,22097285,13061485
12767,2021-12-31,173,Value,0,-9035800,22097285,13061485
12778,2020-03-31,6391,Value,1070110,-8161863,9132213,970350
12778,2020-05-16,6391,Capital Call,-66057,-8227920,9132213,904293
12778,2020-06-30,6391,Value,1070400,-8227920,9132213,904293
12778,2020-09-30,6391,Value,1234960,-8227920,9132213,904293
12778,2020-12-31,6391,Value,1234960,-8227920,9132213,904293
12778,2021-03-31,6391,Value,1317240,-8227920,9132213,904293
12778,2021-06-30,6391,Value,1399520,-8227920,9132213,904293
12789,2020-03-31,334,Value,725300,-10636286,21171919,10535633
12789,2020-06-30,334,Value,725300,-10636286,21171919,10535633
12789,2020-09-30,334,Value,719170,-10636286,21171919,10535633
12789,2020-11-15,334,Capital Call,-96468,-10732754,21171919,10439165
12789,2020-11-15,334,Distribution,145485,-10732754,21317404,10584650
12789,2020-12-31,334,Value,845060,-10732754,21317404,10584650
12789,2021-03-31,334,Value,765780,-10732754,21317404,10584650
12789,2021-05-16,334,Capital Call,1279995,-9452759,21317404,11864645
12789,2021-06-30,334,Value,724010,-9452759,21317404,11864645
12790,2020-02-15,417,Capital Call,-5425,-12988885,20588500,7599615
12790,2020-03-31,417,Value,3440210,-12988885,20588500,7599615
12790,2020-05-16,417,Capital Call,-12745,-13001630,20588500,7586870
12790,2020-06-30,417,Value,2003650,-13001630,20588500,7586870
12790,2020-08-15,417,Capital Call,-185823,-13187453,20588500,7401047
12790,2020-09-30,417,Value,2189480,-13187453,20588500,7401047
12790,2020-12-31,417,Value,2512790,-13187453,20588500,7401047
12790,2021-03-31,417,Value,2599950,-13187453,20588500,7401047
12800,2020-03-31,4903,Value,1064150,-10792988,9145899,-1647089
12800,2020-06-30,4903,Value,1079270,-10792988,9145899,-1647089
12800,2020-09-30,4903,Value,1057350,-10792988,9145899,-1647089
12800,2020-12-31,4903,Value,1034810,-10792988,9145899,-1647089
12800,2021-02-14,4903,Distribution,158333,-10792988,9304232,-1488756
12800,2021-03-31,4903,Value,710300,-10792988,9304232,-1488756
12800,2021-06-30,4903,Value,747620,-10792988,9304232,-1488756
12808,2020-03-31,8596,Value,12020,-9178432,12559579,3381147
12808,2020-06-30,8596,Value,12020,-9178432,12559579,3381147
12808,2020-09-30,8596,Value,12020,-9178432,12559579,3381147
12808,2020-12-31,8596,Value,33610,-9178432,12559579,3381147
12808,2021-02-14,8596,Distribution,23828,-9178432,12583407,3404975
12808,2021-03-31,8596,Value,9780,-9178432,12583407,3404975
12808,2021-06-30,8596,Value,9780,-9178432,12583407,3404975
12839,2020-03-31,1360,Value,878560,-8693572,13611016,4917444
12839,2020-06-30,1360,Value,896850,-8693572,13611016,4917444
12839,2020-08-15,1360,Distribution,160000,-8693572,13771016,5077444
12839,2020-09-30,1360,Value,774640,-8693572,13771016,5077444
12839,2020-12-31,1360,Value,867290,-8693572,13771016,5077444
12839,2021-03-31,1360,Value,967380,-8693572,13771016,5077444
12839,2021-05-16,1360,Distribution,185900,-8693572,13956916,5263344
12839,2021-06-30,1360,Value,854720,-8693572,13956916,5263344
12839,2021-08-15,1360,Capital Call,623,-8692949,13956916,5263967
12839,2021-08-15,1360,Distribution,93400,-8692949,14050316,5357367
12839,2021-09-30,1360,Value,830110,-8692949,14050316,5357367
12889,2020-03-31,600,Value,6048000,-7598000,5926439,-1671561
12889,2020-05-16,600,Capital Call,19000,-7579000,5926439,-1652561
12889,2020-05-16,600,Distribution,2203553,-7579000,8129992,550992
12889,2020-06-30,600,Value,7009050,-7579000,8129992,550992
12890,2021-12-31,770,Value,0,-9750002,672750,-9077252
12909,2020-03-31,23,Value,1314660,-11040003,22695999,11655996
12909,2020-06-30,23,Value,1562660,-11040003,22695999,11655996
12918,2020-01-15,75,Capital Call,0,-10189050,13667389,3478339
12918,2020-01-15,75,Distribution,348376,-10189050,14015765,3826715
12918,2020-02-29,75,Value,2605190,-10189050,14015765,3826715
12918,2020-04-15,75,Capital Call,0,-10189050,14015765,3826715
12918,2020-04-15,75,Distribution,0,-10189050,14015765,3826715
12918,2020-05-31,75,Value,2634330,-10189050,14015765,3826715
12918,2020-08-31,75,Value,2632350,-10189050,14015765,3826715
12918,2020-11-30,75,Value,2704310,-10189050,14015765,3826715
12918,2021-02-28,75,Value,4143870,-10189050,14015765,3826715
12918,2021-04-15,75,Distribution,1543146,-10189050,15558911,5369861
12918,2021-05-31,75,Value,2570720,-10189050,15558911,5369861
12918,2021-07-16,75,Distribution,450000,-10189050,16008911,5819861
12918,2021-08-31,75,Value,2150410,-10189050,16008911,5819861
12918,2021-10-16,75,Capital Call,0,-10189050,16008911,5819861
12918,2021-10-16,75,Distribution,1970833,-10189050,17979744,7790694
12918,2021-12-31,75,Value,0,-10189050,17979744,7790694
12973,2020-02-15,9110,Capital Call,-14581,-10232579,14209151,3976572
12973,2020-02-15,9110,Distribution,1468199,-10232579,15677350,5444771
12973,2020-03-31,9110,Value,9259960,-10232579,15677350,5444771
12973,2020-05-16,9110,Capital Call,-19419,-10251998,15677350,5425352
12973,2020-05-16,9110,Distribution,1985821,-10251998,17663171,7411173
12973,2020-06-30,9110,Value,8038590,-10251998,17663171,7411173
12973,2020-08-15,9110,Capital Call,-7000,-10258998,17663171,7404173
12973,2020-08-15,9110,Distribution,362918,-10258998,18026089,7767091
12973,2020-09-30,9110,Value,7692190,-10258998,18026089,7767091
12973,2020-11-15,9110,Capital Call,-6286,-10265284,18026089,7760805
12973,2020-11-15,9110,Distribution,288265,-10265284,18314354,8049070
12973,2020-12-31,9110,Value,7633010,-10265284,18314354,8049070
12973,2021-02-14,9110,Capital Call,-7388,-10272672,18314354,8041682
12973,2021-02-14,9110,Distribution,635764,-10272672,18950118,8677446
12973,2021-03-31,9110,Value,17501380,-10272672,18950118,8677446
12973,2021-05-16,9110,Capital Call,-326,-10272998,18950118,8677120
12973,2021-05-16,9110,Distribution,68287,-10272998,19018405,8745407
12973,2021-06-30,9110,Value,14641070,-10272998,19018405,8745407
12973,2021-08-15,9110,Capital Call,-2000,-10274998,19018405,8743407
12973,2021-08-15,9110,Distribution,310925,-10274998,19329330,9054332
12973,2021-09-30,9110,Value,8218970,-10274998,19329330,9054332
13003,2020-02-15,444,Capital Call,-20175,-9709930,11087767,1377837
13003,2020-02-15,444,Distribution,97066,-9709930,11184833,1474903
13003,2020-03-31,444,Value,159750,-9709930,11184833,1474903
13003,2020-05-16,444,Distribution,3835,-9709930,11188668,1478738
13003,2020-06-30,444,Value,1678500,-9709930,11188668,1478738
13003,2020-08-15,444,Distribution,15304,-9709930,11203972,1494042
13003,2020-11-15,444,Capital Call,-6009,-9715939,11203972,1488033
13003,2020-11-15,444,Distribution,25065,-9715939,11229037,1513098
13003,2020-12-31,444,Value,1604470,-9715939,11229037,1513098
13003,2021-02-14,444,Distribution,68698,-9715939,11297735,1581796
13003,2021-03-31,444,Value,1446950,-9715939,11297735,1581796
13003,2021-05-16,444,Capital Call,-14717,-9730656,11297735,1567079
13003,2021-05-16,444,Distribution,195206,-9730656,11492941,1762285
13003,2021-06-30,444,Value,1539180,-9730656,11492941,1762285
13011,2020-02-15,11,Distribution,1514,-8880609,18358498,9477889
13011,2020-03-31,11,Value,202640,-8880609,18358498,9477889
13011,2020-06-30,11,Value,202610,-8880609,18358498,9477889
13011,2020-09-30,11,Value,212710,-8880609,18358498,9477889
13011,2020-12-31,11,Value,179420,-8880609,18358498,9477889
13011,2021-03-31,11,Value,184600,-8880609,18358498,9477889
13011,2021-05-16,11,Distribution,8,-8880609,18358506,9477897
13011,2021-06-30,11,Value,212710,-8880609,18358506,9477897
13014,2020-02-15,15730,Capital Call,-206667,-10778666,15061333,4282667
13014,2020-02-15,15730,Distribution,554667,-10778666,15616000,4837334
13014,2020-03-31,15730,Value,733330,-10778666,15616000,4837334
13014,2020-05-16,15730,Capital Call,-60000,-10838666,15616000,4777334
13014,2020-05-16,15730,Distribution,168667,-10838666,15784667,4946001
13014,2020-06-30,15730,Value,637990,-10838666,15784667,4946001
13014,2020-08-15,15730,Capital Call,-130667,-10969333,15784667,4815334
13014,2020-08-15,15730,Distribution,130667,-10969333,15915334,4946001
13014,2020-09-30,15730,Value,630660,-10969333,15915334,4946001
13014,2020-12-31,15730,Value,264660,-10969333,15915334,4946001
13014,2021-03-31,15730,Value,216660,-10969333,15915334,4946001
13014,2021-06-30,15730,Value,216660,-10969333,15915334,4946001
13014,2021-08-15,15730,Capital Call,67,-10969266,15915334,4946068
13014,2021-08-15,15730,Distribution,-67,-10969266,15915267,4946001
13014,2021-09-30,15730,Value,216860,-10969266,15915267,4946001
13047,2021-12-31,10180,Value,0,-11813412,14858469,3045057
13105,2020-03-31,8729,Value,5746900,-9999998,15211161,5211163
13105,2020-05-16,8729,Distribution,0,-9999998,15211161,5211163
13105,2020-06-30,8729,Value,14621520,-9999998,15211161,5211163
13105,2020-08-15,8729,Distribution,14313030,-9999998,29524191,19524193
13105,2020-09-30,8729,Value,235220,-9999998,29524191,19524193
13105,2020-11-15,8729,Distribution,213469,-9999998,29737660,19737662
13105,2020-12-31,8729,Value,17640,-9999998,29737660,19737662
13105,2021-04-01,8729,Distribution,2339,-9999998,29739999,19740001
13105,2021-06-30,8729,Value,20000,-9999998,29739999,19740001
13105,2021-08-15,8729,Distribution,-2339,-9999998,29737660,19737662
13105,2021-09-30,8729,Value,17640,-9999998,29737660,19737662
13105,2021-12-31,8729,Value,0,-9999998,29737660,19737662
13124,2020-02-15,733,Capital Call,-62414,-11514804,14823350,3308546
13124,2020-02-15,733,Distribution,115517,-11514804,14938867,3424063
13124,2020-03-31,733,Value,1916390,-11514804,14938867,3424063
13124,2020-05-16,733,Capital Call,53204,-11461600,14938867,3477267
13124,2020-06-30,733,Value,1851510,-11461600,14938867,3477267
13124,2020-08-15,733,Capital Call,-61525,-11523125,14938867,3415742
13124,2020-08-15,733,Distribution,278140,-11523125,15217007,3693882
13124,2020-09-30,733,Value,1645420,-11523125,15217007,3693882
13124,2020-11-15,733,Distribution,25287,-11523125,15242294,3719169
13124,2020-12-31,733,Value,1618120,-11523125,15242294,3719169
13124,2021-02-14,733,Distribution,27018,-11523125,15269312,3746187
13124,2021-03-31,733,Value,1566820,-11523125,15269312,3746187
13124,2021-05-16,733,Capital Call,-31922,-11555047,15269312,3714265
13124,2021-05-16,733,Distribution,582171,-11555047,15851483,4296436
13124,2021-06-30,733,Value,1098560,-11555047,15851483,4296436
13143,2020-03-31,12590,Value,354240,-9801642,3897304,-5904338
13143,2020-05-16,12590,Capital Call,-27594,-9829236,3897304,-5931932
13143,2020-06-30,12590,Value,314560,-9829236,3897304,-5931932
13143,2020-08-15,12590,Capital Call,-10275,-9839511,3897304,-5942207
13143,2020-08-15,12590,Distribution,10274,-9839511,3907578,-5931933
13143,2020-09-30,12590,Value,341250,-9839511,3907578,-5931933
13143,2020-12-31,12590,Value,301180,-9839511,3907578,-5931933
13143,2021-06-30,12590,Value,254240,-9839511,3907578,-5931933
13162,2020-06-30,80,Value,824630,-8984441,17311686,8327245
13162,2020-12-30,80,Capital Call,-1983557,-10967998,17311686,6343688
13162,2020-12-30,80,Distribution,4805285,-10967998,22116971,11148973
13162,2021-06-30,80,Value,0,-10967998,22116971,11148973
13193,2020-02-15,519,Capital Call,-97338,-9479536,12751269,3271733
13193,2020-02-15,519,Distribution,97338,-9479536,12848607,3369071
13193,2020-03-31,519,Value,1589430,-9479536,12848607,3369071
13193,2020-05-16,519,Distribution,121349,-9479536,12969956,3490420
13193,2020-06-30,519,Value,1401900,-9479536,12969956,3490420
13193,2020-08-15,519,Distribution,51483,-9479536,13021439,3541903
13193,2020-09-30,519,Value,1252640,-9479536,13021439,3541903
13193,2020-11-15,519,Distribution,136757,-9479536,13158196,3678660
13193,2020-12-31,519,Value,1115880,-9479536,13158196,3678660
13193,2021-02-14,519,Distribution,82348,-9479536,13240544,3761008
13193,2021-03-31,519,Value,1033530,-9479536,13240544,3761008
13193,2021-05-16,519,Distribution,65362,-9479536,13305906,3826370
13193,2021-06-30,519,Value,1270650,-9479536,13305906,3826370
13193,2021-08-15,519,Distribution,83500,-9479536,13389406,3909870
13193,2021-09-30,519,Value,1269400,-9479536,13389406,3909870
13197,2020-03-31,23,Value,102900,-7858193,4799802,-3058391
13197,2020-06-30,23,Value,105860,-7858193,4799802,-3058391
13197,2020-12-31,23,Value,110710,-7858193,4799802,-3058391
13197,2021-03-31,23,Value,114840,-7858193,4799802,-3058391
13197,2021-05-16,23,Capital Call,-31808,-7890001,4799802,-3090199
13197,2021-05-16,23,Distribution,19408,-7890001,4819210,-3070791
13197,2021-06-30,23,Value,114840,-7890001,4819210,-3070791
13200,2020-02-15,939,Capital Call,-12857,-9911427,24487143,14575716
13200,2020-02-15,939,Distribution,12857,-9911427,24500000,14588573
13200,2020-03-31,939,Value,978570,-9911427,24500000,14588573
13200,2020-06-30,939,Value,985710,-9911427,24500000,14588573
13200,2020-08-15,939,Capital Call,12857,-9898570,24500000,14601430
13200,2020-08-15,939,Distribution,-12857,-9898570,24487143,14588573
13200,2020-09-30,939,Value,1222850,-9898570,24487143,14588573
13200,2020-11-15,939,Distribution,47143,-9898570,24534286,14635716
13200,2020-12-31,939,Value,1084280,-9898570,24534286,14635716
13200,2021-02-14,939,Distribution,524286,-9898570,25058572,15160002
13200,2021-03-31,939,Value,841420,-9898570,25058572,15160002
13200,2021-06-30,939,Value,932850,-9898570,25058572,15160002
13206,2020-03-31,2078,Value,8521820,-10000000,20266886,10266886
13206,2020-05-16,2078,Distribution,21057,-10000000,20287943,10287943
13206,2020-06-30,2078,Value,8547970,-10000000,20287943,10287943
13206,2020-09-30,2078,Value,8830390,-10000000,20287943,10287943
13206,2020-12-31,2078,Value,9123400,-10000000,20287943,10287943
13206,2021-03-31,2078,Value,8756630,-10000000,20287943,10287943
13206,2021-06-30,2078,Value,8758580,-10000000,20287943,10287943
13223,2020-03-31,1519,Value,12358730,-10000004,11635630,1635626
13223,2020-06-30,1519,Value,12332000,-10000004,11635630,1635626
13223,2020-09-30,1519,Value,12297940,-10000004,11635630,1635626
13223,2020-12-31,1519,Value,8454670,-10000004,11635630,1635626
13223,2021-03-31,1519,Value,11639930,-10000004,11635630,1635626
13223,2021-06-30,1519,Value,12620770,-10000004,11635630,1635626
13258,2020-02-15,6715,Distribution,0,-9500000,23493766,13993766
13258,2020-03-31,6715,Value,10607570,-9500000,23493766,13993766
13258,2020-05-16,6715,Distribution,0,-9500000,23493766,13993766
13258,2020-06-30,6715,Value,10587480,-9500000,23493766,13993766
13258,2020-09-30,6715,Value,12578500,-9500000,23493766,13993766
13258,2020-12-31,6715,Value,15345600,-9500000,23493766,13993766
13258,2021-03-31,6715,Value,17927920,-9500000,23493766,13993766
13258,2021-05-16,6715,Distribution,3639264,-9500000,27133030,17633030
13258,2021-06-30,6715,Value,19546470,-9500000,27133030,17633030
13258,2021-08-15,6715,Distribution,11354710,-9500000,38487740,28987740
13258,2021-09-30,6715,Value,12487930,-9500000,38487740,28987740
13262,2021-12-31,910,Value,0,-8560000,2773440,-5786560
13288,2020-02-15,1086,Capital Call,-10031,-9244490,5101269,-4143221
13288,2020-02-15,1086,Distribution,10031,-9244490,5111300,-4133190
13288,2020-03-31,1086,Value,1634400,-9244490,5111300,-4133190
13288,2020-06-30,1086,Value,2227210,-9244490,5111300,-4133190
13288,2020-09-30,1086,Value,2632150,-9244490,5111300,-4133190
13288,2020-11-15,1086,Capital Call,-9143,-9253633,5111300,-4142333
13288,2020-11-15,1086,Distribution,9144,-9253633,5120444,-4133189
13288,2020-12-31,1086,Value,3023100,-9253633,5120444,-4133189
13288,2021-03-31,1086,Value,3615920,-9253633,5120444,-4133189
13288,2021-05-16,1086,Capital Call,-86377,-9340010,5120444,-4219566
13288,2021-05-16,1086,Distribution,2710704,-9340010,7831148,-1508862
13288,2021-06-30,1086,Value,1269610,-9340010,7831148,-1508862
13296,2020-03-31,16154,Value,1300000,-10000000,16800000,6800000
13296,2020-06-30,16154,Value,1200000,-10000000,16800000,6800000
13296,2020-09-30,16154,Value,1200000,-10000000,16800000,6800000
13296,2020-12-31,16154,Value,1200000,-10000000,16800000,6800000
13296,2021-03-31,16154,Value,1200000,-10000000,16800000,6800000
13296,2021-06-30,16154,Value,1200000,-10000000,16800000,6800000
13296,2021-09-30,16154,Value,1200000,-10000000,16800000,6800000
13296,2021-12-31,16154,Value,1200000,-10000000,16800000,6800000
13318,2020-06-30,9740,Value,3520300,-8593892,16156164,7562272
13318,2020-12-30,9740,Capital Call,-27001,-8620893,16156164,7535271
13318,2020-12-30,9740,Distribution,1022158,-8620893,17178322,8557429
13318,2021-06-30,9740,Value,2276870,-8620893,17178322,8557429
13319,2020-03-31,1590,Capital Call,-329000,-11925001,14697930,2772929
13319,2020-03-31,1590,Distribution,1256528,-11925001,15954458,4029457
13319,2020-06-30,1590,Value,3816000,-11925001,15954458,4029457
13319,2020-08-15,1590,Capital Call,-62100,-11987101,15954458,3967357
13319,2020-08-15,1590,Distribution,87878,-11987101,16042336,4055235
13319,2020-09-30,1590,Value,4099580,-11987101,16042336,4055235
13319,2020-11-15,1590,Capital Call,-7900,-11995001,16042336,4047335
13319,2020-11-15,1590,Distribution,1635895,-11995001,17678231,5683230
13319,2020-12-31,1590,Value,2815220,-11995001,17678231,5683230
13319,2021-02-14,1590,Distribution,-11995,-11995001,17666236,5671235
13319,2021-03-31,1590,Value,2853610,-11995001,17666236,5671235
13319,2021-05-16,1590,Capital Call,-22000,-12017001,17666236,5649235
13319,2021-05-16,1590,Distribution,240296,-12017001,17906532,5889531
13319,2021-06-30,1590,Value,2837210,-12017001,17906532,5889531
13319,2021-08-15,1590,Capital Call,-1000,-12018001,17906532,5888531
13319,2021-08-15,1590,Distribution,1490,-12018001,17908022,5890021
13319,2021-09-30,1590,Value,2865090,-12018001,17908022,5890021
13347,2020-02-15,13324,Capital Call,-3558,-10036981,13449765,3412784
13347,2020-03-31,13324,Value,2408660,-10036981,13449765,3412784
13347,2020-05-16,13324,Capital Call,-5073,-10042054,13449765,3407711
13347,2020-06-30,13324,Value,2517100,-10042054,13449765,3407711
13347,2020-08-15,13324,Capital Call,-10617,-10052671,13449765,3397094
13347,2020-09-30,13324,Value,2232400,-10052671,13449765,3397094
13347,2020-11-15,13324,Capital Call,-4631,-10057302,13449765,3392463
13347,2020-12-31,13324,Value,1535610,-10057302,13449765,3392463
13347,2021-02-14,13324,Capital Call,-15208,-10072510,13449765,3377255
13347,2021-02-14,13324,Distribution,283863,-10072510,13733628,3661118
13347,2021-03-31,13324,Value,1475860,-10072510,13733628,3661118
13347,2021-06-30,13324,Value,1677310,-10072510,13733628,3661118
13405,2020-03-31,1477,Value,1576000,-9850000,9259000,-591000
13405,2020-06-30,1477,Value,1674500,-9850000,9259000,-591000
13405,2020-08-15,1477,Distribution,-98500,-9850000,9160500,-689500
13405,2020-09-30,1477,Value,1576000,-9850000,9160500,-689500
13405,2020-12-31,1477,Value,1970000,-9850000,9160500,-689500
13405,2021-03-31,1477,Value,2167000,-9850000,9160500,-689500
13405,2021-09-30,1477,Value,2364000,-9850000,9160500,-689500
13405,2021-12-31,1477,Value,2265500,-9850000,9160500,-689500
13413,2020-02-15,715,Capital Call,-204837,-10763751,21259894,10496143
13413,2020-03-31,715,Value,2644810,-10763751,21259894,10496143
13413,2020-06-30,715,Value,2644810,-10763751,21259894,10496143
13413,2020-08-15,715,Distribution,20848,-10763751,21280742,10516991
13413,2020-09-30,715,Value,2815120,-10763751,21280742,10516991
13413,2020-11-15,715,Distribution,11210,-10763751,21291952,10528201
13413,2020-12-31,715,Value,2968890,-10763751,21291952,10528201
13413,2021-02-14,715,Distribution,204837,-10763751,21496789,10733038
13413,2021-03-31,715,Value,2600930,-10763751,21496789,10733038
13413,2021-05-16,715,Capital Call,305717,-10458034,21496789,11038755
13413,2021-06-30,715,Value,2749920,-10458034,21496789,11038755
13425,2020-02-15,211,Capital Call,-7500,-11095000,16155000,5060000
13425,2020-02-15,211,Distribution,317500,-11095000,16472500,5377500
13425,2020-03-31,211,Value,3512490,-11095000,16472500,5377500
13425,2020-05-16,211,Capital Call,-25000,-11120000,16472500,5352500
13425,2020-05-16,211,Distribution,370000,-11120000,16842500,5722500
13425,2020-06-30,211,Value,2727490,-11120000,16842500,5722500
13425,2020-08-15,211,Capital Call,-5000,-11125000,16842500,5717500
13425,2020-08-15,211,Distribution,255000,-11125000,17097500,5972500
13425,2020-09-30,211,Value,2634990,-11125000,17097500,5972500
13425,2020-11-15,211,Capital Call,27500,-11097500,17097500,6000000
13425,2020-11-15,211,Distribution,285000,-11097500,17382500,6285000
13425,2020-12-31,211,Value,2574990,-11097500,17382500,6285000
13425,2021-02-14,211,Capital Call,-25000,-11122500,17382500,6260000
13425,2021-02-14,211,Distribution,705000,-11122500,18087500,6965000
13425,2021-03-31,211,Value,2089990,-11122500,18087500,6965000
13425,2021-05-16,211,Capital Call,-42500,-11165000,18087500,6922500
13425,2021-05-16,211,Distribution,705000,-11165000,18792500,7627500
13425,2021-06-30,211,Value,2090000,-11165000,18792500,7627500
13425,2021-08-15,211,Capital Call,1000,-11164000,18792500,7628500
13425,2021-08-15,211,Distribution,830500,-11164000,19623000,8459000
13425,2021-09-30,211,Value,2090240,-11164000,19623000,8459000
13446,2020-02-15,18619,Capital Call,-5317,-9916608,14532286,4615678
13446,2020-02-15,18619,Distribution,68578,-9916608,14600864,4684256
13446,2020-03-31,18619,Value,926020,-9916608,14600864,4684256
13446,2020-05-16,18619,Capital Call,-7249,-9923857,14600864,4677007
13446,2020-05-16,18619,Distribution,50804,-9923857,14651668,4727811
13446,2020-06-30,18619,Value,891150,-9923857,14651668,4727811
13446,2020-08-15,18619,Capital Call,-4600,-9928457,14651668,4723211
13446,2020-08-15,18619,Distribution,31548,-9928457,14683216,4754759
13446,2020-09-30,18619,Value,711580,-9928457,14683216,4754759
13446,2020-11-15,18619,Capital Call,-648,-9929105,14683216,4754111
13446,2020-11-15,18619,Distribution,53832,-9929105,14737048,4807943
13446,2020-12-31,18619,Value,689690,-9929105,14737048,4807943
13446,2021-02-14,18619,Capital Call,-396,-9929501,14737048,4807547
13446,2021-02-14,18619,Distribution,74524,-9929501,14811572,4882071
13446,2021-03-31,18619,Value,682190,-9929501,14811572,4882071
13446,2021-05-16,18619,Capital Call,-360,-9929861,14811572,4881711
13446,2021-05-16,18619,Distribution,114938,-9929861,14926510,4996649
13446,2021-06-30,18619,Value,673440,-9929861,14926510,4996649
13447,2020-02-15,18619,Capital Call,-8506,-10391097,14560413,4169316
13447,2020-02-15,18619,Distribution,46756,-10391097,14607169,4216072
13447,2020-03-31,18619,Value,1359340,-10391097,14607169,4216072
13447,2020-05-16,18619,Distribution,156454,-10391097,14763623,4372526
13447,2020-06-30,18619,Value,978590,-10391097,14763623,4372526
13447,2020-08-15,18619,Capital Call,-4042,-10395139,14763623,4368484
13447,2020-08-15,18619,Distribution,81896,-10395139,14845519,4450380
13447,2020-09-30,18619,Value,901400,-10395139,14845519,4450380
13447,2020-11-15,18619,Capital Call,-3257,-10398396,14845519,4447123
13447,2020-11-15,18619,Distribution,107201,-10398396,14952720,4554324
13447,2020-12-31,18619,Value,743500,-10398396,14952720,4554324
13447,2021-02-14,18619,Capital Call,-3010,-10401406,14952720,4551314
13447,2021-02-14,18619,Distribution,55322,-10401406,15008042,4606636
13447,2021-03-31,18619,Value,691160,-10401406,15008042,4606636
13447,2021-05-16,18619,Capital Call,43,-10401363,15008042,4606679
13447,2021-05-16,18619,Distribution,80744,-10401363,15088786,4687423
13447,2021-06-30,18619,Value,779920,-10401363,15088786,4687423
13447,2021-08-15,18619,Capital Call,-2430,-10403793,15088786,4684993
13447,2021-08-15,18619,Distribution,62278,-10403793,15151064,4747271
13447,2021-09-30,18619,Value,844950,-10403793,15151064,4747271
13448,2020-02-15,8649,Distribution,130931,-9918998,24801470,14882472
13448,2020-03-31,8649,Value,504870,-9918998,24801470,14882472
13448,2020-06-30,8649,Value,543560,-9918998,24801470,14882472
13448,2020-09-30,8649,Value,818310,-9918998,24801470,14882472
13448,2020-11-15,8649,Capital Call,-1000,-9919998,24801470,14881472
13448,2020-11-15,8649,Distribution,674084,-9919998,25475554,15555556
13448,2020-12-31,8649,Value,150780,-9919998,25475554,15555556
13448,2021-05-17,8649,Capital Call,-1000,-9920998,25475554,15554556
13448,2021-05-17,8649,Distribution,64078,-9920998,25539632,15618634
13448,2021-09-30,8649,Value,77380,-9920998,25539632,15618634
13483,2020-03-31,15,Value,382530,-8400001,12396824,3996823
13483,2020-06-30,15,Value,334920,-8400001,12396824,3996823
13483,2020-09-30,15,Value,328570,-8400001,12396824,3996823
13483,2020-12-31,15,Value,239680,-8400001,12396824,3996823
13483,2021-03-31,15,Value,207930,-8400001,12396824,3996823
13483,2021-05-16,15,Distribution,11088889,-8400001,23485713,15085712
13483,2021-06-30,15,Value,142850,-8400001,23485713,15085712
13483,2021-09-30,15,Value,143440,-8400001,23485713,15085712
13507,2020-02-15,698,Capital Call,-42593,-9302964,9952223,649259
13507,2020-02-15,698,Distribution,248889,-9302964,10201112,898148
13507,2020-03-31,698,Value,4615180,-9302964,10201112,898148
13507,2020-05-16,698,Capital Call,-170370,-9473334,10201112,727778
13507,2020-05-16,698,Distribution,455185,-9473334,10656297,1182963
13507,2020-06-30,698,Value,3385180,-9473334,10656297,1182963
13507,2020-09-30,698,Value,3771480,-9473334,10656297,1182963
13507,2020-11-15,698,Capital Call,-22963,-9496297,10656297,1160000
13507,2020-11-15,698,Distribution,137778,-9496297,10794075,1297778
13507,2020-12-31,698,Value,3695920,-9496297,10794075,1297778
13507,2021-02-14,698,Capital Call,-41111,-9537408,10794075,1256667
13507,2021-02-14,698,Distribution,110000,-9537408,10904075,1366667
13507,2021-03-31,698,Value,3521480,-9537408,10904075,1366667
13507,2021-05-16,698,Capital Call,42222,-9495186,10904075,1408889
13507,2021-05-16,698,Distribution,112963,-9495186,11017038,1521852
13507,2021-06-30,698,Value,3557770,-9495186,11017038,1521852
13525,2020-03-31,16605,Value,404320,-8965001,22102311,13137310
13525,2020-06-30,16605,Value,462590,-8965001,22102311,13137310
13525,2020-09-30,16605,Value,535210,-8965001,22102311,13137310
13525,2020-12-31,16605,Value,617680,-8965001,22102311,13137310
13525,2021-02-14,16605,Distribution,138061,-8965001,22240372,13275371
13525,2021-03-31,16605,Value,509210,-8965001,22240372,13275371
13525,2021-06-30,16605,Value,527140,-8965001,22240372,13275371
13525,2021-08-15,16605,Distribution,-7172,-8965001,22233200,13268199
13525,2021-09-30,16605,Value,758430,-8965001,22233200,13268199
13525,2021-11-15,16605,Distribution,975392,-8965001,23208592,14243591
13525,2021-12-31,16605,Value,0,-8965001,23208592,14243591
13538,2020-03-31,6955,Value,760000,-13230000,20590000,7360000
13538,2020-06-30,6955,Value,939990,-13230000,20590000,7360000
13538,2020-09-30,6955,Value,669990,-13230000,20590000,7360000
13538,2020-11-15,6955,Distribution,530000,-13230000,21120000,7890000
13538,2020-12-31,6955,Value,0,-13230000,21120000,7890000
13538,2021-03-31,6955,Value,0,-13230000,21120000,7890000
13538,2021-06-30,6955,Value,0,-13230000,21120000,7890000
13538,2021-09-30,6955,Value,0,-13230000,21120000,7890000
13554,2020-03-31,162,Value,1409990,-9860000,12365000,2505000
13554,2020-05-16,162,Capital Call,-15000,-9875000,12365000,2490000
13554,2020-05-16,162,Distribution,15000,-9875000,12380000,2505000
13554,2020-06-30,162,Value,1445000,-9875000,12380000,2505000
13554,2020-09-30,162,Value,1219990,-9875000,12380000,2505000
13554,2020-11-15,162,Capital Call,-135000,-10010000,12380000,2370000
13554,2020-11-15,162,Distribution,35000,-10010000,12415000,2405000
13554,2020-12-31,162,Value,1664990,-10010000,12415000,2405000
13554,2021-03-31,162,Value,1964990,-10010000,12415000,2405000
13554,2021-06-30,162,Value,2349990,-10010000,12415000,2405000
13554,2021-08-15,162,Capital Call,-2000,-10012000,12415000,2403000
13554,2021-09-30,162,Value,2371000,-10012000,12415000,2403000
13585,2020-02-15,7,Capital Call,33167,-9950001,11532556,1582555
13585,2020-02-15,7,Distribution,161439,-9950001,11693995,1743994
13585,2020-03-31,7,Value,4521470,-9950001,11693995,1743994
13585,2020-05-16,7,Distribution,9396,-9950001,11703391,1753390
13585,2020-06-30,7,Value,5252900,-9950001,11703391,1753390
13585,2020-08-15,7,Distribution,90951,-9950001,11794342,1844341
13585,2020-09-30,7,Value,5586190,-9950001,11794342,1844341
13601,2020-02-15,1759,Capital Call,-53000,-11277000,17733919,6456919
13601,2020-02-15,1759,Distribution,732168,-11277000,18466087,7189087
13601,2020-03-31,1759,Value,3608640,-11277000,18466087,7189087
13601,2020-05-16,1759,Capital Call,-116000,-11393000,18466087,7073087
13601,2020-05-16,1759,Distribution,119313,-11393000,18585400,7192400
13601,2020-06-30,1759,Value,3417900,-11393000,18585400,7192400
13601,2020-08-15,1759,Distribution,116209,-11393000,18701609,7308609
13601,2020-09-30,1759,Value,3531830,-11393000,18701609,7308609
13601,2020-11-15,1759,Capital Call,-9000,-11402000,18701609,7299609
13601,2020-11-15,1759,Distribution,616799,-11402000,19318408,7916408
13601,2020-12-31,1759,Value,3192560,-11402000,19318408,7916408
13601,2021-02-14,1759,Capital Call,2000,-11400000,19318408,7918408
13601,2021-02-14,1759,Distribution,528991,-11400000,19847399,8447399
13601,2021-03-31,1759,Value,3078000,-11400000,19847399,8447399
13601,2021-05-16,1759,Capital Call,-2000,-11402000,19847399,8445399
13601,2021-05-16,1759,Distribution,220120,-11402000,20067519,8665519
13601,2021-06-30,1759,Value,3306580,-11402000,20067519,8665519
13601,2021-08-15,1759,Capital Call,2000,-11400000,20067519,8667519
13601,2021-08-15,1759,Distribution,760280,-11400000,20827799,9427799
13601,2021-09-30,1759,Value,3534000,-11400000,20827799,9427799
13715,2020-02-15,54,Distribution,28918,-12762771,24815491,12052720
13715,2020-03-31,54,Value,1435870,-12762771,24815491,12052720
13715,2020-05-16,54,Distribution,715768,-12762771,25531259,12768488
13715,2020-06-30,54,Value,1320800,-12762771,25531259,12768488
13715,2020-08-15,54,Capital Call,-19597,-12782368,25531259,12748891
13715,2020-08-15,54,Distribution,851612,-12782368,26382871,13600503
13715,2020-09-30,54,Value,581150,-12782368,26382871,13600503
13715,2020-11-15,54,Distribution,6450,-12782368,26389321,13606953
13715,2020-12-31,54,Value,586380,-12782368,26389321,13606953
13715,2021-02-14,54,Capital Call,-19597,-12801965,26389321,13587356
13715,2021-02-14,54,Distribution,74541,-12801965,26463862,13661897
13715,2021-03-31,54,Value,708880,-12801965,26463862,13661897
13715,2021-05-16,54,Distribution,21604,-12801965,26485466,13683501
13715,2021-06-30,54,Value,575660,-12801965,26485466,13683501
13718,2020-03-31,506,Value,3746310,-9700000,21559606,11859606
13718,2020-05-16,506,Distribution,715234,-9700000,22274840,12574840
13718,2020-06-30,506,Value,4042720,-9700000,22274840,12574840
13721,2020-01-15,526,Capital Call,0,-10000000,17844597,7844597
13721,2020-01-15,526,Distribution,0,-10000000,17844597,7844597
13721,2020-02-29,526,Value,3834850,-10000000,17844597,7844597
13721,2020-04-15,526,Capital Call,0,-10000000,17844597,7844597
13721,2020-04-15,526,Distribution,0,-10000000,17844597,7844597
13721,2020-05-31,526,Value,3706130,-10000000,17844597,7844597
13721,2020-07-16,526,Distribution,488918,-10000000,18333515,8333515
13721,2020-08-31,526,Value,3806400,-10000000,18333515,8333515
13721,2020-11-30,526,Value,3807370,-10000000,18333515,8333515
13721,2021-01-14,526,Distribution,291146,-10000000,18624661,8624661
13721,2021-02-28,526,Value,3659020,-10000000,18624661,8624661
13721,2021-05-31,526,Value,3690480,-10000000,18624661,8624661
13721,2021-08-31,526,Value,18392500,-10000000,18624661,8624661
13721,2021-10-16,526,Capital Call,0,-10000000,18624661,8624661
13721,2021-10-16,526,Distribution,12022585,-10000000,30647246,20647246
13721,2021-11-30,526,Value,14820700,-10000000,30647246,20647246
13723,2020-03-31,7234,Value,545000,-9680000,21620000,11940000
13723,2020-06-30,7234,Value,545000,-9680000,21620000,11940000
13723,2020-09-30,7234,Value,545000,-9680000,21620000,11940000
13723,2020-12-31,7234,Value,394990,-9680000,21620000,11940000
13723,2021-03-31,7234,Value,394990,-9680000,21620000,11940000
13723,2021-06-30,7234,Value,394990,-9680000,21620000,11940000
13723,2021-08-15,7234,Capital Call,-2000,-9682000,21620000,11938000
13723,2021-08-15,7234,Distribution,2000,-9682000,21622000,11940000
13723,2021-09-30,7234,Value,395490,-9682000,21622000,11940000
13768,2020-03-31,16988,Value,0,-10100017,2226219,-7873798
13768,2020-06-30,16988,Value,0,-10100017,2226219,-7873798
13768,2020-09-30,16988,Value,0,-10100017,2226219,-7873798
13768,2020-12-31,16988,Value,0,-10100017,2226219,-7873798
13768,2021-03-31,16988,Value,0,-10100017,2226219,-7873798
13768,2021-06-30,16988,Value,0,-10100017,2226219,-7873798
13768,2021-09-30,16988,Value,0,-10100017,2226219,-7873798
13768,2021-12-31,16988,Value,0,-10100017,2226219,-7873798
13769,2020-03-31,535,Value,0,-10000000,14040001,4040001
13769,2020-06-30,535,Value,0,-10000000,14040001,4040001
13769,2020-09-30,535,Value,0,-10000000,14040001,4040001
13769,2020-12-31,535,Value,0,-10000000,14040001,4040001
13769,2021-03-31,535,Value,0,-10000000,14040001,4040001
13769,2021-06-30,535,Value,0,-10000000,14040001,4040001
13769,2021-09-30,535,Value,0,-10000000,14040001,4040001
13769,2021-12-31,535,Value,0,-10000000,14040001,4040001
13770,2020-03-31,616,Value,0,-9999999,17593334,7593335
13770,2020-06-30,616,Value,0,-9999999,17593334,7593335
13770,2020-09-30,616,Value,0,-9999999,17593334,7593335
13770,2020-12-31,616,Value,0,-9999999,17593334,7593335
13770,2021-03-31,616,Value,0,-9999999,17593334,7593335
13770,2021-06-30,616,Value,0,-9999999,17593334,7593335
13770,2021-09-30,616,Value,0,-9999999,17593334,7593335
13770,2021-12-31,616,Value,0,-9999999,17593334,7593335
13796,2020-12-31,534,Value,7712000,-10000001,4060999,-5939002
13796,2021-03-31,534,Value,5915000,-10000001,4060999,-5939002
13800,2020-02-15,736,Distribution,1440000,-10000000,17739822,7739822
13800,2020-03-31,736,Value,2574350,-10000000,17739822,7739822
13800,2020-06-30,736,Value,2733490,-10000000,17739822,7739822
13800,2020-08-15,736,Distribution,1245000,-10000000,18984822,8984822
13800,2020-09-30,736,Value,1237490,-10000000,18984822,8984822
13800,2020-11-15,736,Distribution,320000,-10000000,19304822,9304822
13800,2020-12-31,736,Value,1536460,-10000000,19304822,9304822
13800,2021-03-31,736,Value,2041420,-10000000,19304822,9304822
13800,2021-05-16,736,Distribution,1080000,-10000000,20384822,10384822
13800,2021-06-30,736,Value,1090900,-10000000,20384822,10384822
13803,2020-02-15,835,Capital Call,-6349,-7718093,11712785,3994692
13803,2020-02-15,835,Distribution,195776,-7718093,11908561,4190468
13803,2020-03-31,835,Value,921100,-7718093,11908561,4190468
13803,2020-06-30,835,Value,948880,-7718093,11908561,4190468
13803,2020-08-15,835,Capital Call,-3725,-7721818,11908561,4186743
13803,2020-08-15,835,Distribution,31082,-7721818,11939643,4217825
13803,2020-09-30,835,Value,869530,-7721818,11939643,4217825
13803,2020-11-15,835,Capital Call,-21779,-7743597,11939643,4196046
13803,2020-12-31,835,Value,684500,-7743597,11939643,4196046
13803,2021-03-31,835,Value,1030860,-7743597,11939643,4196046
13803,2021-06-30,835,Value,1028530,-7743597,11939643,4196046
13870,2020-09-30,5813,Value,0,-9560000,15544560,5984560
13870,2020-12-31,5813,Value,0,-9560000,15544560,5984560
13870,2021-03-31,5813,Value,0,-9560000,15544560,5984560
13870,2021-06-30,5813,Value,0,-9560000,15544560,5984560
13870,2021-09-30,5813,Value,0,-9560000,15544560,5984560
13870,2021-12-31,5813,Value,0,-9560000,15544560,5984560
13892,2020-02-15,1360,Distribution,77163,-9980700,12834178,2853478
13892,2020-03-31,1360,Value,1291510,-9980700,12834178,2853478
13892,2020-06-30,1360,Value,1027800,-9980700,12834178,2853478
13892,2020-08-15,1360,Distribution,30865,-9980700,12865043,2884343
13892,2020-09-30,1360,Value,1018510,-9980700,12865043,2884343
13892,2020-11-15,1360,Distribution,96454,-9980700,12961497,2980797
13892,2020-12-31,1360,Value,981190,-9980700,12961497,2980797
13892,2021-02-14,1360,Distribution,57872,-9980700,13019369,3038669
13892,2021-03-31,1360,Value,995990,-9980700,13019369,3038669
13912,2020-02-15,7,Distribution,350000,-9900000,10889570,989570
13912,2020-03-31,7,Value,5810240,-9900000,10889570,989570
13912,2020-06-30,7,Value,5103760,-9900000,10889570,989570
13912,2020-08-15,7,Capital Call,-50000,-9950000,10889570,939570
13912,2020-08-15,7,Distribution,350000,-9950000,11239570,1289570
13912,2020-09-30,7,Value,6038940,-9950000,11239570,1289570
13919,2020-03-31,211,Value,0,-3514101,4467619,953518
13919,2020-06-30,211,Value,0,-3514101,4467619,953518
13919,2020-09-30,211,Value,0,-3514101,4467619,953518
13919,2020-12-31,211,Value,0,-3514101,4467619,953518
13919,2021-03-31,211,Value,0,-3514101,4467619,953518
13919,2021-06-30,211,Value,0,-3514101,4467619,953518
13919,2021-09-30,211,Value,0,-3514101,4467619,953518
13919,2021-12-31,211,Value,0,-3514101,4467619,953518
13943,2020-03-31,6839,Value,49400,-10033930,20543022,10509092
13943,2020-06-30,6839,Value,46550,-10033930,20543022,10509092
13943,2020-09-30,6839,Value,21450,-10033930,20543022,10509092
13943,2020-12-31,6839,Value,21170,-10033930,20543022,10509092
13943,2021-03-31,6839,Value,20030,-10033930,20543022,10509092
13943,2021-06-30,6839,Value,19540,-10033930,20543022,10509092
13975,2020-03-31,6691,Value,2178000,-9900000,25641000,15741000
13975,2020-05-16,6691,Capital Call,-33580,-9933580,25641000,15707420
13975,2020-06-30,6691,Value,2185380,-9933580,25641000,15707420
13975,2020-09-30,6691,Value,2177990,-9933580,25641000,15707420
13975,2020-11-15,6691,Capital Call,-420,-9934000,25641000,15707000
13975,2020-11-15,6691,Distribution,-110620,-9934000,25530380,15596380
13975,2020-12-31,6691,Value,2185480,-9934000,25530380,15596380
13975,2021-03-31,6691,Value,2384160,-9934000,25530380,15596380
13977,2020-02-15,2198,Distribution,-9750,-9749999,21557250,11807251
13977,2020-03-31,2198,Value,1228490,-9749999,21557250,11807251
13977,2020-06-30,2198,Value,1228490,-9749999,21557250,11807251
13977,2020-08-15,2198,Distribution,282750,-9749999,21840000,12090001
13977,2020-09-30,2198,Value,818990,-9749999,21840000,12090001
13977,2020-12-31,2198,Value,804370,-9749999,21840000,12090001
13977,2021-02-14,2198,Capital Call,0,-9749999,21840000,12090001
13977,2021-02-14,2198,Distribution,-53378,-9749999,21786622,12036623
13977,2021-03-31,2198,Value,818180,-9749999,21786622,12036623
13977,2021-05-16,2198,Capital Call,0,-9749999,21786622,12036623
13977,2021-05-16,2198,Distribution,53378,-9749999,21840000,12090001
13977,2021-06-30,2198,Value,1643840,-9749999,21840000,12090001
13977,2021-09-30,2198,Value,839470,-9749999,21840000,12090001
14010,2020-02-15,7225,Distribution,466804,-9860833,8329227,-1531606
14010,2020-03-31,7225,Value,4172810,-9860833,8329227,-1531606
14010,2020-06-30,7225,Value,4127840,-9860833,8329227,-1531606
14010,2020-09-30,7225,Value,4125240,-9860833,8329227,-1531606
14010,2020-11-15,7225,Distribution,2131875,-9860833,10461102,600269
14010,2020-12-31,7225,Value,3399220,-9860833,10461102,600269
14010,2021-02-14,7225,Distribution,638626,-9860833,11099728,1238895
14010,2021-03-31,7225,Value,3249460,-9860833,11099728,1238895
14010,2021-06-30,7225,Value,3280150,-9860833,11099728,1238895
14010,2021-09-30,7225,Value,3775360,-9860833,11099728,1238895
14025,2020-02-15,2212,Capital Call,-23000,-9562000,16452871,6890871
14025,2020-02-15,2212,Distribution,587573,-9562000,17040444,7478444
14025,2020-03-31,2212,Value,4300980,-9562000,17040444,7478444
14025,2020-05-16,2212,Capital Call,-23000,-9585000,17040444,7455444
14025,2020-05-16,2212,Distribution,731,-9585000,17041175,7456175
14025,2020-06-30,2212,Value,4452230,-9585000,17041175,7456175
14025,2020-08-15,2212,Capital Call,-17000,-9602000,17041175,7439175
14025,2020-08-15,2212,Distribution,326926,-9602000,17368101,7766101
14025,2020-09-30,2212,Value,4467810,-9602000,17368101,7766101
14025,2020-11-15,2212,Capital Call,-30000,-9632000,17368101,7736101
14025,2020-11-15,2212,Distribution,15736,-9632000,17383837,7751837
14025,2020-12-31,2212,Value,5128070,-9632000,17383837,7751837
14025,2021-02-14,2212,Distribution,78019,-9632000,17461856,7829856
14025,2021-03-31,2212,Value,5663610,-9632000,17461856,7829856
14025,2021-05-16,2212,Capital Call,-24000,-9656000,17461856,7805856
14025,2021-05-16,2212,Distribution,87927,-9656000,17549783,7893783
14025,2021-06-30,2212,Value,6103550,-9656000,17549783,7893783
14025,2021-09-30,2212,Value,6977420,-9656000,17549783,7893783
14077,2020-02-15,211,Capital Call,-13398,-10756568,14901437,4144869
14077,2020-02-15,211,Distribution,113204,-10756568,15014641,4258073
14077,2020-03-31,211,Value,2345440,-10756568,15014641,4258073
14077,2020-05-16,211,Capital Call,9769,-10746799,15014641,4267842
14077,2020-05-16,211,Distribution,47155,-10746799,15061796,4314997
14077,2020-06-30,211,Value,2406920,-10746799,15061796,4314997
14077,2020-08-15,211,Capital Call,-46305,-10793104,15061796,4268692
14077,2020-08-15,211,Distribution,195915,-10793104,15257711,4464607
14077,2020-09-30,211,Value,2467200,-10793104,15257711,4464607
14077,2020-11-15,211,Capital Call,-4389,-10797493,15257711,4460218
14077,2020-11-15,211,Distribution,73853,-10797493,15331564,4534071
14077,2020-12-31,211,Value,2687290,-10797493,15331564,4534071
14077,2021-02-14,211,Capital Call,-1918,-10799411,15331564,4532153
14077,2021-02-14,211,Distribution,43426,-10799411,15374990,4575579
14077,2021-03-31,211,Value,2761100,-10799411,15374990,4575579
14077,2021-05-16,211,Capital Call,-14304,-10813715,15374990,4561275
14077,2021-05-16,211,Distribution,206328,-10813715,15581318,4767603
14077,2021-06-30,211,Value,2680430,-10813715,15581318,4767603
14080,2020-03-31,17601,Value,45600000,-10000000,19600000,9600000
14080,2020-05-16,17601,Distribution,25300000,-10000000,44900000,34900000
14080,2020-06-30,17601,Value,13100000,-10000000,44900000,34900000
14080,2020-09-30,17601,Distribution,19328000,-10000000,64228000,54228000
14080,2020-12-31,17601,Value,0,-10000000,64228000,54228000
14080,2021-12-31,17601,Value,0,-10000000,64228000,54228000
14103,2020-03-31,7459,Value,11165000,-7000000,13557600,6557600
14103,2020-05-16,7459,Distribution,1705200,-7000000,15262800,8262800
14103,2020-06-30,7459,Value,10929100,-7000000,15262800,8262800
14103,2020-08-15,7459,Distribution,894600,-7000000,16157400,9157400
14103,2020-09-30,7459,Value,11038300,-7000000,16157400,9157400
14103,2020-11-15,7459,Distribution,1152200,-7000000,17309600,10309600
14103,2020-12-31,7459,Value,13846700,-7000000,17309600,10309600
14103,2021-02-14,7459,Distribution,-19600,-7000000,17290000,10290000
14103,2021-03-31,7459,Value,20332900,-7000000,17290000,10290000
14103,2021-05-16,7459,Distribution,3780000,-7000000,21070000,14070000
14103,2021-06-30,7459,Value,13846700,-7000000,21070000,14070000
14103,2021-08-15,7459,Distribution,3010000,-7000000,24080000,17080000
14103,2021-09-30,7459,Value,19663000,-7000000,24080000,17080000
14106,2020-02-15,1357,Distribution,1050000,-10076999,15113000,5036001
14106,2020-03-31,1357,Value,9763790,-10076999,15113000,5036001
14106,2020-05-16,1357,Distribution,950000,-10076999,16063000,5986001
14106,2020-06-30,1357,Value,9483540,-10076999,16063000,5986001
14106,2020-08-15,1357,Distribution,675000,-10076999,16738000,6661001
14106,2020-09-30,1357,Value,10551110,-10076999,16738000,6661001
14106,2020-11-15,1357,Distribution,2500000,-10076999,19238000,9161001
14106,2020-12-31,1357,Value,9230180,-10076999,19238000,9161001
14106,2021-02-14,1357,Distribution,1000000,-10076999,20238000,10161001
14106,2021-03-31,1357,Value,8664930,-10076999,20238000,10161001
14146,2020-03-31,487,Value,3316550,-9599998,2210378,-7389620
14146,2020-06-30,487,Value,4323100,-9599998,2210378,-7389620
14146,2020-12-31,487,Value,4487260,-9599998,2210378,-7389620
14146,2021-03-31,487,Value,5340330,-9599998,2210378,-7389620
14146,2021-06-30,487,Value,5340330,-9599998,2210378,-7389620
14157,2020-03-31,391,Value,0,-8800002,10559999,1759997
14157,2020-06-30,391,Value,0,-8800002,10559999,1759997
14157,2020-09-30,391,Value,0,-8800002,10559999,1759997
14157,2020-12-31,391,Value,0,-8800002,10559999,1759997
14157,2021-03-31,391,Value,0,-8800002,10559999,1759997
14157,2021-06-30,391,Value,0,-8800002,10559999,1759997
14157,2021-09-30,391,Value,0,-8800002,10559999,1759997
14157,2021-12-31,391,Value,0,-8800002,10559999,1759997
14179,2020-03-31,5928,Value,1509600,-9031600,14562008,5530408
14179,2020-05-16,5928,Capital Call,84,-9031516,14562008,5530492
14179,2020-05-16,5928,Distribution,1743,-9031516,14563751,5532235
14179,2020-06-30,5928,Value,1536290,-9031516,14563751,5532235
14179,2020-09-30,5928,Value,1582720,-9031516,14563751,5532235
14179,2020-11-15,5928,Capital Call,-61539,-9093055,14563751,5470696
14179,2020-12-31,5928,Value,1362550,-9093055,14563751,5470696
14179,2021-02-14,5928,Capital Call,-43077,-9136132,14563751,5427619
14179,2021-03-31,5928,Value,1199750,-9136132,14563751,5427619
14179,2021-05-16,5928,Capital Call,-737870,-9874002,14563751,4689749
14179,2021-05-16,5928,Distribution,657019,-9874002,15220770,5346768
14179,2021-06-30,5928,Value,1198700,-9874002,15220770,5346768
14269,2020-03-31,4936,Value,493740,-9302768,14684400,5381632
14269,2020-05-16,4936,Capital Call,-168141,-9470909,14684400,5213491
14269,2020-05-16,4936,Distribution,159776,-9470909,14844176,5373267
14269,2020-06-30,4936,Value,508030,-9470909,14844176,5373267
14269,2020-09-30,4936,Value,405890,-9470909,14844176,5373267
14269,2020-12-31,4936,Value,253260,-9470909,14844176,5373267
14269,2021-02-14,4936,Capital Call,-193780,-9664689,14844176,5179487
14269,2021-03-31,4936,Value,283090,-9664689,14844176,5179487
14274,2020-02-15,270,Capital Call,-54100,-11514681,3520880,-7993801
14274,2020-02-15,270,Distribution,1124136,-11514681,4645016,-6869665
14274,2020-03-31,270,Value,2836430,-11514681,4645016,-6869665
14274,2020-05-16,270,Capital Call,-50752,-11565433,4645016,-6920417
14274,2020-06-30,270,Value,3026120,-11565433,4645016,-6920417
14274,2020-08-15,270,Capital Call,-58946,-11624379,4645016,-6979363
14274,2020-09-30,270,Value,3032930,-11624379,4645016,-6979363
14274,2020-11-15,270,Capital Call,-131885,-11756264,4645016,-7111248
14274,2020-11-15,270,Distribution,313368,-11756264,4958384,-6797880
14274,2020-12-31,270,Value,3517420,-11756264,4958384,-6797880
14274,2021-02-14,270,Capital Call,-224194,-11980458,4958384,-7022074
14274,2021-02-14,270,Distribution,168438,-11980458,5126822,-6853636
14274,2021-03-31,270,Value,3876720,-11980458,5126822,-6853636
14274,2021-05-16,270,Distribution,48447,-11980458,5175269,-6805189
14274,2021-06-30,270,Value,4178340,-11980458,5175269,-6805189
14285,2020-03-31,8452,Capital Call,0,-7586533,12380138,4793605
14285,2020-06-30,8452,Value,147670,-7586533,12380138,4793605
14285,2020-09-30,8452,Value,147040,-7586533,12380138,4793605
14285,2020-11-15,8452,Capital Call,3214,-7583319,12380138,4796819
14285,2020-11-15,8452,Distribution,18456,-7583319,12398594,4815275
14285,2020-12-31,8452,Value,121990,-7583319,12398594,4815275
14285,2021-03-31,8452,Value,120890,-7583319,12398594,4815275
14285,2021-05-16,8452,Capital Call,667962,-6915357,12398594,5483237
14285,2021-06-30,8452,Value,208710,-6915357,12398594,5483237
14365,2020-03-31,332,Distribution,190000,-8169999,13846668,5676669
14365,2020-06-30,332,Value,689990,-8169999,13846668,5676669
14365,2020-09-30,332,Value,720000,-8169999,13846668,5676669
14365,2020-11-15,332,Distribution,93333,-8169999,13940001,5770002
14365,2020-12-31,332,Value,710000,-8169999,13940001,5770002
14365,2021-02-14,332,Distribution,136667,-8169999,14076668,5906669
14365,2021-03-31,332,Value,633330,-8169999,14076668,5906669
14365,2021-06-30,332,Value,713330,-8169999,14076668,5906669
14365,2021-08-15,332,Distribution,1000,-8169999,14077668,5907669
14365,2021-09-30,332,Value,713990,-8169999,14077668,5907669
14403,2020-02-15,1314,Capital Call,9402,-9860000,8779201,-1080799
14403,2020-02-15,1314,Distribution,-8731,-9860000,8770470,-1089530
14403,2020-03-31,1314,Value,1672250,-9860000,8770470,-1089530
14403,2020-05-16,1314,Capital Call,-9408,-9869408,8770470,-1098938
14403,2020-05-16,1314,Distribution,8731,-9869408,8779201,-1090207
14403,2020-06-30,1314,Value,1865300,-9869408,8779201,-1090207
14403,2020-08-15,1314,Capital Call,408,-9869000,8779201,-1089799
14403,2020-08-15,1314,Distribution,-725,-9869000,8778476,-1090524
14403,2020-09-30,1314,Value,1770490,-9869000,8778476,-1090524
14403,2020-11-15,1314,Distribution,-59214,-9869000,8719262,-1149738
14403,2020-12-31,1314,Value,2021170,-9869000,8719262,-1149738
14403,2021-02-14,1314,Distribution,239817,-9869000,8959079,-909921
14403,2021-03-31,1314,Value,250670,-9869000,8959079,-909921
14403,2021-06-30,1314,Value,256590,-9869000,8959079,-909921
14403,2021-08-15,1314,Distribution,93756,-9869000,9052835,-816165
14403,2021-09-30,1314,Value,2120840,-9869000,9052835,-816165
14423,2020-02-15,1886,Distribution,337250,-8750000,13295745,4545745
14423,2020-03-31,1886,Value,4973000,-8750000,13295745,4545745
14423,2020-05-16,1886,Capital Call,0,-8750000,13295745,4545745
14423,2020-05-16,1886,Distribution,-120,-8750000,13295625,4545625
14423,2020-06-30,1886,Value,5425870,-8750000,13295625,4545625
14423,2020-08-15,1886,Distribution,266000,-8750000,13561625,4811625
14423,2020-09-30,1886,Value,5701500,-8750000,13561625,4811625
14423,2020-11-15,1886,Distribution,285250,-8750000,13846875,5096875
14423,2020-12-31,1886,Value,6762870,-8750000,13846875,5096875
14423,2021-02-14,1886,Distribution,475125,-8750000,14322000,5572000
14423,2021-03-31,1886,Value,7121620,-8750000,14322000,5572000
14423,2021-05-16,1886,Distribution,522375,-8750000,14844375,6094375
14423,2021-06-30,1886,Value,7342120,-8750000,14844375,6094375
14423,2021-08-15,1886,Capital Call,0,-8750000,14844375,6094375
14423,2021-08-15,1886,Distribution,1187370,-8750000,16031745,7281745
14423,2021-09-30,1886,Value,6979760,-8750000,16031745,7281745
14424,2020-03-31,1886,Value,4069250,-9075000,8670000,-405000
14424,2020-05-16,1886,Capital Call,0,-9075000,8670000,-405000
14424,2020-05-16,1886,Distribution,255,-9075000,8670255,-404745
14424,2020-06-30,1886,Value,4222590,-9075000,8670255,-404745
14424,2020-08-15,1886,Distribution,149737,-9075000,8819992,-255008
14424,2020-09-30,1886,Value,4263430,-9075000,8819992,-255008
14424,2020-11-15,1886,Capital Call,-80000,-9155000,8819992,-335008
14424,2020-11-15,1886,Distribution,450361,-9155000,9270353,115353
14424,2020-12-31,1886,Value,4031860,-9155000,9270353,115353
14424,2021-02-14,1886,Distribution,349721,-9155000,9620074,465074
14424,2021-03-31,1886,Value,4169180,-9155000,9620074,465074
14424,2021-06-30,1886,Value,4539040,-9155000,9620074,465074
14424,2021-08-15,1886,Distribution,875218,-9155000,10495292,1340292
14424,2021-09-30,1886,Value,3727000,-9155000,10495292,1340292
14425,2020-02-15,1886,Distribution,700000,-9904688,8150000,-1754688
14425,2020-03-31,1886,Value,10081400,-9904688,8150000,-1754688
14425,2020-05-16,1886,Capital Call,-312,-9905000,8150000,-1755000
14425,2020-05-16,1886,Distribution,-166,-9905000,8149834,-1755166
14425,2020-06-30,1886,Value,10850920,-9905000,8149834,-1755166
14425,2020-08-15,1886,Distribution,750799,-9905000,8900633,-1004367
14425,2020-09-30,1886,Value,11513570,-9905000,8900633,-1004367
14425,2020-11-15,1886,Distribution,944937,-9905000,9845570,-59430
14425,2020-12-31,1886,Value,12227720,-9905000,9845570,-59430
14425,2021-02-14,1886,Distribution,449687,-9905000,10295257,390257
14425,2021-03-31,1886,Value,19307810,-9905000,10295257,390257
14425,2021-05-16,1886,Distribution,1799739,-9905000,12094996,2189996
14425,2021-06-30,1886,Value,18872980,-9905000,12094996,2189996
14425,2021-08-15,1886,Distribution,260502,-9905000,12355498,2450498
14425,2021-09-30,1886,Value,18317310,-9905000,12355498,2450498
14427,2020-03-31,1886,Value,4385920,-7010000,5015000,-1995000
14427,2020-05-16,1886,Capital Call,0,-7010000,5015000,-1995000
14427,2020-05-16,1886,Distribution,319610,-7010000,5334610,-1675390
14427,2020-06-30,1886,Value,4354610,-7010000,5334610,-1675390
14427,2020-08-15,1886,Distribution,701,-7010000,5335311,-1674689
14427,2020-09-30,1886,Value,4663750,-7010000,5335311,-1674689
14427,2020-11-15,1886,Distribution,259370,-7010000,5594681,-1415319
14427,2020-12-31,1886,Value,4529860,-7010000,5594681,-1415319
14427,2021-02-14,1886,Distribution,280400,-7010000,5875081,-1134919
14427,2021-03-31,1886,Value,4589440,-7010000,5875081,-1134919
14427,2021-06-30,1886,Value,4594350,-7010000,5875081,-1134919
14427,2021-09-30,1886,Value,4492700,-7010000,5875081,-1134919
14470,2020-03-31,24,Value,4301930,-9800001,10359499,559498
14470,2020-05-16,24,Capital Call,0,-9800001,10359499,559498
14470,2020-05-16,24,Distribution,81,-9800001,10359580,559579
14470,2020-06-30,24,Value,4315040,-9800001,10359580,559579
14470,2020-09-30,24,Value,4567780,-9800001,10359580,559579
14470,2020-11-15,24,Capital Call,0,-9800001,10359580,559579
14470,2020-11-15,24,Distribution,-81,-9800001,10359499,559498
14470,2020-12-31,24,Value,4478470,-9800001,10359499,559498
14470,2021-02-14,24,Capital Call,0,-9800001,10359499,559498
14470,2021-02-14,24,Distribution,81,-9800001,10359580,559579
14470,2021-03-31,24,Value,4599140,-9800001,10359580,559579
14470,2021-06-30,24,Value,4629520,-9800001,10359580,559579
14470,2021-09-30,24,Value,4883340,-9800001,10359580,559579
14537,2020-03-31,2447,Value,2958780,-8455695,12669639,4213944
14537,2020-06-30,2447,Value,2977690,-8455695,12669639,4213944
14537,2020-09-30,2447,Value,3143160,-8455695,12669639,4213944
14537,2020-12-31,2447,Value,3365760,-8455695,12669639,4213944
14537,2021-03-31,2447,Value,4336960,-8455695,12669639,4213944
14584,2020-03-31,93,Value,2128000,-10000000,25755001,15755001
14584,2020-06-30,93,Value,1929000,-10000000,25755001,15755001
14584,2020-09-30,93,Value,1811000,-10000000,25755001,15755001
14584,2020-11-15,93,Distribution,1000,-10000000,25756001,15756001
14584,2020-12-31,93,Value,1825000,-10000000,25756001,15756001
14584,2021-03-31,93,Value,1966000,-10000000,25756001,15756001
14584,2021-06-30,93,Value,2184000,-10000000,25756001,15756001
14591,2020-02-15,8980,Distribution,-65904,-10000000,6234096,-3765904
14591,2020-03-31,8980,Value,47747460,-10000000,6234096,-3765904
14591,2020-05-16,8980,Distribution,3265904,-10000000,9500000,-500000
14591,2020-06-30,8980,Value,53500000,-10000000,9500000,-500000
14591,2020-08-15,8980,Distribution,20143145,-10000000,29643145,19643145
14591,2020-09-30,8980,Value,36759300,-10000000,29643145,19643145
14591,2020-12-31,8980,Value,39292610,-10000000,29643145,19643145
14591,2021-02-14,8980,Distribution,7390855,-10000000,37034000,27034000
14591,2021-03-31,8980,Value,29395000,-10000000,37034000,27034000
14591,2021-05-16,8980,Distribution,1416074,-10000000,38450074,28450074
14591,2021-06-30,8980,Value,29100000,-10000000,38450074,28450074
14591,2021-08-15,8980,Distribution,-74,-10000000,38450000,28450000
14591,2021-09-30,8980,Value,24500000,-10000000,38450000,28450000
14597,2020-02-15,18,Capital Call,0,-9180000,9202951,22951
14597,2020-02-15,18,Distribution,599146,-9180000,9802097,622097
14597,2020-03-31,18,Value,6939530,-9180000,9802097,622097
14597,2020-05-16,18,Distribution,627358,-9180000,10429455,1249455
14597,2020-06-30,18,Value,7115630,-9180000,10429455,1249455
14597,2020-08-15,18,Distribution,411105,-9180000,10840560,1660560
14597,2020-09-30,18,Value,8344530,-9180000,10840560,1660560
14597,2020-11-15,18,Distribution,848115,-9180000,11688675,2508675
14597,2020-12-31,18,Value,9082630,-9180000,11688675,2508675
14597,2021-02-14,18,Distribution,547389,-9180000,12236064,3056064
14597,2021-03-31,18,Value,9797620,-9180000,12236064,3056064
14597,2021-05-16,18,Capital Call,10,-9179990,12236064,3056074
14597,2021-05-16,18,Distribution,1684953,-9179990,13921017,4741027
14597,2021-06-30,18,Value,9184050,-9179990,13921017,4741027
14597,2021-08-15,18,Distribution,786167,-9179990,14707184,5527194
14597,2021-09-30,18,Value,9273050,-9179990,14707184,5527194
14621,2020-02-15,555,Capital Call,-6232,-8631074,24048524,15417450
14621,2020-02-15,555,Distribution,628,-8631074,24049152,15418078
14621,2020-03-31,555,Value,1564000,-8631074,24049152,15418078
14621,2020-05-16,555,Capital Call,-5372,-8636446,24049152,15412706
14621,2020-06-30,555,Value,1564000,-8636446,24049152,15412706
14621,2020-08-15,555,Capital Call,-2449,-8638895,24049152,15410257
14621,2020-09-30,555,Value,1382580,-8638895,24049152,15410257
14621,2020-12-31,555,Value,1190710,-8638895,24049152,15410257
14621,2021-03-31,555,Value,1253410,-8638895,24049152,15410257
14621,2021-05-16,555,Capital Call,694076,-7944819,24049152,16104333
14621,2021-06-30,555,Value,1366680,-7944819,24049152,16104333
14629,2020-03-31,5496,Value,3778810,-8505443,1331017,-7174426
14629,2020-06-30,5496,Value,5345520,-8505443,1331017,-7174426
14629,2020-09-30,5496,Value,6345450,-8505443,1331017,-7174426
14629,2020-12-31,5496,Value,5795480,-8505443,1331017,-7174426
14629,2021-03-31,5496,Value,5696910,-8505443,1331017,-7174426
14629,2021-06-30,5496,Value,5138420,-8505443,1331017,-7174426
14634,2021-12-31,5175,Value,0,-8550000,5472000,-3078000
14656,2020-02-15,3612,Distribution,17460,-6913917,10315870,3401953
14656,2020-03-31,3612,Value,217070,-6913917,10315870,3401953
14656,2020-06-30,3612,Value,223680,-6913917,10315870,3401953
14656,2020-09-30,3612,Value,232490,-6913917,10315870,3401953
14656,2020-11-15,3612,Capital Call,-10849,-6924766,10315870,3391104
14656,2020-12-31,3612,Value,230290,-6924766,10315870,3391104
14656,2021-02-14,3612,Capital Call,-7356,-6932122,10315870,3383748
14656,2021-03-31,3612,Value,229070,-6932122,10315870,3383748
14737,2020-03-31,2500,Value,5557210,-10078467,5691492,-4386975
14737,2020-06-30,2500,Value,5389800,-10078467,5691492,-4386975
14737,2020-09-30,2500,Value,8165060,-10078467,5691492,-4386975
14737,2020-11-15,2500,Distribution,995893,-10078467,6687385,-3391082
14737,2020-12-31,2500,Value,6058660,-10078467,6687385,-3391082
14737,2021-02-14,2500,Distribution,652500,-10078467,7339885,-2738582
14737,2021-03-31,2500,Value,7891820,-10078467,7339885,-2738582
14769,2021-12-31,9403,Value,0,-10051688,12780645,2728957
14798,2020-02-15,361,Capital Call,-4000,-9540400,12830800,3290400
14798,2020-02-15,361,Distribution,509400,-9540400,13340200,3799800
14798,2020-03-31,361,Value,12402000,-9540400,13340200,3799800
14798,2020-05-16,361,Capital Call,-7600,-9548000,13340200,3792200
14798,2020-05-16,361,Distribution,944200,-9548000,14284400,4736400
14798,2020-06-30,361,Value,13494000,-9548000,14284400,4736400
14798,2020-08-15,361,Capital Call,-3600,-9551600,14284400,4732800
14798,2020-08-15,361,Distribution,2162200,-9551600,16446600,6895000
14798,2020-09-30,361,Value,13638600,-9551600,16446600,6895000
14798,2020-11-15,361,Distribution,7487800,-9551600,23934400,14382800
14798,2020-12-31,361,Value,6489400,-9551600,23934400,14382800
14798,2021-02-14,361,Capital Call,-2400,-9554000,23934400,14380400
14798,2021-02-14,361,Distribution,1909800,-9554000,25844200,16290200
14798,2021-03-31,361,Value,5357800,-9554000,25844200,16290200
14798,2021-05-16,361,Capital Call,-1200,-9555200,25844200,16289000
14798,2021-05-16,361,Distribution,750200,-9555200,26594400,17039200
14798,2021-06-30,361,Value,5258600,-9555200,26594400,17039200
14798,2021-08-15,361,Capital Call,55200,-9500000,26594400,17094400
14798,2021-08-15,361,Distribution,5600,-9500000,26600000,17100000
14798,2021-09-30,361,Value,4750000,-9500000,26600000,17100000
14808,2020-03-31,741,Value,3219990,-11060000,12520000,1460000
14808,2020-06-30,741,Value,3399990,-11060000,12520000,1460000
14808,2020-09-30,741,Value,3500000,-11060000,12520000,1460000
14808,2020-11-15,741,Capital Call,-20000,-11080000,12520000,1440000
14808,2020-11-15,741,Distribution,360000,-11080000,12880000,1800000
14808,2020-12-31,741,Value,3380000,-11080000,12880000,1800000
14808,2021-03-31,741,Value,3420000,-11080000,12880000,1800000
14808,2021-06-30,741,Value,3339990,-11080000,12880000,1800000
14808,2021-09-30,741,Value,2980000,-11080000,12880000,1800000
14818,2020-02-15,17285,Distribution,488118,-10007650,8160720,-1846930
14818,2020-03-31,17285,Value,8834520,-10007650,8160720,-1846930
14818,2020-05-16,17285,Distribution,393930,-10007650,8554650,-1453000
14818,2020-06-30,17285,Value,10454980,-10007650,8554650,-1453000
14818,2020-08-15,17285,Distribution,1222677,-10007650,9777327,-230323
14818,2020-09-30,17285,Value,9937170,-10007650,9777327,-230323
14818,2020-11-15,17285,Distribution,1309147,-10007650,11086474,1078824
14818,2020-12-31,17285,Value,11711860,-10007650,11086474,1078824
14818,2021-02-14,17285,Distribution,137267,-10007650,11223741,1216091
14818,2021-03-31,17285,Value,12104810,-10007650,11223741,1216091
14818,2021-05-16,17285,Distribution,3089808,-10007650,14313549,4305899
14818,2021-06-30,17285,Value,12504660,-10007650,14313549,4305899
14818,2021-12-31,17285,Value,0,-10007650,14313549,4305899
14837,2020-03-31,1986,Value,4547000,-10000000,4633808,-5366192
14837,2020-06-30,1986,Value,4625110,-10000000,4633808,-5366192
14837,2020-09-30,1986,Value,4483470,-10000000,4633808,-5366192
14837,2020-12-31,1986,Value,4874820,-10000000,4633808,-5366192
14837,2021-03-31,1986,Value,5249980,-10000000,4633808,-5366192
14837,2021-06-30,1986,Value,5460060,-10000000,4633808,-5366192
14869,2020-07-01,2094,Distribution,803004,-10294626,10219526,-75100
14869,2020-12-31,2094,Value,0,-10294626,10219526,-75100
14869,2021-06-30,2094,Value,0,-10294626,10219526,-75100
14869,2021-09-30,2094,Value,0,-10294626,10219526,-75100
14869,2021-12-31,2094,Value,0,-10294626,10219526,-75100
14880,2020-03-31,9022,Value,6545090,-10422782,36500990,26078208
14880,2020-05-16,9022,Distribution,921844,-10422782,37422834,27000052
14880,2020-06-30,9022,Value,5623250,-10422782,37422834,27000052
14880,2020-09-30,9022,Value,6040160,-10422782,37422834,27000052
14880,2020-11-15,9022,Distribution,677274,-10422782,38100108,27677326
14880,2020-12-31,9022,Value,6822080,-10422782,38100108,27677326
14880,2021-03-31,9022,Value,6822080,-10422782,38100108,27677326
14880,2021-06-30,9022,Value,7030530,-10422782,38100108,27677326
14884,2020-03-31,8417,Value,8395350,-9999999,9465665,-534334
14884,2020-05-16,8417,Distribution,1315308,-9999999,10780973,780974
14884,2020-06-30,8417,Value,6691910,-9999999,10780973,780974
14884,2020-09-30,8417,Distribution,634675,-9999999,11415648,1415649
14884,2020-12-31,8417,Value,6554900,-9999999,11415648,1415649
14884,2021-03-31,8417,Value,5585280,-9999999,11415648,1415649
14884,2021-06-30,8417,Value,5585280,-9999999,11415648,1415649
14907,2020-02-15,2562,Distribution,287430,-6700000,14337330,7637330
14907,2020-03-31,2562,Value,4296040,-6700000,14337330,7637330
14907,2020-06-30,2562,Value,3532910,-6700000,14337330,7637330
14907,2020-08-15,2562,Distribution,295470,-6700000,14632800,7932800
14907,2020-09-30,2562,Value,3463900,-6700000,14632800,7932800
14908,2020-02-15,1360,Distribution,260000,-9173334,15339999,6166665
14908,2020-03-31,1360,Value,820000,-9173334,15339999,6166665
14908,2020-06-30,1360,Value,820000,-9173334,15339999,6166665
14908,2020-09-30,1360,Value,820000,-9173334,15339999,6166665
14908,2020-12-31,1360,Value,519990,-9173334,15339999,6166665
14908,2021-03-31,1360,Value,519990,-9173334,15339999,6166665
14908,2021-06-30,1360,Value,519990,-9173334,15339999,6166665
14908,2021-08-15,1360,Capital Call,-2667,-9176001,15339999,6163998
14908,2021-08-15,1360,Distribution,-2667,-9176001,15337332,6161331
14908,2021-09-30,1360,Value,517330,-9176001,15337332,6161331
14910,2020-03-31,9189,Value,3089070,-10000056,6627529,-3372527
14910,2020-06-30,9189,Value,3050220,-10000056,6627529,-3372527
14910,2020-09-30,9189,Value,2887550,-10000056,6627529,-3372527
14910,2020-12-31,9189,Value,2923760,-10000056,6627529,-3372527
14910,2021-03-31,9189,Value,2954220,-10000056,6627529,-3372527
14910,2021-06-30,9189,Value,2938220,-10000056,6627529,-3372527
14913,2020-03-31,1571,Value,1277320,-10000000,5276341,-4723659
14913,2020-06-30,1571,Value,1274610,-10000000,5276341,-4723659
14913,2020-08-15,1571,Distribution,60553,-10000000,5336894,-4663106
14913,2020-09-30,1571,Value,0,-10000000,5336894,-4663106
14913,2021-03-31,1571,Value,0,-10000000,5336894,-4663106
14913,2021-06-30,1571,Value,0,-10000000,5336894,-4663106
14913,2021-09-30,1571,Value,0,-10000000,5336894,-4663106
14913,2021-12-31,1571,Value,0,-10000000,5336894,-4663106
14924,2020-03-31,3599,Value,13230,-12006239,10192065,-1814174
14925,2020-02-15,832,Capital Call,-224000,-11290000,6141630,-5148370
14925,2020-02-15,832,Distribution,9162,-11290000,6150792,-5139208
14925,2020-03-31,832,Value,2647500,-11290000,6150792,-5139208
14925,2020-05-16,832,Capital Call,-48000,-11338000,6150792,-5187208
14925,2020-05-16,832,Distribution,198488,-11338000,6349280,-4988720
14925,2020-06-30,832,Value,2608870,-11338000,6349280,-4988720
14925,2020-08-15,832,Distribution,1134,-11338000,6350414,-4987586
14925,2020-09-30,832,Value,2794810,-11338000,6350414,-4987586
14925,2020-11-15,832,Capital Call,-10000,-11348000,6350414,-4997586
14925,2020-11-15,832,Distribution,250718,-11348000,6601132,-4746868
14925,2020-12-31,832,Value,3168360,-11348000,6601132,-4746868
14925,2021-03-31,832,Value,3514470,-11348000,6601132,-4746868
14925,2021-06-30,832,Value,3983140,-11348000,6601132,-4746868
14925,2021-08-15,832,Capital Call,-52000,-11400000,6601132,-4798868
14925,2021-08-15,832,Distribution,1977368,-11400000,8578500,-2821500
14925,2021-09-30,832,Value,2280000,-11400000,8578500,-2821500
14925,2021-12-31,832,Value,2492040,-11400000,8578500,-2821500
14933,2020-03-31,2005,Value,1216850,-8466325,4146862,-4319463
14933,2020-06-30,2005,Value,558200,-8466325,4146862,-4319463
14933,2020-09-30,2005,Value,508100,-8466325,4146862,-4319463
14933,2020-12-31,2005,Value,547160,-8466325,4146862,-4319463
14933,2021-03-31,2005,Value,589780,-8466325,4146862,-4319463
14933,2021-06-30,2005,Value,571160,-8466325,4146862,-4319463
14939,2020-03-31,20331,Value,4354650,-9860509,13602593,3742084
14939,2020-05-16,20331,Distribution,4815811,-9860509,18418404,8557895
14939,2020-06-30,20331,Value,1156710,-9860509,18418404,8557895
14939,2020-09-30,20331,Value,1310950,-9860509,18418404,8557895
14939,2020-12-31,20331,Value,1342160,-9860509,18418404,8557895
14939,2021-03-31,20331,Value,1601440,-9860509,18418404,8557895
14939,2021-06-30,20331,Value,1644970,-9860509,18418404,8557895
14939,2021-09-30,20331,Value,1869860,-9860509,18418404,8557895
14962,2020-03-31,376,Value,1329900,-10230000,14884650,4654650
14962,2020-05-16,376,Capital Call,-10000,-10240000,14884650,4644650
14962,2020-05-16,376,Distribution,45270,-10240000,14929920,4689920
14962,2020-06-30,376,Value,1873920,-10240000,14929920,4689920
14962,2020-09-30,376,Capital Call,-80000,-10320000,14929920,4609920
14962,2020-09-30,376,Distribution,23760,-10320000,14953680,4633680
14962,2020-12-31,376,Value,2507760,-10320000,14953680,4633680
14962,2021-02-14,376,Capital Call,-10000,-10330000,14953680,4623680
14962,2021-02-14,376,Distribution,4160,-10330000,14957840,4627840
14962,2021-03-31,376,Value,2654810,-10330000,14957840,4627840
14986,2020-02-15,756,Capital Call,-48308,-11517441,13736253,2218812
14986,2020-03-31,756,Value,4115770,-11517441,13736253,2218812
14986,2020-05-16,756,Capital Call,-35862,-11553303,13736253,2182950
14986,2020-06-30,756,Value,4286890,-11553303,13736253,2182950
14986,2020-09-30,756,Value,4633490,-11553303,13736253,2182950
14986,2020-11-15,756,Capital Call,-170425,-11723728,13736253,2012525
14986,2020-12-31,756,Value,6076840,-11723728,13736253,2012525
14986,2021-03-31,756,Value,6545790,-11723728,13736253,2012525
14986,2021-06-30,756,Value,7249210,-11723728,13736253,2012525
15133,2020-03-31,211,Distribution,120000,-9420000,15680000,6260000
15133,2020-09-30,211,Value,4440000,-9420000,15680000,6260000
15133,2020-12-31,211,Value,3880000,-9420000,15680000,6260000
15133,2021-02-14,211,Distribution,3860000,-9420000,19540000,10120000
15133,2021-03-31,211,Value,0,-9420000,19540000,10120000
15133,2021-06-30,211,Value,0,-9420000,19540000,10120000
15133,2021-12-31,211,Value,0,-9420000,19540000,10120000
15138,2020-03-31,211,Value,4607690,-10495578,9237850,-1257728
15138,2020-05-16,211,Distribution,124136,-10495578,9361986,-1133592
15138,2020-06-30,211,Value,4386910,-10495578,9361986,-1133592
15138,2020-09-30,211,Value,4386910,-10495578,9361986,-1133592
15138,2020-11-15,211,Distribution,686367,-10495578,10048353,-447225
15138,2020-12-31,211,Value,4173170,-10495578,10048353,-447225
15138,2021-02-14,211,Distribution,608176,-10495578,10656529,160951
15138,2021-03-31,211,Value,3938030,-10495578,10656529,160951
15158,2020-03-31,20997,Value,0,-10148744,12636923,2488179
15158,2020-06-30,20997,Value,0,-10148744,12636923,2488179
15158,2020-09-30,20997,Value,0,-10148744,12636923,2488179
15158,2020-12-31,20997,Value,0,-10148744,12636923,2488179
15158,2021-03-31,20997,Value,0,-10148744,12636923,2488179
15158,2021-06-30,20997,Value,0,-10148744,12636923,2488179
15158,2021-09-30,20997,Value,0,-10148744,12636923,2488179
15158,2021-12-31,20997,Value,0,-10148744,12636923,2488179
15159,2020-02-15,20998,Distribution,222018,-11544751,19305249,7760498
15159,2020-03-31,20998,Value,3207200,-11544751,19305249,7760498
15159,2020-05-16,20998,Capital Call,-25687,-11570438,19305249,7734811
15159,2020-05-16,20998,Distribution,493098,-11570438,19798347,8227909
15159,2020-06-30,20998,Value,2832760,-11570438,19798347,8227909
15159,2020-09-30,20998,Value,2851830,-11570438,19798347,8227909
15159,2020-12-31,20998,Value,2851240,-11570438,19798347,8227909
15159,2021-03-31,20998,Value,2905370,-11570438,19798347,8227909
15159,2021-05-16,20998,Capital Call,-29066,-11599504,19798347,8198843
15159,2021-05-16,20998,Distribution,631320,-11599504,20429667,8830163
15159,2021-06-30,20998,Value,2370400,-11599504,20429667,8830163
15253,2020-02-15,140,Capital Call,-11007,-10945404,10397298,-548106
15253,2020-02-15,140,Distribution,14006,-10945404,10411304,-534100
15253,2020-03-31,140,Value,1663580,-10945404,10411304,-534100
15253,2020-06-30,140,Value,1518810,-10945404,10411304,-534100
15253,2020-09-30,140,Value,1571260,-10945404,10411304,-534100
15253,2020-12-30,140,Capital Call,-18329,-10963733,10411304,-552429
15253,2020-12-30,140,Distribution,352549,-10963733,10763853,-199880
15253,2021-03-31,140,Value,1302560,-10963733,10763853,-199880
15253,2021-05-16,140,Capital Call,-6275,-10970008,10763853,-206155
15253,2021-05-16,140,Distribution,41021,-10970008,10804874,-165134
15253,2021-06-30,140,Value,1278690,-10970008,10804874,-165134
15255,2020-03-31,14411,Value,5407780,-6736440,8153049,1416609
15255,2020-05-16,14411,Capital Call,-117318,-6853758,8153049,1299291
15255,2020-05-16,14411,Distribution,503027,-6853758,8656076,1802318
15255,2020-06-30,14411,Value,5148970,-6853758,8656076,1802318
15255,2020-08-15,14411,Capital Call,-39106,-6892864,8656076,1763212
15255,2020-08-15,14411,Distribution,189191,-6892864,8845267,1952403
15255,2020-09-30,14411,Value,5609360,-6892864,8845267,1952403
15255,2020-12-31,14411,Value,5609360,-6892864,8845267,1952403
15255,2021-02-14,14411,Capital Call,-31441,-6924305,8845267,1920962
15255,2021-02-14,14411,Distribution,491136,-6924305,9336403,2412098
15255,2021-03-31,14411,Value,6026670,-6924305,9336403,2412098
15256,2020-03-31,14411,Capital Call,-31580,-9384616,7144825,-2239791
15256,2020-03-31,14411,Distribution,651062,-9384616,7795887,-1588729
15256,2020-06-30,14411,Value,4741720,-9384616,7795887,-1588729
15256,2020-09-30,14411,Value,4951600,-9384616,7795887,-1588729
15256,2020-11-15,14411,Capital Call,102331,-9282285,7795887,-1486398
15256,2020-11-15,14411,Distribution,316114,-9282285,8112001,-1170284
15256,2020-12-31,14411,Value,4744570,-9282285,8112001,-1170284
15256,2021-02-14,14411,Capital Call,-10795,-9293080,8112001,-1181079
15256,2021-02-14,14411,Distribution,395405,-9293080,8507406,-785674
15256,2021-03-31,14411,Value,4658160,-9293080,8507406,-785674
15257,2020-03-31,236,Value,8031600,-10000000,4545600,-5454400
15257,2020-06-30,236,Value,8283600,-10000000,4545600,-5454400
15257,2020-09-30,236,Value,8411200,-10000000,4545600,-5454400
15257,2020-12-31,236,Value,8571600,-10000000,4545600,-5454400
15257,2021-03-31,236,Value,9398400,-10000000,4545600,-5454400
15257,2021-06-30,236,Value,10716000,-10000000,4545600,-5454400
15305,2020-03-31,68,Value,22223000,-10000001,15072000,5071999
15305,2020-05-16,68,Distribution,1359500,-10000001,16431500,6431499
15305,2020-06-30,68,Value,20974500,-10000001,16431500,6431499
15305,2020-09-30,68,Value,29076000,-10000001,16431500,6431499
15305,2020-11-15,68,Distribution,2831000,-10000001,19262500,9262499
15305,2020-12-31,68,Value,36051000,-10000001,19262500,9262499
15334,2020-03-31,10131,Value,3820000,-10000000,10949000,949000
15334,2020-05-16,10131,Distribution,51000,-10000000,11000000,1000000
15334,2020-06-30,10131,Value,3445000,-10000000,11000000,1000000
15334,2020-08-15,10131,Distribution,173000,-10000000,11173000,1173000
15334,2020-09-30,10131,Value,3201000,-10000000,11173000,1173000
15334,2021-02-14,10131,Distribution,1215000,-10000000,12388000,2388000
15334,2021-06-30,10131,Value,2647000,-10000000,12388000,2388000
15364,2020-03-31,4170,Value,3317580,-11418515,12831662,1413147
15400,2020-03-31,355,Distribution,782560,-9500000,7649735,-1850265
15400,2020-06-30,355,Value,12635540,-9500000,7649735,-1850265
15400,2020-08-15,355,Distribution,608762,-9500000,8258497,-1241503
15400,2020-09-30,355,Value,15373230,-9500000,8258497,-1241503
15400,2020-11-15,355,Distribution,970675,-9500000,9229172,-270828
15400,2020-12-31,355,Value,18267950,-9500000,9229172,-270828
15400,2021-02-14,355,Distribution,1605644,-9500000,10834816,1334816
15400,2021-03-31,355,Value,18990480,-9500000,10834816,1334816
15408,2020-02-15,355,Distribution,211536,-8275000,5957788,-2317212
15408,2020-03-31,355,Value,7884760,-8275000,5957788,-2317212
15408,2020-05-16,355,Capital Call,-250000,-8525000,5957788,-2567212
15408,2020-05-16,355,Distribution,971528,-8525000,6929316,-1595684
15408,2020-06-30,355,Value,7726780,-8525000,6929316,-1595684
15408,2020-08-15,355,Distribution,249534,-8525000,7178850,-1346150
15408,2020-09-30,355,Value,8291190,-8525000,7178850,-1346150
15408,2020-11-15,355,Distribution,700365,-8525000,7879215,-645785
15408,2020-12-31,355,Value,8688750,-8525000,7879215,-645785
15408,2021-02-14,355,Distribution,498644,-8525000,8377859,-147141
15408,2021-03-31,355,Value,8957550,-8525000,8377859,-147141
15408,2021-05-16,355,Distribution,1176277,-8525000,9554136,1029136
15408,2021-06-30,355,Value,9420720,-8525000,9554136,1029136
15412,2020-03-31,5020,Value,2314380,-9300000,13443510,4143510
15412,2020-06-30,5020,Value,2007790,-9300000,13443510,4143510
15412,2020-09-30,5020,Value,1848030,-9300000,13443510,4143510
15412,2020-11-15,5020,Distribution,338493,-9300000,13782003,4482003
15412,2020-12-31,5020,Value,1573470,-9300000,13782003,4482003
15412,2021-02-14,5020,Distribution,100742,-9300000,13882745,4582745
15412,2021-03-31,5020,Value,1602490,-9300000,13882745,4582745
15412,2021-06-30,5020,Value,1645460,-9300000,13882745,4582745
15412,2021-08-15,5020,Distribution,277133,-9300000,14159878,4859878
15412,2021-09-30,5020,Value,1440240,-9300000,14159878,4859878
15432,2020-02-15,2562,Distribution,670200,-6000000,16015800,10015800
15432,2020-03-31,2562,Value,6247200,-6000000,16015800,10015800
15432,2020-06-30,2562,Value,5995200,-6000000,16015800,10015800
15432,2020-09-30,2562,Value,5994000,-6000000,16015800,10015800
15452,2020-02-15,1642,Capital Call,-125000,-10037456,10739686,702230
15452,2020-03-31,1642,Value,7528480,-10037456,10739686,702230
15452,2020-05-16,1642,Distribution,180664,-10037456,10920350,882894
15452,2020-06-30,1642,Value,8451940,-10037456,10920350,882894
15452,2020-08-15,1642,Distribution,63416,-10037456,10983766,946310
15452,2020-09-30,1642,Value,8790020,-10037456,10983766,946310
15452,2020-12-31,1642,Value,9693390,-10037456,10983766,946310
15452,2021-03-31,1642,Value,12403500,-10037456,10983766,946310
15452,2021-05-16,1642,Distribution,72766,-10037456,11056532,1019076
15452,2021-06-30,1642,Value,13334480,-10037456,11056532,1019076
15496,2020-02-15,690,Distribution,11200,-9175200,19239600,10064400
15496,2020-03-31,690,Value,2746000,-9175200,19239600,10064400
15496,2020-06-30,690,Value,2808800,-9175200,19239600,10064400
15496,2020-09-30,690,Value,4891600,-9175200,19239600,10064400
15496,2020-11-15,690,Distribution,2994800,-9175200,22234400,13059200
15496,2020-12-31,690,Value,2018400,-9175200,22234400,13059200
15496,2021-03-31,690,Value,2072800,-9175200,22234400,13059200
15496,2021-06-30,690,Value,2197600,-9175200,22234400,13059200
15533,2020-02-15,436,Capital Call,29091,-10989091,10970907,-18184
15533,2020-02-15,436,Distribution,2541818,-10989091,13512725,2523634
15533,2020-03-31,436,Value,6476360,-10989091,13512725,2523634
15533,2020-05-16,436,Distribution,240000,-10989091,13752725,2763634
15533,2020-06-30,436,Value,6970900,-10989091,13752725,2763634
15533,2020-08-15,436,Capital Call,-29091,-11018182,13752725,2734543
15533,2020-08-15,436,Distribution,425455,-11018182,14178180,3159998
15533,2020-09-30,436,Value,7370900,-11018182,14178180,3159998
15533,2020-11-15,436,Capital Call,-105455,-11123637,14178180,3054543
15533,2020-11-15,436,Distribution,610909,-11123637,14789089,3665452
15533,2020-12-31,436,Value,7345450,-11123637,14789089,3665452
15533,2021-02-14,436,Distribution,149091,-11123637,14938180,3814543
15533,2021-03-31,436,Value,7879990,-11123637,14938180,3814543
15533,2021-05-16,436,Distribution,1472727,-11123637,16410907,5287270
15533,2021-06-30,436,Value,6825450,-11123637,16410907,5287270
15533,2021-08-15,436,Capital Call,-1091,-11124728,16410907,5286179
15533,2021-08-15,436,Distribution,628000,-11124728,17038907,5914179
15533,2021-09-30,436,Value,6797090,-11124728,17038907,5914179
15537,2020-03-31,553,Value,5746660,-9986667,5213333,-4773334
15537,2020-06-30,553,Value,5746660,-9986667,5213333,-4773334
15537,2020-09-30,553,Value,6760000,-9986667,5213333,-4773334
15537,2020-11-15,553,Distribution,1440000,-9986667,6653333,-3333334
15537,2020-12-31,553,Value,5733330,-9986667,6653333,-3333334
15537,2021-03-31,553,Value,5800000,-9986667,6653333,-3333334
15537,2021-06-30,553,Value,8346660,-9986667,6653333,-3333334
15537,2021-08-15,553,Distribution,440000,-9986667,7093333,-2893334
15537,2021-09-30,553,Value,8053330,-9986667,7093333,-2893334
15550,2020-02-15,18,Capital Call,0,-9749091,20217664,10468573
15550,2020-02-15,18,Distribution,91,-9749091,20217755,10468664
15550,2020-03-31,18,Value,7181990,-9749091,20217755,10468664
15550,2020-05-16,18,Distribution,1112924,-9749091,21330679,11581588
15550,2020-06-30,18,Value,7916670,-9749091,21330679,11581588
15550,2020-08-15,18,Distribution,521974,-9749091,21852653,12103562
15550,2020-09-30,18,Value,7423140,-9749091,21852653,12103562
15550,2020-11-15,18,Distribution,407792,-9749091,22260445,12511354
15550,2020-12-31,18,Value,8342880,-9749091,22260445,12511354
15550,2021-02-14,18,Distribution,247006,-9749091,22507451,12758360
15550,2021-03-31,18,Value,8808230,-9749091,22507451,12758360
15550,2021-05-16,18,Capital Call,91,-9749000,22507451,12758451
15550,2021-05-16,18,Distribution,822358,-9749000,23329809,13580809
15550,2021-06-30,18,Value,8038460,-9749000,23329809,13580809
15550,2021-09-30,18,Value,9822070,-9749000,23329809,13580809
15562,2020-02-15,11706,Distribution,2074000,-12199999,20496000,8296001
15562,2020-03-31,11706,Value,11102000,-12199999,20496000,8296001
15562,2020-06-30,11706,Value,11346000,-12199999,20496000,8296001
15562,2020-08-15,11706,Capital Call,-100000,-12299999,20496000,8196001
15562,2020-08-15,11706,Distribution,291000,-12299999,20787000,8487001
15562,2020-09-30,11706,Value,10332000,-12299999,20787000,8487001
15562,2020-11-15,11706,Distribution,123000,-12299999,20910000,8610001
15562,2020-12-31,11706,Value,8118000,-12299999,20910000,8610001
15562,2021-03-31,11706,Value,8118000,-12299999,20910000,8610001
15562,2021-05-16,11706,Distribution,1107000,-12299999,22017000,9717001
15562,2021-06-30,11706,Value,7380000,-12299999,22017000,9717001
15562,2021-09-30,11706,Value,7257000,-12299999,22017000,9717001
15580,2020-02-15,18,Capital Call,-358,-8810071,7897521,-912550
15580,2020-02-15,18,Distribution,678017,-8810071,8575538,-234533
15580,2020-03-31,18,Value,7380500,-8810071,8575538,-234533
15580,2020-05-16,18,Distribution,742703,-8810071,9318241,508170
15580,2020-06-30,18,Value,7500670,-8810071,9318241,508170
15580,2020-08-15,18,Distribution,388416,-8810071,9706657,896586
15580,2020-09-30,18,Value,8771560,-8810071,9706657,896586
15580,2020-11-15,18,Distribution,446922,-8810071,10153579,1343508
15580,2020-12-31,18,Value,9998740,-8810071,10153579,1343508
15580,2021-02-14,18,Distribution,708574,-8810071,10862153,2052082
15580,2021-03-31,18,Value,10619450,-8810071,10862153,2052082
15580,2021-05-16,18,Capital Call,72,-8809999,10862153,2052154
15580,2021-05-16,18,Distribution,1753457,-8809999,12615610,3805611
15580,2021-06-30,18,Value,9969210,-8809999,12615610,3805611
15580,2021-08-15,18,Distribution,851582,-8809999,13467192,4657193
15580,2021-09-30,18,Value,10345440,-8809999,13467192,4657193
15607,2020-01-15,30882,Capital Call,-84483,-9977031,3952917,-6024114
15607,2020-01-15,30882,Distribution,1063965,-9977031,5016882,-4960149
15607,2020-02-29,30882,Value,9569000,-9977031,5016882,-4960149
15607,2020-04-15,30882,Capital Call,0,-9977031,5016882,-4960149
15607,2020-04-15,30882,Distribution,158711,-9977031,5175593,-4801438
15607,2020-05-31,30882,Value,6855830,-9977031,5175593,-4801438
15607,2020-07-16,30882,Distribution,1296823,-9977031,6472416,-3504615
15607,2020-08-31,30882,Value,5435720,-9977031,6472416,-3504615
15607,2020-10-16,30882,Distribution,131872,-9977031,6604288,-3372743
15607,2020-11-30,30882,Value,6006210,-9977031,6604288,-3372743
15607,2021-02-28,30882,Value,7892040,-9977031,6604288,-3372743
15607,2021-04-15,30882,Capital Call,-34483,-10011514,6604288,-3407226
15607,2021-04-15,30882,Distribution,458850,-10011514,7063138,-2948376
15607,2021-05-31,30882,Value,7502920,-10011514,7063138,-2948376
15607,2021-08-31,30882,Value,8571080,-10011514,7063138,-2948376
15607,2021-10-16,30882,Capital Call,0,-10011514,7063138,-2948376
15607,2021-10-16,30882,Distribution,0,-10011514,7063138,-2948376
15607,2021-11-30,30882,Value,9119780,-10011514,7063138,-2948376
15631,2020-02-15,244,Distribution,2100000,-9100000,19970002,10870002
15631,2020-03-31,244,Value,1460000,-9100000,19970002,10870002
15631,2020-06-30,244,Value,1883330,-9100000,19970002,10870002
15631,2020-09-30,244,Value,1996660,-9100000,19970002,10870002
15631,2020-12-31,244,Value,2003330,-9100000,19970002,10870002
15631,2021-02-14,244,Distribution,186667,-9100000,20156669,11056669
15631,2021-03-31,244,Value,2060000,-9100000,20156669,11056669
15631,2021-05-16,244,Distribution,2143333,-9100000,22300002,13200002
15631,2021-06-30,244,Value,403330,-9100000,22300002,13200002
15631,2021-09-30,244,Value,1131720,-9100000,22300002,13200002
15631,2021-12-31,244,Value,0,-9100000,22300002,13200002
15681,2020-03-31,21626,Value,2886920,-9406471,15334944,5928473
15681,2020-05-16,21626,Distribution,772518,-9406471,16107462,6700991
15681,2020-06-30,21626,Value,2761140,-9406471,16107462,6700991
15681,2020-09-30,21626,Capital Call,-13072,-9419543,16107462,6687919
15681,2020-09-30,21626,Distribution,636444,-9419543,16743906,7324363
15681,2020-12-31,21626,Value,3149030,-9419543,16743906,7324363
15681,2021-02-14,21626,Capital Call,-56922,-9476465,16743906,7267441
15681,2021-02-14,21626,Distribution,1029107,-9476465,17773013,8296548
15681,2021-03-31,21626,Value,3019480,-9476465,17773013,8296548
15681,2021-05-16,21626,Distribution,555416,-9476465,18328429,8851964
15681,2021-06-30,21626,Value,2996120,-9476465,18328429,8851964
15707,2020-02-15,140,Capital Call,-36359,-12796672,20919630,8122958
15707,2020-02-15,140,Distribution,519180,-12796672,21438810,8642138
15707,2020-03-31,140,Value,81900,-12796672,21438810,8642138
15707,2020-05-16,140,Distribution,28770,-12796672,21467580,8670908
15707,2020-06-30,140,Value,52630,-12796672,21467580,8670908
15707,2020-09-30,140,Value,51870,-12796672,21467580,8670908
15707,2021-12-31,140,Value,0,-12796672,21467580,8670908
15708,2020-02-15,9407,Distribution,114620,-7510734,7490190,-20544
15708,2020-03-31,9407,Value,6598060,-7510734,7490190,-20544
15708,2020-06-30,9407,Value,6476500,-7510734,7490190,-20544
15708,2020-08-15,9407,Distribution,1409844,-7510734,8900034,1389300
15708,2020-09-30,9407,Value,5331300,-7510734,8900034,1389300
15708,2020-12-30,9407,Distribution,1333754,-7510734,10233788,2723054
15708,2021-03-31,9407,Value,5043970,-7510734,10233788,2723054
15708,2021-05-16,9407,Distribution,333439,-7510734,10567227,3056493
15708,2021-06-30,9407,Value,5224110,-7510734,10567227,3056493
15715,2020-02-15,22035,Capital Call,200000,-10044730,2176474,-7868256
15715,2020-03-31,22035,Value,20476270,-10044730,2176474,-7868256
15715,2020-05-16,22035,Distribution,1009844,-10044730,3186318,-6858412
15715,2020-06-30,22035,Value,20011500,-10044730,3186318,-6858412
15715,2020-09-30,22035,Value,19345760,-10044730,3186318,-6858412
15715,2020-11-15,22035,Distribution,-250000,-10044730,2936318,-7108412
15715,2020-12-31,22035,Value,19576830,-10044730,2936318,-7108412
15715,2021-02-14,22035,Distribution,-150000,-10044730,2786318,-7258412
15715,2021-03-31,22035,Value,19862720,-10044730,2786318,-7258412
15715,2021-06-30,22035,Value,20958550,-10044730,2786318,-7258412
15715,2021-08-15,22035,Distribution,1703016,-10044730,4489334,-5555396
15715,2021-09-30,22035,Value,23691100,-10044730,4489334,-5555396
15749,2020-03-31,2258,Value,3087600,-13503291,20386236,6882945
15749,2020-05-16,2258,Distribution,555490,-13503291,20941726,7438435
15749,2020-06-30,2258,Value,2577990,-13503291,20941726,7438435
15749,2020-09-30,2258,Value,2576050,-13503291,20941726,7438435
15749,2020-12-31,2258,Value,3087760,-13503291,20941726,7438435
15749,2021-04-01,2258,Distribution,517398,-13503291,21459124,7955833
15749,2021-06-30,2258,Value,2418810,-13503291,21459124,7955833
15765,2020-03-31,718,Value,5483550,-9824999,18872928,9047929
15765,2020-05-16,718,Distribution,303225,-9824999,19176153,9351154
15765,2020-06-30,718,Value,11927800,-9824999,19176153,9351154
15765,2020-08-15,718,Distribution,1950362,-9824999,21126515,11301516
15765,2020-09-30,718,Value,10796860,-9824999,21126515,11301516
15765,2020-11-15,718,Capital Call,-25000,-9849999,21126515,11276516
15765,2020-11-15,718,Distribution,1976410,-9849999,23102925,13252926
15765,2020-12-31,718,Value,10947700,-9849999,23102925,13252926
15765,2021-02-14,718,Distribution,1575000,-9849999,24677925,14827926
15765,2021-03-31,718,Value,10565110,-9849999,24677925,14827926
15765,2021-05-16,718,Distribution,1342598,-9849999,26020523,16170524
15765,2021-06-30,718,Value,10300280,-9849999,26020523,16170524
15765,2021-08-15,718,Distribution,3637622,-9849999,29658145,19808146
15765,2021-09-30,718,Value,8891740,-9849999,29658145,19808146
15777,2020-03-31,9455,Value,2980720,-10000000,9259134,-740866
15777,2020-06-30,9455,Value,3126660,-10000000,9259134,-740866
15777,2020-09-30,9455,Value,3140150,-10000000,9259134,-740866
15777,2020-11-15,9455,Distribution,990724,-10000000,10249858,249858
15777,2020-12-31,9455,Value,2179910,-10000000,10249858,249858
15777,2021-02-14,9455,Distribution,432125,-10000000,10681983,681983
15777,2021-03-31,9455,Value,1758710,-10000000,10681983,681983
15777,2021-06-30,9455,Value,1739920,-10000000,10681983,681983
15829,2020-03-31,902,Value,8078590,-9642950,3492950,-6150000
15829,2020-06-30,902,Value,8560730,-9642950,3492950,-6150000
15829,2020-09-30,902,Value,10007180,-9642950,3492950,-6150000
15829,2020-12-31,902,Value,11646480,-9642950,3492950,-6150000
15829,2021-03-31,902,Value,10585750,-9642950,3492950,-6150000
15829,2021-05-16,902,Distribution,350000,-9642950,3842950,-5800000
15829,2021-06-30,902,Value,16792960,-9642950,3842950,-5800000
15936,2020-02-15,6372,Capital Call,-8000,-10307999,11682001,1374002
15936,2020-02-15,6372,Distribution,1536000,-10307999,13218001,2910002
15936,2020-03-31,6372,Value,5469990,-10307999,13218001,2910002
15936,2020-05-16,6372,Capital Call,-6000,-10313999,13218001,2904002
15936,2020-05-16,6372,Distribution,142000,-10313999,13360001,3046002
15936,2020-06-30,6372,Value,6897990,-10313999,13360001,3046002
15936,2020-08-15,6372,Capital Call,-12000,-10325999,13360001,3034002
15936,2020-08-15,6372,Distribution,290000,-10325999,13650001,3324002
15936,2020-09-30,6372,Value,9131990,-10325999,13650001,3324002
15936,2020-11-15,6372,Capital Call,-6000,-10331999,13650001,3318002
15936,2020-11-15,6372,Distribution,1596000,-10331999,15246001,4914002
15936,2020-12-31,6372,Value,7535990,-10331999,15246001,4914002
15936,2021-02-14,6372,Capital Call,-6000,-10337999,15246001,4908002
15936,2021-02-14,6372,Distribution,176000,-10337999,15422001,5084002
15936,2021-03-31,6372,Value,9763990,-10337999,15422001,5084002
15936,2021-05-16,6372,Distribution,266000,-10337999,15688001,5350002
15936,2021-06-30,6372,Value,9497990,-10337999,15688001,5350002
15936,2021-08-15,6372,Capital Call,-2000,-10339999,15688001,5348002
15936,2021-08-15,6372,Distribution,190000,-10339999,15878001,5538002
15936,2021-09-30,6372,Value,9705990,-10339999,15878001,5538002
15942,2020-02-15,1759,Distribution,99005,-11124149,18954429,7830280
15942,2020-03-31,1759,Value,556200,-11124149,18954429,7830280
15942,2020-06-30,1759,Value,556200,-11124149,18954429,7830280
15942,2020-09-30,1759,Value,556200,-11124149,18954429,7830280
15942,2020-11-15,1759,Capital Call,-25855,-11150004,18954429,7804425
15942,2020-11-15,1759,Distribution,496744,-11150004,19451173,8301169
15942,2020-12-31,1759,Value,111500,-11150004,19451173,8301169
15942,2021-02-14,1759,Distribution,5575,-11150004,19456748,8306744
15942,2021-03-31,1759,Value,111500,-11150004,19456748,8306744
15942,2021-06-30,1759,Value,111500,-11150004,19456748,8306744
15942,2021-08-15,1759,Capital Call,-50000,-11200004,19456748,8256744
15942,2021-08-15,1759,Distribution,87250,-11200004,19543998,8343994
15942,2021-09-30,1759,Value,111830,-11200004,19543998,8343994
15954,2020-02-15,871,Capital Call,25424,-9744577,16515796,6771219
15954,2020-03-31,871,Value,5717100,-9744577,16515796,6771219
15954,2020-05-16,871,Capital Call,-15000,-9759577,16515796,6756219
15954,2020-05-16,871,Distribution,17122,-9759577,16532918,6773341
15954,2020-06-30,871,Value,5717100,-9759577,16532918,6773341
15954,2020-09-30,871,Value,5653820,-9759577,16532918,6773341
15954,2020-11-15,871,Capital Call,-130424,-9890001,16532918,6642917
15954,2020-11-15,871,Distribution,108984,-9890001,16641902,6751901
15954,2020-12-31,871,Value,5927070,-9890001,16641902,6751901
15954,2021-05-17,871,Capital Call,-17000,-9907001,16641902,6734901
15954,2021-05-17,871,Distribution,6039183,-9907001,22681085,12774084
15954,2021-09-30,871,Value,3848860,-9907001,22681085,12774084
15956,2020-03-31,22557,Value,1941940,-10000097,15526041,5525944
15956,2020-06-30,22557,Value,1913260,-10000097,15526041,5525944
15956,2020-09-30,22557,Value,1884810,-10000097,15526041,5525944
15956,2020-12-31,22557,Value,1525370,-10000097,15526041,5525944
15956,2021-02-14,22557,Distribution,222049,-10000097,15748090,5747993
15956,2021-03-31,22557,Value,1121550,-10000097,15748090,5747993
15956,2021-06-30,22557,Value,886580,-10000097,15748090,5747993
15964,2020-02-15,17188,Distribution,343200,-8000000,14792000,6792000
15964,2020-03-31,17188,Value,1156800,-8000000,14792000,6792000
15964,2020-06-30,17188,Value,1333600,-8000000,14792000,6792000
15964,2020-08-15,17188,Distribution,8000,-8000000,14800000,6800000
15964,2020-09-30,17188,Value,1300000,-8000000,14800000,6800000
15964,2020-11-15,17188,Distribution,256000,-8000000,15056000,7056000
15964,2020-12-31,17188,Value,579200,-8000000,15056000,7056000
15964,2021-02-14,17188,Distribution,800,-8000000,15056800,7056800
15964,2021-03-31,17188,Value,504000,-8000000,15056800,7056800
15964,2021-05-16,17188,Distribution,443200,-8000000,15500000,7500000
15964,2021-06-30,17188,Value,0,-8000000,15500000,7500000
15964,2021-09-30,17188,Value,0,-8000000,15500000,7500000
15964,2021-12-31,17188,Value,0,-8000000,15500000,7500000
15977,2020-03-31,588,Value,2237400,-9660866,11947828,2286962
15977,2020-05-16,588,Capital Call,-2962,-9663828,11947828,2284000
15977,2020-05-16,588,Distribution,180000,-9663828,12127828,2464000
15977,2020-06-30,588,Value,1831160,-9663828,12127828,2464000
15977,2020-08-15,588,Distribution,270000,-9663828,12397828,2734000
15977,2020-09-30,588,Value,1616560,-9663828,12397828,2734000
15977,2020-12-31,588,Value,1633550,-9663828,12397828,2734000
15977,2021-02-14,588,Capital Call,-693,-9664521,12397828,2733307
15977,2021-02-14,588,Distribution,144000,-9664521,12541828,2877307
15977,2021-03-31,588,Value,1489550,-9664521,12541828,2877307
15977,2021-05-16,588,Capital Call,-34,-9664555,12541828,2877273
15977,2021-05-16,588,Distribution,315000,-9664555,12856828,3192273
15977,2021-06-30,588,Value,1555650,-9664555,12856828,3192273
16005,2020-02-15,465,Capital Call,-20000,-11050000,16120000,5070000
16005,2020-03-31,465,Value,1879990,-11050000,16120000,5070000
16005,2020-05-16,465,Capital Call,-10000,-11060000,16120000,5060000
16005,2020-05-16,465,Distribution,50000,-11060000,16170000,5110000
16005,2020-06-30,465,Value,2349990,-11060000,16170000,5110000
16005,2020-09-30,465,Value,2899990,-11060000,16170000,5110000
16005,2020-12-31,465,Value,3659990,-11060000,16170000,5110000
16005,2021-02-14,465,Capital Call,-10000,-11070000,16170000,5100000
16005,2021-02-14,465,Distribution,250000,-11070000,16420000,5350000
16005,2021-03-31,465,Value,3439990,-11070000,16420000,5350000
16005,2021-05-16,465,Distribution,2610000,-11070000,19030000,7960000
16005,2021-06-30,465,Value,860000,-11070000,19030000,7960000
16005,2021-09-30,465,Value,1039990,-11070000,19030000,7960000
16011,2020-03-31,5777,Value,2902610,-10295589,8946137,-1349452
16011,2020-05-16,5777,Capital Call,-85189,-10380778,8946137,-1434641
16011,2020-05-16,5777,Distribution,285806,-10380778,9231943,-1148835
16011,2020-06-30,5777,Value,2775010,-10380778,9231943,-1148835
16011,2020-12-31,5777,Value,3056100,-10380778,9231943,-1148835
16011,2021-03-31,5777,Value,3031020,-10380778,9231943,-1148835
16011,2021-05-16,5777,Capital Call,-100360,-10481138,9231943,-1249195
16011,2021-05-16,5777,Distribution,258731,-10481138,9490674,-990464
16011,2021-06-30,5777,Value,3031020,-10481138,9490674,-990464
16012,2020-02-15,9004,Distribution,126000,-9850000,15148669,5298669
16012,2020-03-31,9004,Value,2477330,-9850000,15148669,5298669
16012,2020-06-30,9004,Value,2720660,-9850000,15148669,5298669
16012,2020-09-30,9004,Value,2714000,-9850000,15148669,5298669
16012,2020-11-15,9004,Capital Call,-50000,-9900000,15148669,5248669
16012,2020-12-31,9004,Value,20470660,-9900000,15148669,5248669
16012,2021-03-31,9004,Value,11854000,-9900000,15148669,5248669
16012,2021-06-30,9004,Value,8338000,-9900000,15148669,5248669
16023,2020-02-15,1886,Capital Call,-100000,-9530456,10896489,1366033
16023,2020-03-31,1886,Value,2169900,-9530456,10896489,1366033
16023,2020-05-16,1886,Capital Call,456,-9530000,10896489,1366489
16023,2020-05-16,1886,Distribution,-1182,-9530000,10895307,1365307
16023,2020-06-30,1886,Value,2313210,-9530000,10895307,1365307
16023,2020-08-15,1886,Capital Call,270,-9529730,10895307,1365577
16023,2020-08-15,1886,Distribution,260332,-9529730,11155639,1625909
16023,2020-09-30,1886,Value,2078750,-9529730,11155639,1625909
16023,2020-11-15,1886,Capital Call,-270,-9530000,11155639,1625639
16023,2020-11-15,1886,Distribution,179,-9530000,11155818,1625818
16023,2020-12-31,1886,Value,1926600,-9530000,11155818,1625818
16023,2021-02-14,1886,Capital Call,282,-9529718,11155818,1626100
16023,2021-02-14,1886,Distribution,399786,-9529718,11555604,2025886
16023,2021-03-31,1886,Value,1755310,-9529718,11555604,2025886
16023,2021-05-16,1886,Capital Call,-282,-9530000,11555604,2025604
16023,2021-05-16,1886,Distribution,474,-9530000,11556078,2026078
16023,2021-06-30,1886,Value,1574350,-9530000,11556078,2026078
16023,2021-08-15,1886,Capital Call,-456,-9530456,11556078,2025622
16023,2021-08-15,1886,Distribution,200411,-9530456,11756489,2226033
16023,2021-09-30,1886,Value,1380270,-9530456,11756489,2226033
16036,2020-02-15,579,Capital Call,-102957,-9461541,9490959,29418
16036,2020-02-15,579,Distribution,178175,-9461541,9669134,207593
16036,2020-03-31,579,Value,6886690,-9461541,9669134,207593
16036,2020-05-16,579,Capital Call,-18459,-9480000,9669134,189134
16036,2020-05-16,579,Distribution,190069,-9480000,9859203,379203
16036,2020-06-30,579,Value,7451280,-9480000,9859203,379203
16065,2020-03-31,32667,Value,76130,-9464810,16438106,6973296
16065,2020-06-30,32667,Value,80130,-9464810,16438106,6973296
16065,2020-09-30,32667,Value,80000,-9464810,16438106,6973296
16065,2020-11-15,32667,Distribution,84680,-9464810,16522786,7057976
16065,2020-12-31,32667,Value,84670,-9464810,16522786,7057976
16065,2021-02-14,32667,Distribution,-84680,-9464810,16438106,6973296
16065,2021-03-31,32667,Value,84670,-9464810,16438106,6973296
16101,2020-02-15,23,Distribution,450000,-9620000,5550000,-4070000
16101,2020-03-31,23,Value,3703970,-9620000,5550000,-4070000
16101,2020-06-30,23,Value,4222110,-9620000,5550000,-4070000
16101,2020-09-30,23,Value,4529160,-9620000,5550000,-4070000
16101,2020-12-31,23,Value,5309010,-9620000,5550000,-4070000
16101,2021-03-31,23,Value,4819650,-9620000,5550000,-4070000
16101,2021-06-30,23,Value,5886550,-9620000,5550000,-4070000
16146,2020-01-15,9112,Distribution,893461,-12000000,9192043,-2807957
16146,2020-02-29,9112,Value,18977610,-12000000,9192043,-2807957
16146,2020-04-15,9112,Distribution,726109,-12000000,9918152,-2081848
16146,2020-05-31,9112,Value,19965320,-12000000,9918152,-2081848
16146,2020-07-16,9112,Capital Call,-199999,-12199999,9918152,-2281847
16146,2020-07-16,9112,Distribution,761998,-12199999,10680150,-1519849
16146,2020-08-31,9112,Value,19920610,-12199999,10680150,-1519849
16146,2020-10-16,9112,Distribution,263508,-12199999,10943658,-1256341
16146,2020-11-30,9112,Value,21070390,-12199999,10943658,-1256341
16146,2021-01-14,9112,Distribution,570015,-12199999,11513673,-686326
16146,2021-02-28,9112,Value,20982300,-12199999,11513673,-686326
16146,2021-04-15,9112,Distribution,107734,-12199999,11621407,-578592
16146,2021-05-31,9112,Value,21567600,-12199999,11621407,-578592
16146,2021-07-16,9112,Capital Call,-150001,-12350000,11621407,-728593
16146,2021-07-16,9112,Distribution,1137577,-12350000,12758984,408984
16146,2021-08-31,9112,Value,41867210,-12350000,12758984,408984
16146,2021-10-16,9112,Distribution,549451,-12350000,13308435,958435
16146,2021-11-30,9112,Value,36156510,-12350000,13308435,958435
16147,2020-03-31,22829,Value,8045290,-9944579,13254544,3309965
16147,2020-05-16,22829,Capital Call,43948,-9900631,13254544,3353913
16147,2020-05-16,22829,Distribution,449505,-9900631,13704049,3803418
16147,2020-06-30,22829,Value,9599030,-9900631,13704049,3803418
16147,2020-08-15,22829,Capital Call,-58040,-9958671,13704049,3745378
16147,2020-08-15,22829,Distribution,494969,-9958671,14199018,4240347
16147,2020-09-30,22829,Value,11394690,-9958671,14199018,4240347
16147,2020-11-15,22829,Distribution,1257065,-9958671,15456083,5497412
16147,2020-12-31,22829,Value,13284660,-9958671,15456083,5497412
16147,2021-02-14,22829,Capital Call,-41330,-10000001,15456083,5456082
16147,2021-02-14,22829,Distribution,550859,-10000001,16006942,6006941
16147,2021-03-31,22829,Value,13044750,-10000001,16006942,6006941
16148,2020-01-15,22991,Distribution,0,-9999999,12173603,2173604
16148,2020-02-29,22991,Value,61600,-9999999,12173603,2173604
16148,2020-04-15,22991,Distribution,0,-9999999,12173603,2173604
16148,2020-05-31,22991,Value,59800,-9999999,12173603,2173604
16148,2020-08-31,22991,Value,58050,-9999999,12173603,2173604
16148,2020-11-30,22991,Value,56580,-9999999,12173603,2173604
16148,2021-02-28,22991,Value,55340,-9999999,12173603,2173604
16148,2021-05-31,22991,Value,54050,-9999999,12173603,2173604
16148,2021-08-31,22991,Value,53690,-9999999,12173603,2173604
16148,2021-10-16,22991,Distribution,0,-9999999,12173603,2173604
16148,2021-12-31,22991,Value,0,-9999999,12173603,2173604
16149,2020-02-15,910,Capital Call,-25251,-10909917,14089902,3179985
16149,2020-02-15,910,Distribution,3250046,-10909917,17339948,6430031
16149,2020-03-31,910,Value,12873000,-10909917,17339948,6430031
16149,2020-05-16,910,Capital Call,-23880,-10933797,17339948,6406151
16149,2020-05-16,910,Distribution,1371946,-10933797,18711894,7778097
16149,2020-06-30,910,Value,13727230,-10933797,18711894,7778097
16149,2020-08-15,910,Capital Call,-31691,-10965488,18711894,7746406
16149,2020-08-15,910,Distribution,1211017,-10965488,19922911,8957423
16149,2020-09-30,910,Value,14155520,-10965488,19922911,8957423
16149,2020-11-15,910,Capital Call,-13358,-10978846,19922911,8944065
16149,2020-11-15,910,Distribution,480881,-10978846,20403792,9424946
16149,2020-12-31,910,Value,17548060,-10978846,20403792,9424946
16149,2021-02-14,910,Capital Call,-41769,-11020615,20403792,9383177
16149,2021-02-14,910,Distribution,1634302,-11020615,22038094,11017479
16149,2021-03-31,910,Value,20234760,-11020615,22038094,11017479
16150,2020-02-15,910,Capital Call,-32988,-10023545,14168415,4144870
16150,2020-02-15,910,Distribution,422884,-10023545,14591299,4567754
16150,2020-03-31,910,Value,1512600,-10023545,14591299,4567754
16150,2020-05-16,910,Capital Call,-2999,-10026544,14591299,4564755
16150,2020-05-16,910,Distribution,91612,-10026544,14682911,4656367
16150,2020-06-30,910,Value,1470660,-10026544,14682911,4656367
16150,2020-08-15,910,Capital Call,-19095,-10045639,14682911,4637272
16150,2020-08-15,910,Distribution,135597,-10045639,14818508,4772869
16150,2020-09-30,910,Value,1471040,-10045639,14818508,4772869
16150,2020-11-15,910,Capital Call,-21880,-10067519,14818508,4750989
16150,2020-11-15,910,Distribution,155328,-10067519,14973836,4906317
16150,2020-12-31,910,Value,1513150,-10067519,14973836,4906317
16150,2021-02-14,910,Capital Call,-1878,-10069397,14973836,4904439
16150,2021-02-14,910,Distribution,25604,-10069397,14999440,4930043
16150,2021-03-31,910,Value,1644410,-10069397,14999440,4930043
16152,2020-01-15,14405,Capital Call,0,-9515794,3551942,-5963852
16152,2020-01-15,14405,Distribution,52652,-9515794,3604594,-5911200
16152,2020-02-29,14405,Value,626450,-9515794,3604594,-5911200
16152,2020-04-15,14405,Capital Call,0,-9515794,3604594,-5911200
16152,2020-04-15,14405,Distribution,0,-9515794,3604594,-5911200
16152,2020-05-31,14405,Value,562250,-9515794,3604594,-5911200
16152,2020-08-31,14405,Value,465570,-9515794,3604594,-5911200
16152,2020-11-30,14405,Value,387170,-9515794,3604594,-5911200
16152,2021-02-28,14405,Value,529080,-9515794,3604594,-5911200
16152,2021-04-15,14405,Distribution,50785,-9515794,3655379,-5860415
16152,2021-05-31,14405,Value,399120,-9515794,3655379,-5860415
16152,2021-08-31,14405,Value,457350,-9515794,3655379,-5860415
16152,2021-10-16,14405,Capital Call,0,-9515794,3655379,-5860415
16152,2021-10-16,14405,Distribution,0,-9515794,3655379,-5860415
16152,2021-11-30,14405,Value,448420,-9515794,3655379,-5860415
16154,2020-06-30,16986,Value,838830,-15860175,26567439,10707264
16179,2020-03-31,302,Value,7249990,-9540000,15860000,6320000
16179,2020-06-30,302,Value,7990000,-9540000,15860000,6320000
16179,2020-09-30,302,Value,9920000,-9540000,15860000,6320000
16179,2020-11-15,302,Distribution,2170000,-9540000,18030000,8490000
16179,2020-12-31,302,Value,9910000,-9540000,18030000,8490000
16179,2021-03-31,302,Value,11450000,-9540000,18030000,8490000
16179,2021-05-16,302,Distribution,3560000,-9540000,21590000,12050000
16179,2021-06-30,302,Value,11580000,-9540000,21590000,12050000
16179,2021-08-15,302,Distribution,6830000,-9540000,28420000,18880000
16179,2021-09-30,302,Value,4749990,-9540000,28420000,18880000
16206,2020-02-15,1314,Capital Call,-60000,-9710000,4981333,-4728667
16206,2020-02-15,1314,Distribution,60102,-9710000,5041435,-4668565
16206,2020-03-31,1314,Value,3013980,-9710000,5041435,-4668565
16206,2020-05-16,1314,Capital Call,0,-9710000,5041435,-4668565
16206,2020-05-16,1314,Distribution,263,-9710000,5041698,-4668302
16206,2020-06-30,1314,Value,3126710,-9710000,5041698,-4668302
16206,2020-08-15,1314,Capital Call,0,-9710000,5041698,-4668302
16206,2020-08-15,1314,Distribution,-263,-9710000,5041435,-4668565
16206,2020-09-30,1314,Value,3009120,-9710000,5041435,-4668565
16206,2020-11-15,1314,Capital Call,6000,-9704000,5041435,-4662565
16206,2020-11-15,1314,Distribution,-3115,-9704000,5038320,-4665680
16206,2020-12-31,1314,Value,3232400,-9704000,5038320,-4665680
16206,2021-02-14,1314,Capital Call,-41000,-9745000,5038320,-4706680
16206,2021-02-14,1314,Distribution,38828,-9745000,5077148,-4667852
16206,2021-03-31,1314,Value,1390610,-9745000,5077148,-4667852
16206,2021-06-30,1314,Value,1499750,-9745000,5077148,-4667852
16206,2021-08-15,1314,Capital Call,-50000,-9795000,5077148,-4717852
16206,2021-08-15,1314,Distribution,72087,-9795000,5149235,-4645765
16206,2021-09-30,1314,Value,4061000,-9795000,5149235,-4645765
16208,2020-02-15,355,Distribution,908333,-9697917,5693749,-4004168
16208,2020-03-31,355,Value,8402080,-9697917,5693749,-4004168
16208,2020-05-16,355,Distribution,631250,-9697917,6324999,-3372918
16208,2020-06-30,355,Value,7860410,-9697917,6324999,-3372918
16208,2020-09-30,355,Value,7668750,-9697917,6324999,-3372918
16208,2020-12-31,355,Value,7652080,-9697917,6324999,-3372918
16208,2021-02-14,355,Distribution,108333,-9697917,6433332,-3264585
16208,2021-03-31,355,Value,7475000,-9697917,6433332,-3264585
16208,2021-06-30,355,Value,7464580,-9697917,6433332,-3264585
16208,2021-08-15,355,Distribution,1245833,-9697917,7679165,-2018752
16208,2021-09-30,355,Value,11349640,-9697917,7679165,-2018752
16248,2020-02-15,1314,Capital Call,-125000,-8474999,6237448,-2237551
16248,2020-02-15,1314,Distribution,422205,-8474999,6659653,-1815346
16248,2020-03-31,1314,Value,7885140,-8474999,6659653,-1815346
16248,2020-05-16,1314,Capital Call,-200000,-8674999,6659653,-2015346
16248,2020-05-16,1314,Distribution,292490,-8674999,6952143,-1722856
16248,2020-06-30,1314,Value,8186590,-8674999,6952143,-1722856
16248,2020-09-30,1314,Value,8773020,-8674999,6952143,-1722856
16248,2020-11-15,1314,Distribution,675783,-8674999,7627926,-1047073
16248,2020-12-31,1314,Value,9243210,-8674999,7627926,-1047073
16248,2021-02-14,1314,Distribution,847547,-8674999,8475473,-199526
16248,2021-03-31,1314,Value,8790370,-8674999,8475473,-199526
16248,2021-05-16,1314,Distribution,436353,-8674999,8911826,236827
16248,2021-06-30,1314,Value,9598020,-8674999,8911826,236827
16248,2021-08-15,1314,Distribution,-92823,-8674999,8819003,144004
16248,2021-09-30,1314,Value,9074050,-8674999,8819003,144004
16262,2020-03-31,2115,Value,419990,-10849999,10979998,129999
16262,2020-06-30,2115,Value,419990,-10849999,10979998,129999
16262,2020-09-30,2115,Value,650000,-10849999,10979998,129999
16262,2020-11-15,2115,Distribution,150000,-10849999,11129998,279999
16262,2020-12-31,2115,Value,0,-10849999,11129998,279999
16262,2021-03-31,2115,Value,0,-10849999,11129998,279999
16262,2021-06-30,2115,Value,0,-10849999,11129998,279999
16262,2021-09-30,2115,Value,0,-10849999,11129998,279999
16262,2021-12-31,2115,Value,0,-10849999,11129998,279999
16302,2020-02-15,8966,Capital Call,-73401,-9931524,619020,-9312504
16302,2020-02-15,8966,Distribution,23384,-9931524,642404,-9289120
16302,2020-03-31,8966,Value,2835710,-9931524,642404,-9289120
16302,2020-06-30,8966,Value,3271240,-9931524,642404,-9289120
16302,2020-08-15,8966,Capital Call,-40152,-9971676,642404,-9329272
16302,2020-08-15,8966,Distribution,173657,-9971676,816061,-9155615
16302,2020-09-30,8966,Value,3427930,-9971676,816061,-9155615
16302,2020-11-15,8966,Capital Call,-67996,-10039672,816061,-9223611
16302,2020-11-15,8966,Distribution,1290157,-10039672,2106218,-7933454
16302,2020-12-31,8966,Value,72130,-10039672,2106218,-7933454
16302,2021-03-31,8966,Value,69180,-10039672,2106218,-7933454
16302,2021-06-30,8966,Value,68860,-10039672,2106218,-7933454
16394,2020-03-31,184,Value,3150000,-8110000,9670000,1560000
16394,2020-06-30,184,Value,2759990,-8110000,9670000,1560000
16394,2020-08-15,184,Capital Call,-80000,-8190000,9670000,1480000
16394,2020-08-15,184,Distribution,150000,-8190000,9820000,1630000
16394,2020-09-30,184,Value,2929990,-8190000,9820000,1630000
16394,2020-11-15,184,Distribution,220000,-8190000,10040000,1850000
16394,2020-12-31,184,Value,1959990,-8190000,10040000,1850000
16394,2021-02-14,184,Distribution,1960000,-8190000,12000000,3810000
16394,2021-03-31,184,Value,0,-8190000,12000000,3810000
16394,2021-06-30,184,Value,0,-8190000,12000000,3810000
16394,2021-09-30,184,Value,0,-8190000,12000000,3810000
16396,2020-03-31,181,Distribution,169966,-9998000,15786843,5788843
16396,2020-06-30,181,Value,3206350,-9998000,15786843,5788843
16396,2020-12-31,181,Value,3866220,-9998000,15786843,5788843
16396,2021-04-01,181,Distribution,2779444,-9998000,18566287,8568287
16396,2021-06-30,181,Value,1960600,-9998000,18566287,8568287
16397,2020-02-15,423991,Distribution,91429,-9542855,14314285,4771430
16397,2020-03-31,423991,Value,2588570,-9542855,14314285,4771430
16397,2020-05-16,423991,Capital Call,-11429,-9554284,14314285,4760001
16397,2020-06-30,423991,Value,2611420,-9554284,14314285,4760001
16397,2020-08-15,423991,Capital Call,-11429,-9565713,14314285,4748572
16397,2020-08-15,423991,Distribution,74286,-9565713,14388571,4822858
16397,2020-09-30,423991,Value,2799990,-9565713,14388571,4822858
16397,2020-11-15,423991,Capital Call,-5714,-9571427,14388571,4817144
16397,2020-12-31,423991,Value,2685710,-9571427,14388571,4817144
16397,2021-02-14,423991,Capital Call,-11429,-9582856,14388571,4805715
16397,2021-03-31,423991,Value,2799990,-9582856,14388571,4805715
16397,2021-05-16,423991,Capital Call,-5714,-9588570,14388571,4800001
16397,2021-06-30,423991,Value,3017140,-9588570,14388571,4800001
16397,2021-08-15,423991,Capital Call,-13143,-9601713,14388571,4786858
16397,2021-08-15,423991,Distribution,96571,-9601713,14485142,4883429
16397,2021-09-30,423991,Value,2902280,-9601713,14485142,4883429
16420,2020-02-15,231,Distribution,837000,-10000000,9104003,-895997
16420,2020-03-31,231,Value,4182000,-10000000,9104003,-895997
16420,2020-06-30,231,Value,4451000,-10000000,9104003,-895997
16420,2020-09-30,231,Value,4169000,-10000000,9104003,-895997
16420,2020-11-15,231,Distribution,240000,-10000000,9344003,-655997
16420,2020-12-31,231,Value,3938000,-10000000,9344003,-655997
16420,2021-03-31,231,Value,3975000,-10000000,9344003,-655997
16420,2021-06-30,231,Value,4645000,-10000000,9344003,-655997
16420,2021-08-15,231,Distribution,279000,-10000000,9623003,-376997
16420,2021-09-30,231,Value,4334000,-10000000,9623003,-376997
16420,2021-11-15,231,Distribution,1567000,-10000000,11190003,1190003
16420,2021-12-31,231,Value,3019000,-10000000,11190003,1190003
16471,2020-03-31,436,Value,0,-10059999,10120360,60361
16471,2020-06-30,436,Value,0,-10059999,10120360,60361
16471,2020-09-30,436,Value,0,-10059999,10120360,60361
16471,2020-12-31,436,Value,0,-10059999,10120360,60361
16471,2021-03-31,436,Value,0,-10059999,10120360,60361
16471,2021-06-30,436,Value,0,-10059999,10120360,60361
16471,2021-09-30,436,Value,0,-10059999,10120360,60361
16471,2021-12-31,436,Value,0,-10059999,10120360,60361
16483,2020-02-15,161,Capital Call,-6400,-9793600,18189200,8395600
16483,2020-03-31,161,Value,3086400,-9793600,18189200,8395600
16483,2020-05-16,161,Capital Call,-8000,-9801600,18189200,8387600
16483,2020-06-30,161,Value,3510400,-9801600,18189200,8387600
16483,2020-08-15,161,Capital Call,-195200,-9996800,18189200,8192400
16483,2020-08-15,161,Distribution,11200,-9996800,18200400,8203600
16483,2020-09-30,161,Value,4918000,-9996800,18200400,8203600
16483,2020-11-15,161,Capital Call,-2000,-9998800,18200400,8201600
16483,2020-11-15,161,Distribution,2830800,-9998800,21031200,11032400
16483,2020-12-31,161,Value,2620400,-9998800,21031200,11032400
16483,2021-03-31,161,Value,2994400,-9998800,21031200,11032400
16483,2021-05-16,161,Distribution,204800,-9998800,21236000,11237200
16483,2021-06-30,161,Value,2726400,-9998800,21236000,11237200
16485,2020-02-15,801,Distribution,90000,-11110000,12770000,1660000
16485,2020-03-31,801,Value,4150000,-11110000,12770000,1660000
16485,2020-05-16,801,Distribution,20000,-11110000,12790000,1680000
16485,2020-06-30,801,Value,4289990,-11110000,12790000,1680000
16485,2020-09-30,801,Value,5749990,-11110000,12790000,1680000
16485,2020-11-15,801,Capital Call,-30000,-11140000,12790000,1650000
16485,2020-11-15,801,Distribution,2430000,-11140000,15220000,4080000
16485,2020-12-31,801,Value,3379990,-11140000,15220000,4080000
16485,2021-03-31,801,Value,3410000,-11140000,15220000,4080000
16485,2021-05-16,801,Capital Call,-50000,-11190000,15220000,4030000
16485,2021-05-16,801,Distribution,100000,-11190000,15320000,4130000
16485,2021-06-30,801,Value,3540000,-11190000,15320000,4130000
16485,2021-08-15,801,Capital Call,-30000,-11220000,15320000,4100000
16485,2021-08-15,801,Distribution,130000,-11220000,15450000,4230000
16485,2021-09-30,801,Value,3429990,-11220000,15450000,4230000
16511,2020-03-31,368,Value,8456800,-10000000,3641600,-6358400
16511,2020-06-30,368,Value,8897200,-10000000,3641600,-6358400
16511,2020-09-30,368,Value,9513600,-10000000,3641600,-6358400
16511,2020-12-31,368,Value,9508000,-10000000,3641600,-6358400
16511,2021-03-31,368,Value,10827200,-10000000,3641600,-6358400
16511,2021-06-30,368,Value,11471200,-10000000,3641600,-6358400
16523,2020-02-15,9190,Distribution,1028037,-9492934,6020611,-3472323
16523,2020-03-31,9190,Value,7194510,-9492934,6020611,-3472323
16523,2020-05-16,9190,Distribution,-1500,-9492934,6019111,-3473823
16523,2020-06-30,9190,Value,6530510,-9492934,6019111,-3473823
16523,2020-08-15,9190,Capital Call,0,-9492934,6019111,-3473823
16523,2020-08-15,9190,Distribution,293828,-9492934,6312939,-3179995
16523,2020-09-30,9190,Value,6962510,-9492934,6312939,-3179995
16523,2020-12-30,9190,Distribution,1055360,-9492934,7368299,-2124635
16523,2021-03-31,9190,Value,8821150,-9492934,7368299,-2124635
16523,2021-06-30,9190,Value,9689700,-9492934,7368299,-2124635
16555,2020-01-15,13139,Capital Call,-50963,-11187539,5843318,-5344221
16555,2020-01-15,13139,Distribution,2142995,-11187539,7986313,-3201226
16555,2020-02-29,13139,Value,10626870,-11187539,7986313,-3201226
16555,2020-05-31,13139,Value,9361570,-11187539,7986313,-3201226
16555,2020-07-16,13139,Capital Call,-102893,-11290432,7986313,-3304119
16555,2020-07-16,13139,Distribution,804898,-11290432,8791211,-2499221
16555,2020-08-31,13139,Value,9162530,-11290432,8791211,-2499221
16555,2020-11-30,13139,Value,9787340,-11290432,8791211,-2499221
16555,2021-01-14,13139,Distribution,64039,-11290432,8855250,-2435182
16555,2021-02-28,13139,Value,9723300,-11290432,8855250,-2435182
16555,2021-04-15,13139,Capital Call,-86021,-11376453,8855250,-2521203
16555,2021-04-15,13139,Distribution,410618,-11376453,9265868,-2110585
16555,2021-05-31,13139,Value,9886720,-11376453,9265868,-2110585
16555,2021-08-31,13139,Value,9122120,-11376453,9265868,-2110585
16555,2021-11-30,13139,Value,9362050,-11376453,9265868,-2110585
16600,2020-02-15,8396,Distribution,771745,-10075000,8922419,-1152581
16600,2020-03-31,8396,Value,6322060,-10075000,8922419,-1152581
16600,2020-05-16,8396,Distribution,30225,-10075000,8952644,-1122356
16600,2020-06-30,8396,Value,6416760,-10075000,8952644,-1122356
16600,2020-09-30,8396,Value,6541690,-10075000,8952644,-1122356
16600,2020-11-15,8396,Distribution,44330,-10075000,8996974,-1078026
16600,2020-12-31,8396,Value,6611210,-10075000,8996974,-1078026
16600,2021-03-31,8396,Value,6782490,-10075000,8996974,-1078026
16600,2021-06-30,8396,Value,8911330,-10075000,8996974,-1078026
16600,2021-08-15,8396,Distribution,4938765,-10075000,13935739,3860739
16600,2021-09-30,8396,Value,4224440,-10075000,13935739,3860739
16611,2020-03-31,6758,Value,4180000,-9367500,18250000,8882500
16611,2020-05-16,6758,Distribution,65000,-9367500,18315000,8947500
16611,2020-06-30,6758,Value,4282500,-9367500,18315000,8947500
16611,2020-08-15,6758,Distribution,1760000,-9367500,20075000,10707500
16611,2020-09-30,6758,Value,2340000,-9367500,20075000,10707500
16611,2020-11-15,6758,Distribution,117500,-9367500,20192500,10825000
16611,2020-12-31,6758,Value,2442500,-9367500,20192500,10825000
16611,2021-02-14,6758,Distribution,112500,-9367500,20305000,10937500
16611,2021-03-31,6758,Value,2702500,-9367500,20305000,10937500
16611,2021-05-16,6758,Distribution,80000,-9367500,20385000,11017500
16611,2021-06-30,6758,Value,3920000,-9367500,20385000,11017500
16647,2020-12-31,5655,Value,1560000,-10000000,19329000,9329000
16647,2021-03-31,5655,Value,1540000,-10000000,19329000,9329000
16647,2021-06-30,5655,Value,1522000,-10000000,19329000,9329000
16647,2021-08-15,5655,Distribution,2331000,-10000000,21660000,11660000
16647,2021-09-30,5655,Value,1938000,-10000000,21660000,11660000
16647,2021-12-31,5655,Value,1921000,-10000000,21660000,11660000
16663,2020-02-15,93,Distribution,1652941,-9835296,17105881,7270585
16663,2020-03-31,93,Value,12238820,-9835296,17105881,7270585
16663,2020-05-16,93,Distribution,381176,-9835296,17487057,7651761
16663,2020-06-30,93,Value,11857640,-9835296,17487057,7651761
16663,2020-08-15,93,Distribution,543529,-9835296,18030586,8195290
16663,2020-09-30,93,Value,11407050,-9835296,18030586,8195290
16663,2020-11-15,93,Distribution,3456471,-9835296,21487057,11651761
16663,2020-12-31,93,Value,10936470,-9835296,21487057,11651761
16663,2021-02-14,93,Distribution,562353,-9835296,22049410,12214114
16663,2021-03-31,93,Value,12436470,-9835296,22049410,12214114
16663,2021-06-30,93,Value,16691760,-9835296,22049410,12214114
16664,2020-02-15,8114,Distribution,2210000,-12060000,12360000,300000
16664,2020-03-31,8114,Value,4710000,-12060000,12360000,300000
16664,2020-05-16,8114,Capital Call,-10000,-12070000,12360000,290000
16664,2020-05-16,8114,Distribution,170000,-12070000,12530000,460000
16664,2020-06-30,8114,Value,4229990,-12070000,12530000,460000
16664,2020-08-15,8114,Distribution,250000,-12070000,12780000,710000
16664,2020-09-30,8114,Value,4229990,-12070000,12780000,710000
16664,2020-12-31,8114,Value,4629990,-12070000,12780000,710000
16664,2021-02-14,8114,Distribution,330000,-12070000,13110000,1040000
16664,2021-03-31,8114,Value,4209990,-12070000,13110000,1040000
16664,2021-06-30,8114,Value,4239990,-12070000,13110000,1040000
16664,2021-09-30,8114,Value,4520000,-12070000,13110000,1040000
16665,2020-02-15,2166,Capital Call,-8889,-12604444,13737780,1133336
16665,2020-02-15,2166,Distribution,226667,-12604444,13964447,1360003
16665,2020-03-31,2166,Value,5648880,-12604444,13964447,1360003
16665,2020-05-16,2166,Capital Call,-4444,-12608888,13964447,1355559
16665,2020-05-16,2166,Distribution,4444,-12608888,13968891,1360003
16665,2020-06-30,2166,Value,6311110,-12608888,13968891,1360003
16665,2020-08-15,2166,Capital Call,-17778,-12626666,13968891,1342225
16665,2020-08-15,2166,Distribution,13333,-12626666,13982224,1355558
16665,2020-09-30,2166,Value,6524440,-12626666,13982224,1355558
16665,2020-11-15,2166,Capital Call,-66667,-12693333,13982224,1288891
16665,2020-11-15,2166,Distribution,711111,-12693333,14693335,2000002
16665,2020-12-31,2166,Value,6279990,-12693333,14693335,2000002
16665,2021-02-14,2166,Capital Call,-13333,-12706666,14693335,1986669
16665,2021-02-14,2166,Distribution,128889,-12706666,14822224,2115558
16665,2021-03-31,2166,Value,6555550,-12706666,14822224,2115558
16665,2021-06-30,2166,Value,6982220,-12706666,14822224,2115558
16665,2021-08-15,2166,Distribution,-1333,-12706666,14820891,2114225
16665,2021-09-30,2166,Value,7137330,-12706666,14820891,2114225
16702,2020-02-15,24,Distribution,719084,-9250000,9751158,501158
16702,2020-03-31,24,Value,13504150,-9250000,9751158,501158
16702,2020-05-16,24,Capital Call,-465,-9250465,9751158,500693
16702,2020-05-16,24,Distribution,794095,-9250465,10545253,1294788
16702,2020-06-30,24,Value,14931620,-9250465,10545253,1294788
16702,2020-08-15,24,Capital Call,465,-9250000,10545253,1295253
16702,2020-08-15,24,Distribution,432924,-9250000,10978177,1728177
16702,2020-09-30,24,Value,16659590,-9250000,10978177,1728177
16702,2020-11-15,24,Distribution,1286116,-9250000,12264293,3014293
16702,2020-12-31,24,Value,15623600,-9250000,12264293,3014293
16702,2021-02-14,24,Capital Call,0,-9250000,12264293,3014293
16702,2021-02-14,24,Distribution,1536707,-9250000,13801000,4551000
16702,2021-03-31,24,Value,15472470,-9250000,13801000,4551000
16702,2021-05-16,24,Capital Call,0,-9250000,13801000,4551000
16702,2021-05-16,24,Distribution,8489663,-9250000,22290663,13040663
16702,2021-06-30,24,Value,7017880,-9250000,22290663,13040663
16702,2021-08-15,24,Distribution,2090424,-9250000,24381087,15131087
16702,2021-09-30,24,Value,5081350,-9250000,24381087,15131087
16704,2020-02-15,24,Distribution,330069,-9900000,8601644,-1298356
16704,2020-03-31,24,Value,9442540,-9900000,8601644,-1298356
16704,2020-05-16,24,Capital Call,0,-9900000,8601644,-1298356
16704,2020-05-16,24,Distribution,139550,-9900000,8741194,-1158806
16704,2020-06-30,24,Value,9703980,-9900000,8741194,-1158806
16704,2020-08-15,24,Distribution,449967,-9900000,9191161,-708839
16704,2020-09-30,24,Value,9601020,-9900000,9191161,-708839
16704,2020-11-15,24,Capital Call,0,-9900000,9191161,-708839
16704,2020-11-15,24,Distribution,130998,-9900000,9322159,-577841
16704,2020-12-31,24,Value,9969030,-9900000,9322159,-577841
16704,2021-02-14,24,Capital Call,0,-9900000,9322159,-577841
16704,2021-02-14,24,Distribution,738222,-9900000,10060381,160381
16704,2021-03-31,24,Value,9900000,-9900000,10060381,160381
16704,2021-05-16,24,Distribution,325710,-9900000,10386091,486091
16704,2021-06-30,24,Value,11606760,-9900000,10386091,486091
16704,2021-08-15,24,Distribution,294268,-9900000,10680359,780359
16704,2021-09-30,24,Value,11043450,-9900000,10680359,780359
16742,2020-01-15,6384,Capital Call,0,-10342687,16770755,6428068
16742,2020-01-15,6384,Distribution,0,-10342687,16770755,6428068
16742,2020-02-29,6384,Value,126070,-10342687,16770755,6428068
16742,2020-04-15,6384,Capital Call,0,-10342687,16770755,6428068
16742,2020-04-15,6384,Distribution,0,-10342687,16770755,6428068
16742,2020-05-31,6384,Value,118760,-10342687,16770755,6428068
16742,2020-08-31,6384,Value,118500,-10342687,16770755,6428068
16742,2020-11-30,6384,Value,117970,-10342687,16770755,6428068
16742,2021-01-14,6384,Distribution,105266,-10342687,16876021,6533334
16742,2021-02-28,6384,Value,0,-10342687,16876021,6533334
16742,2021-08-31,6384,Value,0,-10342687,16876021,6533334
16742,2021-12-31,6384,Value,0,-10342687,16876021,6533334
16813,2020-02-15,558,Distribution,1725000,-12550000,31175000,18625000
16813,2020-03-31,558,Value,7025000,-12550000,31175000,18625000
16813,2020-05-16,558,Distribution,900000,-12550000,32075000,19525000
16813,2020-06-30,558,Value,6125000,-12550000,32075000,19525000
16813,2020-08-15,558,Capital Call,-125000,-12675000,32075000,19400000
16813,2020-08-15,558,Distribution,1200000,-12675000,33275000,20600000
16813,2020-09-30,558,Value,4700000,-12675000,33275000,20600000
16813,2020-12-31,558,Value,4725000,-12675000,33275000,20600000
16813,2021-02-14,558,Capital Call,-75000,-12750000,33275000,20525000
16813,2021-02-14,558,Distribution,500000,-12750000,33775000,21025000
16813,2021-03-31,558,Value,3525000,-12750000,33775000,21025000
16813,2021-06-30,558,Value,3750000,-12750000,33775000,21025000
16813,2021-09-30,558,Value,3200000,-12750000,33775000,21025000
16817,2020-03-31,8664,Value,175680,-7853275,18242889,10389614
16817,2020-06-30,8664,Value,174120,-7853275,18242889,10389614
16817,2020-09-30,8664,Value,194570,-7853275,18242889,10389614
16817,2020-11-15,8664,Distribution,405490,-7853275,18648379,10795104
16817,2020-12-31,8664,Value,59150,-7853275,18648379,10795104
16817,2021-03-31,8664,Value,58950,-7853275,18648379,10795104
16817,2021-06-30,8664,Value,58600,-7853275,18648379,10795104
16918,2020-03-31,15554,Value,2284880,-20000200,27327635,7327435
16918,2021-03-19,15554,Distribution,310805,-20000200,27638440,7638240
16918,2021-05-31,15554,Distribution,1320000,-20000200,28958440,8958240
16918,2021-06-18,15554,Distribution,4340000,-20000200,33298440,13298240
16918,2021-06-30,15554,Value,1864450,-20000200,33298440,13298240
16918,2021-09-16,15554,Distribution,1085000,-20000200,34383440,14383240
16918,2021-10-18,15554,Distribution,37000,-20000200,34420440,14420240
16918,2021-12-31,15554,Value,795660,-20000200,34420440,14420240
16942,2020-03-31,1674,Distribution,89600,-8960000,4076800,-4883200
16942,2020-09-30,1674,Value,12096000,-8960000,4076800,-4883200
16942,2020-11-15,1674,Capital Call,-38000,-8998000,4076800,-4921200
16942,2020-11-15,1674,Distribution,6225910,-8998000,10302710,1304710
16942,2020-12-31,1674,Value,11184510,-8998000,10302710,1304710
16942,2021-02-14,1674,Distribution,8996200,-8998000,19298910,10300910
16942,2021-03-31,1674,Value,2469950,-8998000,19298910,10300910
16942,2021-05-16,1674,Capital Call,-4000,-9002000,19298910,10296910
16942,2021-05-16,1674,Distribution,2430117,-9002000,21729027,12727027
16942,2021-06-30,1674,Value,0,-9002000,21729027,12727027
16942,2021-09-30,1674,Value,0,-9002000,21729027,12727027
16942,2021-12-31,1674,Value,0,-9002000,21729027,12727027
16974,2020-03-31,17268,Value,0,-9960000,13159999,3199999
16974,2020-06-30,17268,Value,0,-9960000,13159999,3199999
16974,2020-09-30,17268,Value,0,-9960000,13159999,3199999
16974,2020-12-31,17268,Value,0,-9960000,13159999,3199999
16974,2021-03-31,17268,Value,0,-9960000,13159999,3199999
16974,2021-06-30,17268,Value,0,-9960000,13159999,3199999
16974,2021-09-30,17268,Value,0,-9960000,13159999,3199999
16974,2021-12-31,17268,Value,0,-9960000,13159999,3199999
17041,2020-02-15,5708,Distribution,-31484,-9260000,6728316,-2531684
17041,2020-03-31,5708,Value,8046940,-9260000,6728316,-2531684
17041,2020-06-30,5708,Value,7608010,-9260000,6728316,-2531684
17041,2020-08-15,5708,Capital Call,-43000,-9303000,6728316,-2574684
17041,2020-08-15,5708,Distribution,-386,-9303000,6727930,-2575070
17041,2020-09-30,5708,Value,7712180,-9303000,6727930,-2575070
17041,2020-11-15,5708,Capital Call,-113000,-9416000,6727930,-2688070
17041,2020-11-15,5708,Distribution,138218,-9416000,6866148,-2549852
17041,2020-12-31,5708,Value,6852960,-9416000,6866148,-2549852
17052,2020-03-31,1718,Value,485000,-9700000,13192000,3492000
17052,2020-06-30,1718,Value,485000,-9700000,13192000,3492000
17052,2020-09-30,1718,Value,485000,-9700000,13192000,3492000
17052,2020-12-31,1718,Value,485000,-9700000,13192000,3492000
17052,2021-03-31,1718,Value,485000,-9700000,13192000,3492000
17052,2021-06-30,1718,Value,485000,-9700000,13192000,3492000
17052,2021-08-15,1718,Distribution,485000,-9700000,13677000,3977000
17052,2021-09-30,1718,Value,97000,-9700000,13677000,3977000
17052,2021-12-31,1718,Value,97000,-9700000,13677000,3977000
17075,2020-03-31,24893,Value,5639470,-9860524,15257098,5396574
17075,2020-05-16,24893,Capital Call,-7436,-9867960,15257098,5389138
17075,2020-05-16,24893,Distribution,65570,-9867960,15322668,5454708
17075,2020-06-30,24893,Value,5826040,-9867960,15322668,5454708
17075,2020-08-15,24893,Capital Call,-18702,-9886662,15322668,5436006
17075,2020-08-15,24893,Distribution,43263,-9886662,15365931,5479269
17075,2020-09-30,24893,Value,6082010,-9886662,15365931,5479269
17075,2020-11-15,24893,Capital Call,-21406,-9908068,15365931,5457863
17075,2020-11-15,24893,Distribution,1730509,-9908068,17096440,7188372
17075,2020-12-31,24893,Value,4579540,-9908068,17096440,7188372
17075,2021-02-14,24893,Capital Call,-2028,-9910096,17096440,7186344
17075,2021-02-14,24893,Distribution,1789995,-9910096,18886435,8976339
17075,2021-03-31,24893,Value,3174170,-9910096,18886435,8976339
17075,2021-05-16,24893,Capital Call,31320,-9878776,18886435,9007659
17075,2021-06-30,24893,Value,3436230,-9878776,18886435,9007659
17075,2021-08-15,24893,Capital Call,-11311,-9890087,18886435,8996348
17075,2021-08-15,24893,Distribution,2586931,-9890087,21473366,11583279
17075,2021-09-30,24893,Value,3436180,-9890087,21473366,11583279
17075,2021-12-31,24893,Value,0,-9890087,21473366,11583279
17107,2020-03-31,12208,Value,8232000,-9799999,8231999,-1568000
17107,2020-06-30,12208,Value,7546000,-9799999,8231999,-1568000
17107,2020-09-30,12208,Value,7350000,-9799999,8231999,-1568000
17107,2020-12-31,12208,Value,6566000,-9799999,8231999,-1568000
17107,2021-03-31,12208,Value,6566000,-9799999,8231999,-1568000
17107,2021-07-01,12208,Distribution,2352000,-9799999,10583999,784000
17107,2021-09-30,12208,Value,4704000,-9799999,10583999,784000
17136,2020-02-15,5571,Distribution,166154,-5000000,9765488,4765488
17136,2020-03-31,5571,Value,42150,-5000000,9765488,4765488
17136,2020-06-30,5571,Value,38320,-5000000,9765488,4765488
17136,2020-09-30,5571,Value,37550,-5000000,9765488,4765488
17136,2020-11-15,5571,Distribution,12,-5000000,9765500,4765500
17136,2020-12-31,5571,Value,37000,-5000000,9765500,4765500
17136,2021-02-14,5571,Distribution,-12,-5000000,9765488,4765488
17136,2021-03-31,5571,Value,36480,-5000000,9765488,4765488
17136,2021-06-30,5571,Value,36190,-5000000,9765488,4765488
17136,2021-08-15,5571,Distribution,12,-5000000,9765500,4765500
17136,2021-09-30,5571,Value,36000,-5000000,9765500,4765500
17136,2021-12-31,5571,Value,0,-5000000,9765500,4765500
17394,2020-02-15,7486,Capital Call,-11765,-9282353,9200000,-82353
17394,2020-03-31,7486,Value,11247050,-9282353,9200000,-82353
17394,2020-05-16,7486,Capital Call,-47059,-9329412,9200000,-129412
17394,2020-05-16,7486,Distribution,1094118,-9329412,10294118,964706
17394,2020-06-30,7486,Value,9670580,-9329412,10294118,964706
17394,2020-09-30,7486,Value,9611760,-9329412,10294118,964706
17394,2020-11-15,7486,Capital Call,-47059,-9376471,10294118,917647
17394,2020-12-31,7486,Value,12541170,-9376471,10294118,917647
17394,2021-02-14,7486,Capital Call,-94118,-9470589,10294118,823529
17394,2021-02-14,7486,Distribution,94118,-9470589,10388236,917647
17394,2021-03-31,7486,Value,12800000,-9470589,10388236,917647
17394,2021-05-16,7486,Capital Call,-23529,-9494118,10388236,894118
17394,2021-05-16,7486,Distribution,1776471,-9494118,12164707,2670589
17394,2021-06-30,7486,Value,14494110,-9494118,12164707,2670589
17394,2021-08-15,7486,Capital Call,-1176,-9495294,12164707,2669413
17394,2021-08-15,7486,Distribution,3637647,-9495294,15802354,6307060
17394,2021-09-30,7486,Value,18268230,-9495294,15802354,6307060
17426,2020-03-31,9398,Value,4417910,-6985070,2656716,-4328354
17426,2020-05-16,9398,Distribution,358209,-6985070,3014925,-3970145
17426,2020-06-30,9398,Value,4000000,-6985070,3014925,-3970145
17426,2020-08-15,9398,Capital Call,-149254,-7134324,3014925,-4119399
17426,2020-09-30,9398,Value,4089550,-7134324,3014925,-4119399
17426,2020-11-15,9398,Distribution,1552239,-7134324,4567164,-2567160
17426,2020-12-31,9398,Value,0,-7134324,4567164,-2567160
17426,2021-03-31,9398,Value,0,-7134324,4567164,-2567160
17426,2021-06-30,9398,Value,0,-7134324,4567164,-2567160
17426,2021-09-30,9398,Value,0,-7134324,4567164,-2567160
17496,2020-03-31,780,Value,1276470,-9819000,21699988,11880988
17496,2020-06-30,780,Value,1571040,-9819000,21699988,11880988
17496,2020-09-30,780,Value,1374660,-9819000,21699988,11880988
17509,2020-01-15,13159,Distribution,3810000,-8100000,4590088,-3509912
17509,2020-02-29,13159,Value,6666700,-8100000,4590088,-3509912
17509,2020-04-15,13159,Distribution,0,-8100000,4590088,-3509912
17509,2020-05-31,13159,Value,5170920,-8100000,4590088,-3509912
17509,2020-07-16,13159,Distribution,770000,-8100000,5360088,-2739912
17509,2020-08-31,13159,Value,4636990,-8100000,5360088,-2739912
17509,2020-11-30,13159,Value,4612340,-8100000,5360088,-2739912
17509,2021-01-14,13159,Distribution,670000,-8100000,6030088,-2069912
17509,2021-02-28,13159,Value,4407640,-8100000,6030088,-2069912
17509,2021-05-31,13159,Value,5435500,-8100000,6030088,-2069912
17509,2021-07-16,13159,Distribution,1730000,-8100000,7760088,-339912
17509,2021-08-31,13159,Value,3687110,-8100000,7760088,-339912
17509,2021-10-16,13159,Distribution,0,-8100000,7760088,-339912
17509,2021-11-30,13159,Value,3543270,-8100000,7760088,-339912
17565,2020-03-31,25346,Value,2862350,-13353396,15595762,2242366
17565,2020-05-16,25346,Capital Call,-27577,-13380973,15595762,2214789
17565,2020-05-16,25346,Distribution,11748,-13380973,15607510,2226537
17565,2020-06-30,25346,Value,3423260,-13380973,15607510,2226537
17565,2020-09-30,25346,Value,3423260,-13380973,15607510,2226537
17565,2020-11-15,25346,Capital Call,-25523,-13406496,15607510,2201014
17565,2020-11-15,25346,Distribution,101490,-13406496,15709000,2302504
17565,2020-12-31,25346,Value,3857680,-13406496,15709000,2302504
17565,2021-02-14,25346,Capital Call,-18379,-13424875,15709000,2284125
17565,2021-02-14,25346,Distribution,393054,-13424875,16102054,2677179
17565,2021-03-31,25346,Value,3483010,-13424875,16102054,2677179
17838,2020-03-31,9004,Value,5543350,-10000000,2080721,-7919279
17838,2020-06-30,9004,Value,5518020,-10000000,2080721,-7919279
17838,2020-09-30,9004,Value,4015390,-10000000,2080721,-7919279
17838,2020-12-31,9004,Value,3988720,-10000000,2080721,-7919279
17838,2021-03-31,9004,Value,3963150,-10000000,2080721,-7919279
17838,2021-06-30,9004,Value,3936570,-10000000,2080721,-7919279
17909,2020-02-15,4963,Distribution,258700,-9950000,14377752,4427752
17909,2020-03-31,4963,Value,4696400,-9950000,14377752,4427752
17909,2020-06-30,4963,Value,4835700,-9950000,14377752,4427752
17909,2020-09-30,4963,Value,5721250,-9950000,14377752,4427752
17909,2020-12-30,4963,Distribution,1960150,-9950000,16337902,6387902
17909,2021-03-31,4963,Value,4726250,-9950000,16337902,6387902
18025,2020-03-02,515145,Distribution,602410,-9200000,14140270,4940270
18025,2020-03-31,515145,Value,481630,-9200000,14140270,4940270
18026,2020-01-20,515145,Distribution,171821,-10002146,11417388,1415242
18026,2020-03-31,515145,Value,3035890,-10002146,11417388,1415242
18031,2020-03-31,2102,Value,2846890,-11017836,12868226,1850390
18031,2020-06-30,2102,Value,2902040,-11017836,12868226,1850390
18031,2020-09-30,2102,Value,2958880,-11017836,12868226,1850390
18031,2020-12-31,2102,Value,3016840,-11017836,12868226,1850390
18031,2021-03-31,2102,Value,3067020,-11017836,12868226,1850390
18031,2021-06-30,2102,Value,3134200,-11017836,12868226,1850390
18033,2020-02-15,18,Capital Call,-41,-9185000,3744181,-5440819
18033,2020-02-15,18,Distribution,267466,-9185000,4011647,-5173353
18033,2020-03-31,18,Value,10329720,-9185000,4011647,-5173353
18033,2020-05-16,18,Distribution,436265,-9185000,4447912,-4737088
18033,2020-06-30,18,Value,10727430,-9185000,4447912,-4737088
18033,2020-08-15,18,Distribution,440059,-9185000,4887971,-4297029
18033,2020-09-30,18,Value,11249740,-9185000,4887971,-4297029
18033,2020-11-15,18,Distribution,692334,-9185000,5580305,-3604695
18033,2020-12-31,18,Value,12244030,-9185000,5580305,-3604695
18033,2021-02-14,18,Distribution,605081,-9185000,6185386,-2999614
18033,2021-03-31,18,Value,12076980,-9185000,6185386,-2999614
18033,2021-05-16,18,Capital Call,41,-9184959,6185386,-2999573
18033,2021-05-16,18,Distribution,510210,-9184959,6695596,-2489363
18033,2021-06-30,18,Value,12642470,-9184959,6695596,-2489363
18033,2021-08-15,18,Capital Call,-41,-9185000,6695596,-2489404
18033,2021-08-15,18,Distribution,545858,-9185000,7241454,-1943546
18033,2021-09-30,18,Value,12263810,-9185000,7241454,-1943546
18040,2020-02-15,1314,Capital Call,5000,-9570002,13224990,3654988
18040,2020-02-15,1314,Distribution,2134860,-9570002,15359850,5789848
18040,2020-03-31,1314,Value,14200920,-9570002,15359850,5789848
18040,2020-05-16,1314,Capital Call,-30000,-9600002,15359850,5759848
18040,2020-05-16,1314,Distribution,2199510,-9600002,17559360,7959358
18040,2020-06-30,1314,Value,14474880,-9600002,17559360,7959358
18040,2020-08-15,1314,Capital Call,-75000,-9675002,17559360,7884358
18040,2020-08-15,1314,Distribution,606420,-9675002,18165780,8490778
18040,2020-09-30,1314,Value,16287860,-9675002,18165780,8490778
18040,2020-11-15,1314,Distribution,575662,-9675002,18741442,9066440
18040,2020-12-31,1314,Value,21396260,-9675002,18741442,9066440
18040,2021-02-14,1314,Distribution,608557,-9675002,19349999,9674997
18040,2021-03-31,1314,Value,24039470,-9675002,19349999,9674997
18040,2021-05-16,1314,Distribution,1571220,-9675002,20921219,11246217
18040,2021-06-30,1314,Value,24210720,-9675002,20921219,11246217
18040,2021-08-15,1314,Distribution,626940,-9675002,21548159,11873157
18040,2021-09-30,1314,Value,24251350,-9675002,21548159,11873157
18046,2020-03-31,22965,Capital Call,-258506,-10686144,965398,-9720746
18046,2020-03-31,22965,Distribution,0,-10686144,965398,-9720746
18046,2020-06-30,22965,Value,7008540,-10686144,965398,-9720746
18046,2020-09-30,22965,Value,7251250,-10686144,965398,-9720746
18046,2020-11-15,22965,Capital Call,0,-10686144,965398,-9720746
18046,2020-11-15,22965,Distribution,324719,-10686144,1290117,-9396027
18046,2020-12-31,22965,Value,8377030,-10686144,1290117,-9396027
18052,2020-02-15,1314,Capital Call,-100000,-9008000,4774687,-4233313
18052,2020-02-15,1314,Distribution,165299,-9008000,4939986,-4068014
18052,2020-03-31,1314,Value,6399280,-9008000,4939986,-4068014
18052,2020-05-16,1314,Distribution,-101,-9008000,4939885,-4068115
18052,2020-06-30,1314,Value,6634410,-9008000,4939885,-4068115
18052,2020-08-15,1314,Distribution,101,-9008000,4939986,-4068014
18052,2020-09-30,1314,Value,6999210,-9008000,4939986,-4068014
18052,2020-11-15,1314,Capital Call,-100000,-9108000,4939986,-4168014
18052,2020-11-15,1314,Distribution,332634,-9108000,5272620,-3835380
18052,2020-12-31,1314,Value,7595160,-9108000,5272620,-3835380
18052,2021-02-14,1314,Capital Call,-75000,-9183000,5272620,-3910380
18052,2021-02-14,1314,Distribution,476855,-9183000,5749475,-3433525
18052,2021-03-31,1314,Value,7537400,-9183000,5749475,-3433525
18052,2021-05-16,1314,Distribution,337934,-9183000,6087409,-3095591
18052,2021-06-30,1314,Value,8020430,-9183000,6087409,-3095591
18052,2021-08-15,1314,Distribution,181823,-9183000,6269232,-2913768
18052,2021-09-30,1314,Value,7381290,-9183000,6269232,-2913768
18076,2020-02-15,1759,Capital Call,-189000,-10889000,12732999,1843999
18076,2020-02-15,1759,Distribution,1163542,-10889000,13896541,3007541
18076,2020-03-31,1759,Value,6097840,-10889000,13896541,3007541
18076,2020-05-16,1759,Capital Call,-115000,-11004000,13896541,2892541
18076,2020-05-16,1759,Distribution,479084,-11004000,14375625,3371625
18076,2020-06-30,1759,Value,6162240,-11004000,14375625,3371625
18076,2020-08-15,1759,Capital Call,67000,-10937000,14375625,3438625
18076,2020-08-15,1759,Distribution,399168,-10937000,14774793,3837793
18076,2020-09-30,1759,Value,6343460,-10937000,14774793,3837793
18076,2020-11-15,1759,Distribution,264675,-10937000,15039468,4102468
18076,2020-12-31,1759,Value,7327790,-10937000,15039468,4102468
18076,2021-02-14,1759,Capital Call,-3000,-10940000,15039468,4099468
18076,2021-02-14,1759,Distribution,407811,-10940000,15447279,4507279
18076,2021-03-31,1759,Value,7548600,-10940000,15447279,4507279
18076,2021-05-16,1759,Capital Call,3000,-10937000,15447279,4510279
18076,2021-05-16,1759,Distribution,1286330,-10937000,16733609,5796609
18076,2021-06-30,1759,Value,6780940,-10937000,16733609,5796609
18076,2021-08-15,1759,Capital Call,37000,-10900000,16733609,5833609
18076,2021-08-15,1759,Distribution,313990,-10900000,17047599,6147599
18076,2021-09-30,1759,Value,6649000,-10900000,17047599,6147599
18078,2020-03-31,2562,Value,8632600,-8500000,8801750,301750
18078,2020-05-16,2562,Distribution,470900,-8500000,9272650,772650
18078,2020-06-30,2562,Value,8135350,-8500000,9272650,772650
18078,2020-08-15,2562,Distribution,850,-8500000,9273500,773500
18078,2020-09-30,2562,Value,8024000,-8500000,9273500,773500
18078,2021-02-14,2562,Distribution,1479000,-8500000,10752500,2252500
18078,2021-06-30,2562,Value,7565000,-8500000,10752500,2252500
18078,2021-09-30,2562,Distribution,2337500,-8500000,13090000,4590000
18078,2021-12-31,2562,Value,5703500,-8500000,13090000,4590000
18081,2020-02-15,6817,Capital Call,-17335,-9725000,0,-9725000
18081,2020-03-31,6817,Value,11851850,-9725000,0,-9725000
18081,2020-05-16,6817,Capital Call,-275000,-10000000,0,-10000000
18081,2020-06-30,6817,Value,12920000,-10000000,0,-10000000
18081,2020-09-30,6817,Value,12918000,-10000000,0,-10000000
18081,2020-12-31,6817,Value,12830000,-10000000,0,-10000000
18081,2021-03-31,6817,Value,13076000,-10000000,0,-10000000
18081,2021-06-30,6817,Value,13329000,-10000000,0,-10000000
18081,2021-09-30,6817,Value,13590000,-10000000,0,-10000000
18081,2021-12-31,6817,Value,15943000,-10000000,0,-10000000
18205,2020-02-15,14363,Capital Call,-362012,-11963999,8493249,-3470750
18205,2020-02-15,14363,Distribution,2318287,-11963999,10811536,-1152463
18205,2020-03-31,14363,Value,5400130,-11963999,10811536,-1152463
18205,2020-05-16,14363,Capital Call,-4465,-11968464,10811536,-1156928
18205,2020-05-16,14363,Distribution,61173,-11968464,10872709,-1095755
18205,2020-06-30,14363,Value,5330580,-11968464,10872709,-1095755
18205,2020-08-15,14363,Capital Call,-43991,-12012455,10872709,-1139746
18205,2020-09-30,14363,Value,5320900,-12012455,10872709,-1139746
18205,2020-12-31,14363,Value,5563800,-12012455,10872709,-1139746
18205,2021-02-14,14363,Capital Call,-42095,-12054550,10872709,-1181841
18205,2021-03-31,14363,Value,5559200,-12054550,10872709,-1181841
18205,2021-06-30,14363,Value,5708160,-12054550,10872709,-1181841
18240,2020-03-31,766,Value,6101700,-8250000,4637325,-3612675
18240,2020-06-30,766,Value,5741170,-8250000,4637325,-3612675
18261,2020-02-15,5799,Capital Call,-198398,-9502656,6994626,-2508030
18261,2020-02-15,5799,Distribution,411473,-9502656,7406099,-2096557
18261,2020-03-31,5799,Value,6345740,-9502656,7406099,-2096557
18261,2020-05-16,5799,Capital Call,-145134,-9647790,7406099,-2241691
18261,2020-05-16,5799,Distribution,384949,-9647790,7791048,-1856742
18261,2020-06-30,5799,Value,5676040,-9647790,7791048,-1856742
18261,2020-08-15,5799,Capital Call,-44543,-9692333,7791048,-1901285
18261,2020-09-30,5799,Value,5940180,-9692333,7791048,-1901285
18261,2020-11-15,5799,Capital Call,-352323,-10044656,7791048,-2253608
18261,2020-11-15,5799,Distribution,329052,-10044656,8120100,-1924556
18261,2020-12-31,5799,Value,6640100,-10044656,8120100,-1924556
18261,2021-02-14,5799,Distribution,171774,-10044656,8291874,-1752782
18261,2021-03-31,5799,Value,6161820,-10044656,8291874,-1752782
18287,2020-02-15,24,Distribution,380935,-9000000,6395361,-2604639
18287,2020-03-31,24,Value,8180400,-9000000,6395361,-2604639
18287,2020-05-16,24,Capital Call,-200000,-9200000,6395361,-2804639
18287,2020-05-16,24,Distribution,-441,-9200000,6394920,-2805080
18287,2020-06-30,24,Value,8577160,-9200000,6394920,-2805080
18287,2020-08-15,24,Distribution,327520,-9200000,6722440,-2477560
18287,2020-09-30,24,Value,8659040,-9200000,6722440,-2477560
18287,2020-11-15,24,Capital Call,0,-9200000,6722440,-2477560
18287,2020-11-15,24,Distribution,176057,-9200000,6898497,-2301503
18287,2020-12-31,24,Value,9311610,-9200000,6898497,-2301503
18287,2021-02-14,24,Capital Call,0,-9200000,6898497,-2301503
18287,2021-02-14,24,Distribution,974863,-9200000,7873360,-1326640
18287,2021-03-31,24,Value,8336120,-9200000,7873360,-1326640
18287,2021-05-16,24,Distribution,240120,-9200000,8113480,-1086520
18287,2021-06-30,24,Value,9211960,-9200000,8113480,-1086520
18287,2021-08-15,24,Distribution,1061680,-9200000,9175160,-24840
18287,2021-09-30,24,Value,8415240,-9200000,9175160,-24840
18296,2020-02-15,6649,Distribution,100000,-9440000,20560000,11120000
18296,2020-03-31,6649,Value,2520000,-9440000,20560000,11120000
18296,2020-05-16,6649,Capital Call,-10000,-9450000,20560000,11110000
18296,2020-05-16,6649,Distribution,150000,-9450000,20710000,11260000
18296,2020-06-30,6649,Value,2460000,-9450000,20710000,11260000
18296,2020-08-15,6649,Distribution,160000,-9450000,20870000,11420000
18296,2020-09-30,6649,Value,3620000,-9450000,20870000,11420000
18296,2020-11-15,6649,Capital Call,-10000,-9460000,20870000,11410000
18296,2020-11-15,6649,Distribution,3150000,-9460000,24020000,14560000
18296,2020-12-31,6649,Value,3619990,-9460000,24020000,14560000
18296,2021-02-14,6649,Distribution,80000,-9460000,24100000,14640000
18296,2021-03-31,6649,Value,3619990,-9460000,24100000,14640000
18296,2021-06-30,6649,Value,3619990,-9460000,24100000,14640000
18296,2021-08-15,6649,Capital Call,-4000,-9464000,24100000,14636000
18296,2021-08-15,6649,Distribution,-3000,-9464000,24097000,14633000
18296,2021-09-30,6649,Value,3621990,-9464000,24097000,14633000
18322,2020-03-31,24,Value,2247890,-9700000,10957084,1257084
18322,2020-05-16,24,Capital Call,246,-9699754,10957084,1257330
18322,2020-05-16,24,Distribution,-277,-9699754,10956807,1257053
18322,2020-06-30,24,Value,2297650,-9699754,10956807,1257053
18322,2020-08-15,24,Capital Call,119,-9699635,10956807,1257172
18322,2020-08-15,24,Distribution,-135,-9699635,10956672,1257037
18322,2020-09-30,24,Value,2500180,-9699635,10956672,1257037
18322,2020-11-15,24,Capital Call,-365,-9700000,10956672,1256672
18322,2020-11-15,24,Distribution,412,-9700000,10957084,1257084
18322,2020-12-31,24,Value,2864690,-9700000,10957084,1257084
18322,2021-02-14,24,Capital Call,246,-9699754,10957084,1257330
18322,2021-02-14,24,Distribution,181769,-9699754,11138853,1439099
18322,2021-03-31,24,Value,2746010,-9699754,11138853,1439099
18322,2021-05-16,24,Capital Call,-246,-9700000,11138853,1438853
18322,2021-05-16,24,Distribution,91808,-9700000,11230661,1530661
18322,2021-06-30,24,Value,2958500,-9700000,11230661,1530661
18322,2021-08-15,24,Capital Call,365,-9699635,11230661,1531026
18322,2021-08-15,24,Distribution,256207,-9699635,11486868,1787233
18322,2021-09-30,24,Value,2805490,-9699635,11486868,1787233
18373,2020-03-31,6144,Value,1528120,-9888867,17900591,8011724
18373,2020-06-30,6144,Value,1520290,-9888867,17900591,8011724
18373,2020-09-30,6144,Value,1393780,-9888867,17900591,8011724
18373,2020-12-31,6144,Value,1317040,-9888867,17900591,8011724
18373,2021-06-30,6144,Value,1277930,-9888867,17900591,8011724
18388,2020-03-31,11819,Value,1125740,-10197000,16431445,6234445
18388,2020-06-30,11819,Value,1541780,-10197000,16431445,6234445
18388,2020-09-30,11819,Value,1979230,-10197000,16431445,6234445
18388,2020-12-31,11819,Value,2307580,-10197000,16431445,6234445
18388,2021-02-14,11819,Capital Call,-170000,-10367000,16431445,6064445
18388,2021-02-14,11819,Distribution,127763,-10367000,16559208,6192208
18388,2021-03-31,11819,Value,2266220,-10367000,16559208,6192208
18388,2021-06-30,11819,Value,2419650,-10367000,16559208,6192208
18388,2021-08-15,11819,Capital Call,-9000,-10376000,16559208,6183208
18388,2021-08-15,11819,Distribution,176241,-10376000,16735449,6359449
18388,2021-09-30,11819,Value,2167540,-10376000,16735449,6359449
18388,2021-12-31,11819,Value,2125000,-10376000,16735449,6359449
18415,2020-02-15,7,Distribution,253440,-9900000,10153440,253440
18415,2020-03-31,7,Value,5802390,-9900000,10153440,253440
18415,2020-06-30,7,Value,6580530,-9900000,10153440,253440
18415,2020-08-15,7,Capital Call,-50000,-9950000,10153440,203440
18415,2020-08-15,7,Distribution,396545,-9950000,10549985,599985
18415,2020-09-30,7,Value,6693360,-9950000,10549985,599985
18452,2020-03-31,1880,Value,7830410,-8274028,3399282,-4874746
18452,2020-06-30,1880,Value,7830410,-8274028,3399282,-4874746
18452,2020-09-30,1880,Value,6894430,-8274028,3399282,-4874746
18452,2020-12-31,1880,Value,7371390,-8274028,3399282,-4874746
18452,2021-03-31,1880,Value,7371390,-8274028,3399282,-4874746
18452,2021-06-30,1880,Value,8534970,-8274028,3399282,-4874746
18454,2020-02-15,5296,Distribution,317500,-6350000,15748000,9398000
18454,2020-03-31,5296,Value,3810000,-6350000,15748000,9398000
18454,2020-06-30,5296,Value,3238500,-6350000,15748000,9398000
18454,2020-09-30,5296,Value,3302000,-6350000,15748000,9398000
18454,2020-12-31,5296,Value,3429000,-6350000,15748000,9398000
18454,2021-02-14,5296,Distribution,571500,-6350000,16319500,9969500
18454,2021-03-31,5296,Value,3048000,-6350000,16319500,9969500
18454,2021-05-16,5296,Distribution,317500,-6350000,16637000,10287000
18454,2021-06-30,5296,Value,2667000,-6350000,16637000,10287000
18498,2020-02-15,9035,Distribution,477545,-9787631,7209591,-2578040
18498,2020-03-31,9035,Value,8669580,-9787631,7209591,-2578040
18498,2020-06-30,9035,Value,8459030,-9787631,7209591,-2578040
18498,2020-08-15,9035,Distribution,373731,-9787631,7583322,-2204309
18498,2020-09-30,9035,Value,8500650,-9787631,7583322,-2204309
18498,2020-11-15,9035,Distribution,1038141,-9787631,8621463,-1166168
18498,2020-12-31,9035,Value,8048480,-9787631,8621463,-1166168
18498,2021-02-14,9035,Distribution,747462,-9787631,9368925,-418706
18498,2021-05-16,9035,Distribution,373731,-9787631,9742656,-44975
18498,2021-06-30,9035,Value,8111480,-9787631,9742656,-44975
18498,2021-08-15,9035,Distribution,664410,-9787631,10407066,619435
18498,2021-09-30,9035,Value,7636460,-9787631,10407066,619435
18525,2020-02-15,13322,Capital Call,-120000,-7506000,1346467,-6159533
18525,2020-02-15,13322,Distribution,78171,-7506000,1424638,-6081362
18525,2020-03-31,13322,Value,7839260,-7506000,1424638,-6081362
18525,2020-05-16,13322,Capital Call,-124000,-7630000,1424638,-6205362
18525,2020-05-16,13322,Distribution,658351,-7630000,2082989,-5547011
18525,2020-06-30,13322,Value,6371050,-7630000,2082989,-5547011
18525,2020-08-15,13322,Capital Call,-170000,-7800000,2082989,-5717011
18525,2020-08-15,13322,Distribution,46410,-7800000,2129399,-5670601
18525,2020-09-30,13322,Value,6645600,-7800000,2129399,-5670601
18525,2020-11-15,13322,Capital Call,-325000,-8125000,2129399,-5995601
18525,2020-11-15,13322,Distribution,663163,-8125000,2792562,-5332438
18525,2020-12-31,13322,Value,6758370,-8125000,2792562,-5332438
18525,2021-02-14,13322,Capital Call,-1279000,-9404000,2792562,-6611438
18525,2021-02-14,13322,Distribution,753686,-9404000,3546248,-5857752
18525,2021-03-31,13322,Value,6088140,-9404000,3546248,-5857752
18525,2021-05-16,13322,Capital Call,-66000,-9470000,3546248,-5923752
18525,2021-05-16,13322,Distribution,55193,-9470000,3601441,-5868559
18525,2021-06-30,13322,Value,5968940,-9470000,3601441,-5868559
18525,2021-08-15,13322,Capital Call,924000,-8546000,3601441,-4944559
18525,2021-08-15,13322,Distribution,114360,-8546000,3715801,-4830199
18525,2021-09-30,13322,Value,7241020,-8546000,3715801,-4830199
18530,2020-02-15,9110,Capital Call,-73665,-10858664,7969038,-2889626
18530,2020-02-15,9110,Distribution,743695,-10858664,8712733,-2145931
18530,2020-03-31,9110,Value,8126170,-10858664,8712733,-2145931
18530,2020-05-16,9110,Capital Call,-36335,-10894999,8712733,-2182266
18530,2020-05-16,9110,Distribution,602494,-10894999,9315227,-1579772
18530,2020-06-30,9110,Value,8459960,-10894999,9315227,-1579772
18530,2020-08-15,9110,Capital Call,-42000,-10936999,9315227,-1621772
18530,2020-08-15,9110,Distribution,243713,-10936999,9558940,-1378059
18530,2020-09-30,9110,Value,9235200,-10936999,9558940,-1378059
18530,2020-11-15,9110,Capital Call,-55837,-10992836,9558940,-1433896
18530,2020-11-15,9110,Distribution,536986,-10992836,10095926,-896910
18530,2020-12-31,9110,Value,9840550,-10992836,10095926,-896910
18530,2021-02-14,9110,Capital Call,-56267,-11049103,10095926,-953177
18530,2021-02-14,9110,Distribution,737390,-11049103,10833316,-215787
18530,2021-03-31,9110,Value,9857540,-11049103,10833316,-215787
18530,2021-05-16,9110,Capital Call,105,-11048998,10833316,-215682
18530,2021-05-16,9110,Distribution,231154,-11048998,11064470,15472
18530,2021-06-30,9110,Value,10342960,-11048998,11064470,15472
18530,2021-08-15,9110,Capital Call,-63000,-11111998,11064470,-47528
18530,2021-08-15,9110,Distribution,1013164,-11111998,12077634,965636
18530,2021-09-30,9110,Value,9096280,-11111998,12077634,965636
18599,2020-02-15,7,Distribution,449820,-9800000,9100281,-699719
18599,2020-03-31,7,Value,7015820,-9800000,9100281,-699719
18599,2020-06-30,7,Value,7781200,-9800000,9100281,-699719
18599,2020-08-15,7,Capital Call,-100000,-9900000,9100281,-799719
18599,2020-08-15,7,Distribution,249280,-9900000,9349561,-550439
18599,2020-09-30,7,Value,8897130,-9900000,9349561,-550439
18629,2020-02-15,350,Capital Call,-46667,-10629999,9170000,-1459999
18629,2020-02-15,350,Distribution,440000,-10629999,9610000,-1019999
18629,2020-03-31,350,Value,6949990,-10629999,9610000,-1019999
18629,2020-05-16,350,Capital Call,-10000,-10639999,9610000,-1029999
18629,2020-06-30,350,Value,6953330,-10639999,9610000,-1029999
18629,2020-08-15,350,Capital Call,-96667,-10736666,9610000,-1126666
18629,2020-08-15,350,Distribution,1256667,-10736666,10866667,130001
18629,2020-09-30,350,Value,6766660,-10736666,10866667,130001
18629,2020-11-15,350,Capital Call,-43333,-10779999,10866667,86668
18629,2020-11-15,350,Distribution,233333,-10779999,11100000,320001
18629,2020-12-31,350,Value,6566660,-10779999,11100000,320001
18629,2021-02-14,350,Capital Call,-50000,-10829999,11100000,270001
18629,2021-02-14,350,Distribution,603333,-10829999,11703333,873334
18629,2021-03-31,350,Value,6823330,-10829999,11703333,873334
18629,2021-05-16,350,Capital Call,-43333,-10873332,11703333,830001
18629,2021-05-16,350,Distribution,266667,-10873332,11970000,1096668
18629,2021-06-30,350,Value,7133330,-10873332,11970000,1096668
18629,2021-08-15,350,Capital Call,-13333,-10886665,11970000,1083335
18629,2021-08-15,350,Distribution,396667,-10886665,12366667,1480002
18629,2021-09-30,350,Value,6749990,-10886665,12366667,1480002
18671,2021-12-31,9443,Value,0,-8627999,0,-8627999
18692,2020-03-31,6868,Value,14202820,-12404670,5156719,-7247951
18692,2020-06-30,6868,Value,14102820,-12404670,5156719,-7247951
18692,2020-09-30,6868,Value,14571170,-12404670,5156719,-7247951
18692,2020-12-31,6868,Value,15749620,-12404670,5156719,-7247951
18692,2021-02-14,6868,Capital Call,-50000,-12454670,5156719,-7297951
18692,2021-02-14,6868,Distribution,444403,-12454670,5601122,-6853548
18692,2021-03-31,6868,Value,15217620,-12454670,5601122,-6853548
18692,2021-05-16,6868,Distribution,552090,-12454670,6153212,-6301458
18692,2021-06-30,6868,Value,16594800,-12454670,6153212,-6301458
18712,2020-02-15,1355,Capital Call,-39421,-10533122,14487748,3954626
18712,2020-02-15,1355,Distribution,755705,-10533122,15243453,4710331
18712,2020-03-31,1355,Value,6454760,-10533122,15243453,4710331
18712,2020-05-16,1355,Capital Call,-78388,-10611510,15243453,4631943
18712,2020-05-16,1355,Distribution,839066,-10611510,16082519,5471009
18712,2020-06-30,1355,Value,5883290,-10611510,16082519,5471009
18712,2020-08-15,1355,Capital Call,-31573,-10643083,16082519,5439436
18712,2020-08-15,1355,Distribution,235746,-10643083,16318265,5675182
18712,2020-09-30,1355,Value,5606470,-10643083,16318265,5675182
18712,2020-11-15,1355,Capital Call,-223638,-10866721,16318265,5451544
18712,2020-11-15,1355,Distribution,755417,-10866721,17073682,6206961
18712,2020-12-31,1355,Value,4877080,-10866721,17073682,6206961
18712,2021-03-31,1355,Value,6072420,-10866721,17073682,6206961
18712,2021-05-16,1355,Capital Call,-48914,-10915635,17073682,6158047
18712,2021-05-16,1355,Distribution,446613,-10915635,17520295,6604660
18712,2021-06-30,1355,Value,5184210,-10915635,17520295,6604660
18775,2021-06-30,908,Value,0,-10663116,15108918,4445802
18783,2020-03-31,6629,Value,3695360,-11744468,5557871,-6186597
18783,2020-05-16,6629,Capital Call,-420383,-12164851,5557871,-6606980
18783,2020-06-30,6629,Value,3974400,-12164851,5557871,-6606980
18783,2020-09-30,6629,Value,3880200,-12164851,5557871,-6606980
18783,2020-11-15,6629,Capital Call,-20215,-12185066,5557871,-6627195
18783,2020-11-15,6629,Distribution,26702,-12185066,5584573,-6600493
18783,2020-12-31,6629,Value,3610840,-12185066,5584573,-6600493
18783,2021-02-14,6629,Capital Call,-112251,-12297317,5584573,-6712744
18783,2021-02-14,6629,Distribution,1263084,-12297317,6847657,-5449660
18783,2021-03-31,6629,Value,2475000,-12297317,6847657,-5449660
18783,2021-06-30,6629,Value,2613980,-12297317,6847657,-5449660
18783,2021-09-30,6629,Value,2820090,-12297317,6847657,-5449660
18784,2020-03-31,4,Value,227000,-5675001,8455749,2780748
18784,2020-06-30,4,Value,227000,-5675001,8455749,2780748
18784,2020-09-30,4,Value,227000,-5675001,8455749,2780748
18784,2020-12-31,4,Value,170250,-5675001,8455749,2780748
18784,2021-06-30,4,Value,170250,-5675001,8455749,2780748
18795,2020-05-16,96,Capital Call,-90000,-11029999,11410420,380421
18795,2020-05-16,96,Distribution,391680,-11029999,11802100,772101
18795,2020-09-30,96,Value,9044600,-11029999,11802100,772101
18795,2020-11-15,96,Capital Call,-340000,-11369999,11802100,432101
18795,2020-11-15,96,Distribution,363800,-11369999,12165900,795901
18795,2020-12-31,96,Value,14781000,-11369999,12165900,795901
18795,2021-02-14,96,Capital Call,20000,-11349999,12165900,815901
18795,2021-02-14,96,Distribution,-123550,-11349999,12042350,692351
18795,2021-03-31,96,Value,15129550,-11349999,12042350,692351
18795,2021-05-16,96,Capital Call,-90000,-11439999,12042350,602351
18795,2021-05-16,96,Distribution,328866,-11439999,12371216,931217
18795,2021-06-30,96,Value,14428120,-11439999,12371216,931217
18817,2020-02-15,8441,Capital Call,-36409,-13903180,15909595,2006415
18817,2020-02-15,8441,Distribution,334337,-13903180,16243932,2340752
18817,2020-03-31,8441,Value,3701660,-13903180,16243932,2340752
18817,2020-05-16,8441,Capital Call,-7005,-13910185,16243932,2333747
18817,2020-05-16,8441,Distribution,35732,-13910185,16279664,2369479
18817,2020-06-30,8441,Value,3665930,-13910185,16279664,2369479
18817,2020-08-15,8441,Capital Call,-315329,-14225514,16279664,2054150
18817,2020-09-30,8441,Value,4227190,-14225514,16279664,2054150
18817,2020-11-15,8441,Capital Call,-11791,-14237305,16279664,2042359
18817,2020-11-15,8441,Distribution,541532,-14237305,16821196,2583891
18817,2020-12-31,8441,Value,4183150,-14237305,16821196,2583891
18817,2021-03-31,8441,Value,5290520,-14237305,16821196,2583891
18817,2021-05-16,8441,Capital Call,1271248,-12966057,16821196,3855139
18817,2021-06-30,8441,Value,5872660,-12966057,16821196,3855139
18818,2020-01-15,554,Capital Call,-268342,-7605457,9330941,1725484
18818,2020-01-15,554,Distribution,0,-7605457,9330941,1725484
18818,2020-02-29,554,Value,1921410,-7605457,9330941,1725484
18818,2020-04-15,554,Distribution,0,-7605457,9330941,1725484
18818,2020-05-31,554,Value,1717660,-7605457,9330941,1725484
18818,2020-07-16,554,Distribution,403174,-7605457,9734115,2128658
18818,2020-08-31,554,Value,1512480,-7605457,9734115,2128658
18818,2020-10-16,554,Capital Call,-57435,-7662892,9734115,2071223
18818,2020-11-30,554,Value,1586060,-7662892,9734115,2071223
18818,2021-01-14,554,Distribution,1400088,-7662892,11134203,3471311
18818,2021-02-28,554,Value,824790,-7662892,11134203,3471311
18818,2021-05-31,554,Value,793190,-7662892,11134203,3471311
18818,2021-07-16,554,Distribution,303933,-7662892,11438136,3775244
18818,2021-08-31,554,Value,307530,-7662892,11438136,3775244
18818,2021-10-16,554,Distribution,0,-7662892,11438136,3775244
18818,2021-11-30,554,Value,342050,-7662892,11438136,3775244
18819,2020-02-15,1597,Distribution,545125,-8750000,6258000,-2492000
18819,2020-03-31,1597,Value,14580120,-8750000,6258000,-2492000
18819,2020-06-30,1597,Value,15532120,-8750000,6258000,-2492000
18819,2020-08-15,1597,Distribution,1496250,-8750000,7754250,-995750
18819,2020-09-30,1597,Value,11530750,-8750000,7754250,-995750
18819,2020-12-31,1597,Value,14427870,-8750000,7754250,-995750
18819,2021-03-31,1597,Value,15743870,-8750000,7754250,-995750
18819,2021-05-16,1597,Distribution,462875,-8750000,8217125,-532875
18819,2021-06-30,1597,Value,15264370,-8750000,8217125,-532875
18819,2021-08-15,1597,Distribution,642250,-8750000,8859375,109375
18819,2021-09-30,1597,Value,13905500,-8750000,8859375,109375
18826,2020-03-31,32423,Value,0,-9170000,16359280,7189280
18826,2020-06-30,32423,Value,0,-9170000,16359280,7189280
18826,2020-09-30,32423,Value,0,-9170000,16359280,7189280
18826,2020-12-31,32423,Value,0,-9170000,16359280,7189280
18826,2021-03-31,32423,Value,0,-9170000,16359280,7189280
18826,2021-06-30,32423,Value,0,-9170000,16359280,7189280
18826,2021-09-30,32423,Value,0,-9170000,16359280,7189280
18826,2021-12-31,32423,Value,0,-9170000,16359280,7189280
18833,2020-03-31,10781,Value,0,-9657703,5342071,-4315632
18833,2020-06-30,10781,Value,0,-9657703,5342071,-4315632
18833,2020-09-30,10781,Value,0,-9657703,5342071,-4315632
18833,2020-12-31,10781,Value,0,-9657703,5342071,-4315632
18833,2021-03-31,10781,Value,0,-9657703,5342071,-4315632
18833,2021-06-30,10781,Value,0,-9657703,5342071,-4315632
18833,2021-09-30,10781,Value,0,-9657703,5342071,-4315632
18833,2021-12-31,10781,Value,0,-9657703,5342071,-4315632
18851,2020-02-15,32422,Capital Call,5000,-8230000,5105701,-3124299
18851,2020-02-15,32422,Distribution,-3100,-8230000,5102601,-3127399
18851,2020-03-31,32422,Value,10534400,-8230000,5102601,-3127399
18851,2020-06-30,32422,Value,10040600,-8230000,5102601,-3127399
18858,2020-02-15,24219,Capital Call,-35599,-11203547,3986971,-7216576
18858,2020-02-15,24219,Distribution,113737,-11203547,4100708,-7102839
18858,2020-03-31,24219,Value,5102520,-11203547,4100708,-7102839
18858,2020-05-16,24219,Capital Call,-64823,-11268370,4100708,-7167662
18858,2020-06-30,24219,Value,6337610,-11268370,4100708,-7167662
18858,2020-08-15,24219,Capital Call,-43631,-11312001,4100708,-7211293
18858,2020-08-15,24219,Distribution,2275456,-11312001,6376164,-4935837
18858,2020-09-30,24219,Value,5020090,-11312001,6376164,-4935837
18858,2020-11-15,24219,Capital Call,-29546,-11341547,6376164,-4965383
18858,2020-11-15,24219,Distribution,2156298,-11341547,8532462,-2809085
18858,2020-12-31,24219,Value,3428640,-11341547,8532462,-2809085
18858,2021-02-14,24219,Distribution,589513,-11341547,9121975,-2219572
18858,2021-03-31,24219,Value,3904050,-11341547,9121975,-2219572
18858,2021-05-16,24219,Capital Call,-21456,-11363003,9121975,-2241028
18858,2021-05-16,24219,Distribution,3693216,-11363003,12815191,1452188
18858,2021-06-30,24219,Value,1434930,-11363003,12815191,1452188
18972,2020-02-15,40167,Capital Call,-30000,-9160000,6902000,-2258000
18972,2020-03-31,40167,Value,4106000,-9160000,6902000,-2258000
18972,2020-06-30,40167,Value,4106000,-9160000,6902000,-2258000
18972,2020-08-15,40167,Capital Call,-78000,-9238000,6902000,-2336000
18972,2020-08-15,40167,Distribution,82000,-9238000,6984000,-2254000
18972,2020-09-30,40167,Value,3792000,-9238000,6984000,-2254000
18972,2020-12-31,40167,Value,3678000,-9238000,6984000,-2254000
18972,2021-02-14,40167,Capital Call,-8000,-9246000,6984000,-2262000
18972,2021-02-14,40167,Distribution,222000,-9246000,7206000,-2040000
18972,2021-03-31,40167,Value,3486000,-9246000,7206000,-2040000
18972,2021-05-16,40167,Capital Call,-20000,-9266000,7206000,-2060000
18972,2021-05-16,40167,Distribution,102000,-9266000,7308000,-1958000
18972,2021-06-30,40167,Value,3252000,-9266000,7308000,-1958000
18972,2021-08-15,40167,Capital Call,-26000,-9292000,7308000,-1984000
18972,2021-08-15,40167,Distribution,484000,-9292000,7792000,-1500000
18972,2021-09-30,40167,Value,2794550,-9292000,7792000,-1500000
18975,2020-02-15,11277,Distribution,626735,-9584338,5496266,-4088072
18975,2020-03-31,11277,Value,1652100,-9584338,5496266,-4088072
18975,2020-05-16,11277,Distribution,223355,-9584338,5719621,-3864717
18975,2020-06-30,11277,Value,1670170,-9584338,5719621,-3864717
18975,2020-08-15,11277,Distribution,197456,-9584338,5917077,-3667261
18975,2020-09-30,11277,Value,1648520,-9584338,5917077,-3667261
18975,2020-12-31,11277,Value,2298700,-9584338,5917077,-3667261
18975,2021-02-14,11277,Distribution,526933,-9584338,6444010,-3140328
18975,2021-03-31,11277,Value,1795410,-9584338,6444010,-3140328
18977,2020-03-31,2575,Value,4227660,-10000000,3412490,-6587510
18977,2020-06-30,2575,Value,3021670,-10000000,3412490,-6587510
18977,2020-09-30,2575,Value,3011880,-10000000,3412490,-6587510
18977,2020-11-15,2575,Distribution,0,-10000000,3412490,-6587510
18977,2020-12-31,2575,Value,2474360,-10000000,3412490,-6587510
18977,2021-02-14,2575,Distribution,0,-10000000,3412490,-6587510
18977,2021-03-31,2575,Value,2475870,-10000000,3412490,-6587510
18977,2021-05-16,2575,Distribution,683594,-10000000,4096084,-5903916
18977,2021-06-30,2575,Value,1948470,-10000000,4096084,-5903916
18977,2021-09-30,2575,Value,2178800,-10000000,4096084,-5903916
19010,2020-03-31,483,Value,2230670,-9517860,22848686,13330826
19010,2020-06-30,483,Value,2230670,-9517860,22848686,13330826
19010,2020-09-30,483,Value,2701970,-9517860,22848686,13330826
19010,2020-12-30,483,Distribution,2097106,-9517860,24945792,15427932
19010,2021-03-31,483,Value,2093030,-9517860,24945792,15427932
19010,2021-05-16,483,Capital Call,148495,-9369365,24945792,15576427
19010,2021-06-30,483,Value,3352800,-9369365,24945792,15576427
19089,2020-03-31,174,Value,2691420,-10982857,15508571,4525714
19089,2020-05-16,174,Capital Call,-257143,-11240000,15508571,4268571
19089,2020-06-30,174,Value,3337140,-11240000,15508571,4268571
19089,2020-09-30,174,Value,3579990,-11240000,15508571,4268571
19089,2020-12-31,174,Value,3528570,-11240000,15508571,4268571
19089,2021-03-31,174,Value,4468570,-11240000,15508571,4268571
19089,2021-06-30,174,Value,4782850,-11240000,15508571,4268571
19089,2021-08-15,174,Capital Call,-351429,-11591429,15508571,3917142
19089,2021-08-15,174,Distribution,350286,-11591429,15858857,4267428
19089,2021-09-30,174,Value,5148280,-11591429,15858857,4267428
19120,2020-02-29,45418,Value,498830,-8670898,16787108,8116210
19120,2020-05-31,45418,Value,482760,-8670898,16787108,8116210
19120,2020-08-31,45418,Value,482760,-8670898,16787108,8116210
19120,2020-11-30,45418,Value,482760,-8670898,16787108,8116210
19120,2021-02-28,45418,Value,482760,-8670898,16787108,8116210
19120,2021-05-31,45418,Value,499260,-8670898,16787108,8116210
19120,2021-08-31,45418,Value,499260,-8670898,16787108,8116210
19120,2021-11-30,45418,Value,498010,-8670898,16787108,8116210
19133,2020-02-15,45,Distribution,2263514,-10000000,18447147,8447147
19133,2020-03-31,45,Value,12166210,-10000000,18447147,8447147
19133,2020-06-30,45,Value,14138930,-10000000,18447147,8447147
19133,2020-09-30,45,Value,14098610,-10000000,18447147,8447147
19133,2020-11-15,45,Distribution,13940099,-10000000,32387246,22387246
19133,2020-12-31,45,Value,274240,-10000000,32387246,22387246
19133,2021-03-31,45,Value,272740,-10000000,32387246,22387246
19133,2021-06-30,45,Value,290340,-10000000,32387246,22387246
19139,2020-02-15,355,Capital Call,-100000,-9500000,6688532,-2811468
19139,2020-02-15,355,Distribution,394265,-9500000,7082797,-2417203
19139,2020-03-31,355,Value,7359830,-9500000,7082797,-2417203
19139,2020-05-16,355,Distribution,98566,-9500000,7181363,-2318637
19139,2020-06-30,355,Value,7802350,-9500000,7181363,-2318637
19139,2020-08-15,355,Distribution,325269,-9500000,7506632,-1993368
19139,2020-09-30,355,Value,7988320,-9500000,7506632,-1993368
19139,2020-11-15,355,Distribution,709677,-9500000,8216309,-1283691
19139,2020-12-31,355,Value,7278640,-9500000,8216309,-1283691
19139,2021-02-14,355,Distribution,275986,-9500000,8492295,-1007705
19139,2021-03-31,355,Value,9606330,-9500000,8492295,-1007705
19139,2021-06-30,355,Value,9364080,-9500000,8492295,-1007705
19144,2020-02-15,18,Capital Call,0,-8895001,8487609,-407392
19144,2020-02-15,18,Distribution,-91,-8895001,8487518,-407483
19144,2020-03-31,18,Value,5739320,-8895001,8487518,-407483
19144,2020-05-16,18,Distribution,723528,-8895001,9211046,316045
19144,2020-06-30,18,Value,5876590,-8895001,9211046,316045
19144,2020-09-30,18,Value,6525860,-8895001,9211046,316045
19144,2020-11-15,18,Distribution,418809,-8895001,9629855,734854
19144,2020-12-31,18,Value,7055650,-8895001,9629855,734854
19144,2021-02-14,18,Distribution,437583,-8895001,10067438,1172437
19144,2021-03-31,18,Value,7335590,-8895001,10067438,1172437
19144,2021-05-16,18,Capital Call,5,-8894996,10067438,1172442
19144,2021-05-16,18,Distribution,477059,-8894996,10544497,1649501
19144,2021-06-30,18,Value,7647670,-8894996,10544497,1649501
19144,2021-08-15,18,Distribution,441915,-8894996,10986412,2091416
19144,2021-09-30,18,Value,7345500,-8894996,10986412,2091416
19146,2020-02-15,18,Capital Call,0,-9687533,14916138,5228605
19146,2020-02-15,18,Distribution,-244,-9687533,14915894,5228361
19146,2020-03-31,18,Value,5989800,-9687533,14915894,5228361
19146,2020-05-16,18,Capital Call,-115006,-9802539,14915894,5113355
19146,2020-05-16,18,Distribution,478013,-9802539,15393907,5591368
19146,2020-06-30,18,Value,6620730,-9802539,15393907,5591368
19146,2020-08-15,18,Distribution,291135,-9802539,15685042,5882503
19146,2020-09-30,18,Value,6273620,-9802539,15685042,5882503
19146,2020-12-31,18,Value,7719490,-9802539,15685042,5882503
19146,2021-02-14,18,Capital Call,539,-9802000,15685042,5883042
19146,2021-02-14,18,Distribution,255654,-9802000,15940696,6138696
19146,2021-03-31,18,Value,8491330,-9802000,15940696,6138696
19146,2021-05-16,18,Capital Call,0,-9802000,15940696,6138696
19146,2021-05-16,18,Distribution,804059,-9802000,16744755,6942755
19146,2021-06-30,18,Value,7056450,-9802000,16744755,6942755
19146,2021-09-30,18,Value,8258810,-9802000,16744755,6942755
19158,2020-03-31,2901,Value,21003270,-9400000,6823747,-2576253
19158,2020-05-16,2901,Distribution,3772151,-9400000,10595898,1195898
19158,2020-06-30,2901,Value,18099380,-9400000,10595898,1195898
19158,2020-09-30,2901,Value,19886070,-9400000,10595898,1195898
19158,2020-11-15,2901,Distribution,653761,-9400000,11249659,1849659
19158,2020-12-31,2901,Value,19886070,-9400000,11249659,1849659
19158,2021-02-14,2901,Distribution,782562,-9400000,12032221,2632221
19158,2021-03-31,2901,Value,27376930,-9400000,12032221,2632221
19394,2020-03-31,15,Value,2009520,-8230951,11697619,3466668
19394,2020-06-30,15,Value,1752380,-8230951,11697619,3466668
19394,2020-08-15,15,Distribution,116667,-8230951,11814286,3583335
19394,2020-09-30,15,Value,1690470,-8230951,11814286,3583335
19394,2020-12-31,15,Value,1926190,-8230951,11814286,3583335
19394,2021-02-14,15,Distribution,92857,-8230951,11907143,3676192
19394,2021-03-31,15,Value,1923800,-8230951,11907143,3676192
19394,2021-05-16,15,Distribution,614286,-8230951,12521429,4290478
19394,2021-06-30,15,Value,1647610,-8230951,12521429,4290478
19394,2021-08-15,15,Distribution,364286,-8230951,12885715,4654764
19394,2021-09-30,15,Value,1758910,-8230951,12885715,4654764
19574,2020-03-31,13022,Value,1422730,-10175123,34122249,23947126
19574,2020-06-30,13022,Value,2121930,-10175123,34122249,23947126
19574,2020-09-30,13022,Value,2528150,-10175123,34122249,23947126
19574,2020-11-15,13022,Distribution,126836,-10175123,34249085,24073962
19574,2020-12-31,13022,Value,2319500,-10175123,34249085,24073962
19574,2021-02-14,13022,Distribution,242206,-10175123,34491291,24316168
19574,2021-03-31,13022,Value,2875520,-10175123,34491291,24316168
19574,2021-05-16,13022,Capital Call,-223390,-10398513,34491291,24092778
19574,2021-05-16,13022,Distribution,1540027,-10398513,36031318,25632805
19574,2021-06-30,13022,Value,674280,-10398513,36031318,25632805
19589,2020-03-31,39494,Value,0,-12673333,20346667,7673334
19589,2020-06-30,39494,Value,0,-12673333,20346667,7673334
19589,2020-09-30,39494,Value,0,-12673333,20346667,7673334
19589,2020-12-31,39494,Value,0,-12673333,20346667,7673334
19589,2021-03-31,39494,Value,0,-12673333,20346667,7673334
19589,2021-06-30,39494,Value,0,-12673333,20346667,7673334
19589,2021-09-30,39494,Value,0,-12673333,20346667,7673334
19589,2021-12-31,39494,Value,0,-12673333,20346667,7673334
19590,2020-03-31,39494,Value,1673330,-13316667,25486667,12170000
19590,2020-05-16,39494,Capital Call,-36667,-13353334,25486667,12133333
19590,2020-05-16,39494,Distribution,213333,-13353334,25700000,12346666
19590,2020-06-30,39494,Value,1513330,-13353334,25700000,12346666
19590,2020-09-30,39494,Value,1513330,-13353334,25700000,12346666
19590,2020-12-31,39494,Value,1323330,-13353334,25700000,12346666
19590,2021-03-31,39494,Value,1349990,-13353334,25700000,12346666
19590,2021-06-30,39494,Value,1349990,-13353334,25700000,12346666
19590,2021-08-15,39494,Capital Call,333,-13353001,25700000,12346999
19590,2021-08-15,39494,Distribution,341333,-13353001,26041333,12688332
19590,2021-09-30,39494,Value,1010990,-13353001,26041333,12688332
19619,2020-03-31,21861,Value,2960000,-10000000,22180000,12180000
19619,2020-05-16,21861,Distribution,130000,-10000000,22310000,12310000
19619,2020-06-30,21861,Value,2830000,-10000000,22310000,12310000
19619,2020-08-15,21861,Distribution,-130000,-10000000,22180000,12180000
19619,2020-09-30,21861,Value,3030000,-10000000,22180000,12180000
19619,2020-11-15,21861,Distribution,3000,-10000000,22183000,12183000
19619,2020-12-31,21861,Value,3194000,-10000000,22183000,12183000
19619,2021-03-31,21861,Value,3185000,-10000000,22183000,12183000
19619,2021-06-30,21861,Value,3176000,-10000000,22183000,12183000
19619,2021-09-30,21861,Value,4256000,-10000000,22183000,12183000
19619,2021-12-31,21861,Value,4478000,-10000000,22183000,12183000
19645,2020-12-31,246,Value,280000,-10000000,15750000,5750000
19686,2020-02-15,808,Capital Call,-362696,-9861624,7456029,-2405595
19686,2020-02-15,808,Distribution,56451,-9861624,7512480,-2349144
19686,2020-03-31,808,Value,9474070,-9861624,7512480,-2349144
19686,2020-05-16,808,Capital Call,796,-9860828,7512480,-2348348
19686,2020-05-16,808,Distribution,58321,-9860828,7570801,-2290027
19686,2020-06-30,808,Value,10028070,-9860828,7570801,-2290027
19686,2020-09-30,808,Value,12939940,-9860828,7570801,-2290027
19686,2020-11-15,808,Distribution,1903486,-9860828,9474287,-386541
19686,2020-12-31,808,Value,11959920,-9860828,9474287,-386541
19709,2020-06-30,10336,Value,781590,-10000000,5487501,-4512499
19709,2020-09-30,10336,Value,706410,-10000000,5487501,-4512499
19709,2020-12-31,10336,Value,706410,-10000000,5487501,-4512499
19709,2021-03-31,10336,Value,701970,-10000000,5487501,-4512499
19807,2020-02-15,581,Capital Call,-61875,-12437217,10832927,-1604290
19807,2020-02-15,581,Distribution,18411,-12437217,10851338,-1585879
19807,2020-03-31,581,Value,8585110,-12437217,10851338,-1585879
19807,2020-05-16,581,Capital Call,-39515,-12476732,10851338,-1625394
19807,2020-06-30,581,Value,8257510,-12476732,10851338,-1625394
19807,2020-08-15,581,Capital Call,-26764,-12503496,10851338,-1652158
19807,2020-09-30,581,Value,8266520,-12503496,10851338,-1652158
19807,2020-11-15,581,Capital Call,-40933,-12544429,10851338,-1693091
19807,2020-12-31,581,Value,8124700,-12544429,10851338,-1693091
19807,2021-02-14,581,Capital Call,-55552,-12599981,10851338,-1748643
19807,2021-03-31,581,Value,8160230,-12599981,10851338,-1748643
19807,2021-05-16,581,Capital Call,-23643,-12623624,10851338,-1772286
19807,2021-06-30,581,Value,7777020,-12623624,10851338,-1772286
19810,2020-02-29,7473,Value,7378550,-9805000,0,-9805000
19810,2020-04-15,7473,Capital Call,-100000,-9905000,0,-9905000
19810,2020-05-31,7473,Value,8988070,-9905000,0,-9905000
19810,2020-08-31,7473,Value,8948820,-9905000,0,-9905000
19810,2020-11-30,7473,Value,8925470,-9905000,0,-9905000
19810,2021-01-14,7473,Capital Call,-95000,-10000000,0,-10000000
19810,2021-02-28,7473,Value,9020470,-10000000,0,-10000000
19810,2021-05-31,7473,Value,9201330,-10000000,0,-10000000
19810,2021-08-31,7473,Value,9179670,-10000000,0,-10000000
19810,2021-11-30,7473,Value,8897260,-10000000,0,-10000000
19880,2020-02-15,11813,Capital Call,24978,-9300000,6729839,-2570161
19880,2020-02-15,11813,Distribution,501844,-9300000,7231683,-2068317
19880,2020-03-31,11813,Value,14255970,-9300000,7231683,-2068317
19880,2020-05-16,11813,Distribution,760740,-9300000,7992423,-1307577
19880,2020-06-30,11813,Value,15481710,-9300000,7992423,-1307577
19880,2020-08-15,11813,Distribution,1432200,-9300000,9424623,124623
19880,2020-09-30,11813,Value,17721150,-9300000,9424623,124623
19880,2020-11-15,11813,Distribution,1503810,-9300000,10928433,1628433
19880,2020-12-31,11813,Value,22373010,-9300000,10928433,1628433
19880,2021-02-14,11813,Distribution,1969740,-9300000,12898173,3598173
19880,2021-03-31,11813,Value,25178820,-9300000,12898173,3598173
19880,2021-05-16,11813,Distribution,5611620,-9300000,18509793,9209793
19880,2021-06-30,11813,Value,19460250,-9300000,18509793,9209793
19923,2020-06-08,708,Distribution,-1,9,-8,1
19923,2020-12-31,708,Value,10,9,-8,1
19958,2020-03-31,1878,Value,6930000,-9000000,8010000,-990000
19958,2020-06-30,1878,Value,7110000,-9000000,8010000,-990000
19958,2020-08-15,1878,Distribution,540000,-9000000,8550000,-450000
19958,2020-09-30,1878,Value,7110000,-9000000,8550000,-450000
19958,2020-12-31,1878,Value,7020000,-9000000,8550000,-450000
19958,2021-02-14,1878,Distribution,720000,-9000000,9270000,270000
19958,2021-03-31,1878,Value,6300000,-9000000,9270000,270000
19958,2021-06-30,1878,Value,6570000,-9000000,9270000,270000
19958,2021-08-15,1878,Distribution,450000,-9000000,9720000,720000
19958,2021-09-30,1878,Value,7020000,-9000000,9720000,720000
20120,2020-02-15,28684,Capital Call,-530000,-7410000,8290000,880000
20120,2020-03-31,28684,Value,5580000,-7410000,8290000,880000
20120,2020-05-16,28684,Capital Call,-10000,-7420000,8290000,870000
20120,2020-05-16,28684,Distribution,100000,-7420000,8390000,970000
20120,2020-06-30,28684,Value,5630000,-7420000,8390000,970000
20120,2020-09-30,28684,Value,5980000,-7420000,8390000,970000
20120,2020-12-31,28684,Value,6320000,-7420000,8390000,970000
20120,2021-03-31,28684,Value,6330000,-7420000,8390000,970000
20120,2021-05-16,28684,Distribution,130000,-7420000,8520000,1100000
20120,2021-06-30,28684,Value,6600000,-7420000,8520000,1100000
20120,2021-09-30,28684,Value,7000000,-7420000,8520000,1100000
20142,2020-02-15,8710,Capital Call,-170667,-9315334,10504002,1188668
20142,2020-03-31,8710,Value,11372660,-9315334,10504002,1188668
20142,2020-05-16,8710,Distribution,1098667,-9315334,11602669,2287335
20142,2020-06-30,8710,Value,14910660,-9315334,11602669,2287335
20142,2020-08-15,8710,Capital Call,-191333,-9506667,11602669,2096002
20142,2020-08-15,8710,Distribution,2618667,-9506667,14221336,4714669
20142,2020-09-30,8710,Value,12403330,-9506667,14221336,4714669
20142,2020-11-15,8710,Capital Call,-46667,-9553334,14221336,4668002
20142,2020-12-31,8710,Value,12940000,-9553334,14221336,4668002
20142,2021-03-31,8710,Value,12319330,-9553334,14221336,4668002
20142,2021-05-16,8710,Distribution,1818000,-9553334,16039336,6486002
20142,2021-06-30,8710,Value,10198660,-9553334,16039336,6486002
20161,2020-03-31,21200,Value,0,-9760000,18160431,8400431
20161,2020-06-30,21200,Value,0,-9760000,18160431,8400431
20161,2020-09-30,21200,Value,0,-9760000,18160431,8400431
20161,2020-12-31,21200,Value,0,-9760000,18160431,8400431
20161,2021-03-31,21200,Value,0,-9760000,18160431,8400431
20161,2021-06-30,21200,Value,0,-9760000,18160431,8400431
20161,2021-09-30,21200,Value,0,-9760000,18160431,8400431
20161,2021-12-31,21200,Value,0,-9760000,18160431,8400431
20176,2020-03-31,8837,Value,1899990,-14730001,10779999,-3950002
20176,2020-06-30,8837,Value,1889990,-14730001,10779999,-3950002
20176,2020-09-30,8837,Value,1959990,-14730001,10779999,-3950002
20176,2020-12-31,8837,Value,1549990,-14730001,10779999,-3950002
20176,2021-03-31,8837,Value,1699990,-14730001,10779999,-3950002
20176,2021-06-30,8837,Value,1769990,-14730001,10779999,-3950002
20176,2021-09-30,8837,Value,1799990,-14730001,10779999,-3950002
20187,2020-03-31,147,Value,811930,-9243401,20930702,11687301
20187,2020-06-30,147,Value,905620,-9243401,20930702,11687301
20187,2020-09-30,147,Value,991460,-9243401,20930702,11687301
20187,2020-12-31,147,Value,1036340,-9243401,20930702,11687301
20187,2021-02-14,147,Distribution,964890,-9243401,21895592,12652191
20187,2021-03-31,147,Value,0,-9243401,21895592,12652191
20187,2021-09-30,147,Value,0,-9243401,21895592,12652191
20187,2021-12-31,147,Value,0,-9243401,21895592,12652191
20201,2020-02-15,11277,Capital Call,-9112,-10258884,11213631,954747
20201,2020-02-15,11277,Distribution,1571682,-10258884,12785313,2526429
20201,2020-03-31,11277,Value,10046910,-10258884,12785313,2526429
20201,2020-05-16,11277,Capital Call,-8642,-10267526,12785313,2517787
20201,2020-05-16,11277,Distribution,284382,-10267526,13069695,2802169
20201,2020-06-30,11277,Value,11552080,-10267526,13069695,2802169
20201,2020-08-15,11277,Capital Call,-16197,-10283723,13069695,2785972
20201,2020-08-15,11277,Distribution,611519,-10283723,13681214,3397491
20201,2020-09-30,11277,Value,13120460,-10283723,13681214,3397491
20201,2020-11-15,11277,Capital Call,-8201,-10291924,13681214,3389290
20201,2020-11-15,11277,Distribution,1095479,-10291924,14776693,4484769
20201,2020-12-31,11277,Value,15498210,-10291924,14776693,4484769
20201,2021-02-14,11277,Capital Call,-37042,-10328966,14776693,4447727
20201,2021-02-14,11277,Distribution,764096,-10328966,15540789,5211823
20201,2021-03-31,11277,Value,18021470,-10328966,15540789,5211823
20206,2020-02-15,346,Distribution,1317143,-9324858,19095143,9770285
20206,2020-03-31,346,Value,327420,-9324858,19095143,9770285
20206,2020-06-30,346,Value,503140,-9324858,19095143,9770285
20206,2020-09-30,346,Value,616280,-9324858,19095143,9770285
20206,2020-12-31,346,Value,761420,-9324858,19095143,9770285
20206,2021-03-31,346,Value,894280,-9324858,19095143,9770285
20206,2021-06-30,346,Value,949420,-9324858,19095143,9770285
20250,2020-03-31,766,Value,10473410,-6600000,308246,-6291754
20250,2020-05-16,766,Distribution,409399,-6600000,717645,-5882355
20250,2020-06-30,766,Value,9962390,-6600000,717645,-5882355
20250,2020-09-30,766,Distribution,1105047,-6600000,1822692,-4777308
20250,2020-12-31,766,Value,11087520,-6600000,1822692,-4777308
20250,2021-02-14,766,Distribution,1280000,-6600000,3102692,-3497308
20250,2021-03-31,766,Value,9807520,-6600000,3102692,-3497308
20250,2021-05-16,766,Distribution,1631629,-6600000,4734321,-1865679
20250,2021-06-30,766,Value,11093270,-6600000,4734321,-1865679
20250,2021-08-15,766,Distribution,2000334,-6600000,6734655,134655
20250,2021-09-30,766,Value,9995700,-6600000,6734655,134655
20276,2020-02-15,2007,Distribution,173864,-9779545,12614774,2835229
20276,2020-03-31,2007,Value,7357950,-9779545,12614774,2835229
20276,2020-06-30,2007,Value,8188630,-9779545,12614774,2835229
20276,2020-08-15,2007,Distribution,3123864,-9779545,15738638,5959093
20276,2020-09-30,2007,Value,6460220,-9779545,15738638,5959093
20276,2020-11-15,2007,Distribution,5212500,-9779545,20951138,11171593
20276,2020-12-31,2007,Value,2994310,-9779545,20951138,11171593
20276,2021-02-14,2007,Distribution,2056818,-9779545,23007956,13228411
20276,2021-03-31,2007,Value,929540,-9779545,23007956,13228411
20312,2020-02-15,436,Capital Call,-20000,-11409999,7619910,-3790089
20312,2020-02-15,436,Distribution,1970,-11409999,7621880,-3788119
20312,2020-03-31,436,Value,4621050,-11409999,7621880,-3788119
20312,2020-05-16,436,Capital Call,-20000,-11429999,7621880,-3808119
20312,2020-05-16,436,Distribution,93370,-11429999,7715250,-3714749
20312,2020-06-30,436,Value,4606290,-11429999,7715250,-3714749
20312,2020-08-15,436,Capital Call,-20000,-11449999,7715250,-3734749
20312,2020-08-15,436,Distribution,162350,-11449999,7877600,-3572399
20312,2020-09-30,436,Value,4408250,-11449999,7877600,-3572399
20312,2020-11-15,436,Distribution,354950,-11449999,8232550,-3217449
20312,2020-12-31,436,Value,4110550,-11449999,8232550,-3217449
20312,2021-04-01,436,Capital Call,-40000,-11489999,8232550,-3257449
20312,2021-04-01,436,Distribution,1867160,-11489999,10099710,-1390289
20312,2021-06-30,436,Value,2493330,-11489999,10099710,-1390289
20312,2021-08-15,436,Capital Call,-10000,-11499999,10099710,-1400289
20312,2021-08-15,436,Distribution,-2710,-11499999,10097000,-1402999
20312,2021-09-30,436,Value,2434550,-11499999,10097000,-1402999
20312,2021-11-15,436,Capital Call,-8000,-11507999,10097000,-1410999
20312,2021-11-15,436,Distribution,119,-11507999,10097119,-1410880
20312,2021-12-31,436,Value,2494930,-11507999,10097119,-1410880
20322,2020-02-15,77,Capital Call,-34803,-8134804,12716998,4582194
20322,2020-02-15,77,Distribution,80143,-8134804,12797141,4662337
20322,2020-03-31,77,Value,136760,-8134804,12797141,4662337
20322,2020-05-16,77,Capital Call,-60,-8134864,12797141,4662277
20322,2020-05-16,77,Distribution,50246,-8134864,12847387,4712523
20322,2020-06-30,77,Value,82330,-8134864,12847387,4712523
20322,2020-09-30,77,Value,79810,-8134864,12847387,4712523
20322,2020-12-31,77,Value,80890,-8134864,12847387,4712523
20322,2021-03-31,77,Value,80890,-8134864,12847387,4712523
20322,2021-05-16,77,Capital Call,60,-8134804,12847387,4712583
20322,2021-05-16,77,Distribution,-94,-8134804,12847293,4712489
20322,2021-06-30,77,Value,80890,-8134804,12847293,4712489
20322,2021-08-15,77,Capital Call,-60,-8134864,12847293,4712429
20322,2021-08-15,77,Distribution,94,-8134864,12847387,4712523
20322,2021-09-30,77,Value,80890,-8134864,12847387,4712523
20414,2020-02-15,264,Capital Call,-74105,-9400000,13895583,4495583
20414,2020-02-15,264,Distribution,497697,-9400000,14393280,4993280
20414,2020-03-31,264,Value,3083200,-9400000,14393280,4993280
20414,2020-05-16,264,Distribution,458720,-9400000,14852000,5452000
20414,2020-06-30,264,Value,2632000,-9400000,14852000,5452000
20414,2020-08-15,264,Distribution,-752000,-9400000,14100000,4700000
20414,2020-09-30,264,Value,2820000,-9400000,14100000,4700000
20414,2020-11-15,264,Distribution,940000,-9400000,15040000,5640000
20414,2020-12-31,264,Value,2820000,-9400000,15040000,5640000
20414,2021-02-14,264,Capital Call,-100000,-9500000,15040000,5540000
20414,2021-02-14,264,Distribution,160000,-9500000,15200000,5700000
20414,2021-03-31,264,Value,2850000,-9500000,15200000,5700000
20414,2021-05-16,264,Capital Call,-400000,-9900000,15200000,5300000
20414,2021-05-16,264,Distribution,640000,-9900000,15840000,5940000
20414,2021-06-30,264,Value,3960000,-9900000,15840000,5940000
20414,2021-08-15,264,Capital Call,160000,-9740000,15840000,6100000
20414,2021-08-15,264,Distribution,-547226,-9740000,15292774,5552774
20414,2021-09-30,264,Value,3575550,-9740000,15292774,5552774
20423,2020-07-01,15979,Distribution,426793,-8418000,11313793,2895793
20423,2020-12-31,15979,Value,1841010,-8418000,11313793,2895793
20423,2021-07-02,15979,Distribution,750886,-8418000,12064679,3646679
20423,2021-12-31,15979,Value,1197880,-8418000,12064679,3646679
20425,2020-03-31,372,Value,8529990,-14180000,8880000,-5300000
20425,2020-05-16,372,Capital Call,-30000,-14210000,8880000,-5330000
20425,2020-05-16,372,Distribution,180000,-14210000,9060000,-5150000
20425,2020-06-30,372,Value,9230000,-14210000,9060000,-5150000
20425,2020-08-15,372,Distribution,930000,-14210000,9990000,-4220000
20425,2020-09-30,372,Value,9499990,-14210000,9990000,-4220000
20425,2020-12-31,372,Value,9680000,-14210000,9990000,-4220000
20425,2021-02-14,372,Capital Call,10000,-14200000,9990000,-4210000
20425,2021-02-14,372,Distribution,-10000,-14200000,9980000,-4220000
20425,2021-03-31,372,Value,9870000,-14200000,9980000,-4220000
20425,2021-05-16,372,Capital Call,-80000,-14280000,9980000,-4300000
20425,2021-05-16,372,Distribution,260000,-14280000,10240000,-4040000
20425,2021-06-30,372,Value,10360000,-14280000,10240000,-4040000
20425,2021-08-15,372,Capital Call,1000,-14279000,10240000,-4039000
20425,2021-08-15,372,Distribution,-1000,-14279000,10239000,-4040000
20425,2021-09-30,372,Value,11386990,-14279000,10239000,-4040000
20428,2020-02-15,395,Distribution,328000,-9999999,12216001,2216002
20428,2020-03-31,395,Value,4679200,-9999999,12216001,2216002
20428,2020-06-30,395,Value,4816800,-9999999,12216001,2216002
20428,2020-09-30,395,Value,5009600,-9999999,12216001,2216002
20428,2020-11-15,395,Distribution,485600,-9999999,12701601,2701602
20428,2020-12-31,395,Value,5630400,-9999999,12701601,2701602
20428,2021-03-31,395,Value,7298400,-9999999,12701601,2701602
20428,2021-05-16,395,Distribution,229600,-9999999,12931201,2931202
20428,2021-06-30,395,Value,9149600,-9999999,12931201,2931202
20502,2020-03-31,885,Value,5750000,-11500000,10350000,-1150000
20502,2020-12-31,885,Value,6900000,-11500000,10350000,-1150000
20502,2021-06-30,885,Value,6900000,-11500000,10350000,-1150000
20502,2021-09-30,885,Capital Call,-200000,-11700000,10350000,-1350000
20502,2021-09-30,885,Distribution,414000,-11700000,10764000,-936000
20502,2021-12-31,885,Value,8190000,-11700000,10764000,-936000
20526,2020-03-31,6754,Value,2090580,-9528001,13992180,4464179
20526,2020-05-16,6754,Capital Call,-15932,-9543933,13992180,4448247
20526,2020-05-16,6754,Distribution,225452,-9543933,14217632,4673699
20526,2020-06-30,6754,Value,1922900,-9543933,14217632,4673699
20526,2020-09-30,6754,Value,1962790,-9543933,14217632,4673699
20526,2020-12-31,6754,Value,2062100,-9543933,14217632,4673699
20526,2021-03-31,6754,Value,2009440,-9543933,14217632,4673699
20526,2021-06-30,6754,Value,2073530,-9543933,14217632,4673699
20531,2020-03-31,6123,Value,0,-9723261,10952708,1229447
20531,2020-06-30,6123,Value,0,-9723261,10952708,1229447
20531,2020-09-30,6123,Value,0,-9723261,10952708,1229447
20531,2020-12-31,6123,Value,0,-9723261,10952708,1229447
20531,2021-03-31,6123,Value,0,-9723261,10952708,1229447
20531,2021-06-30,6123,Value,0,-9723261,10952708,1229447
20531,2021-09-30,6123,Value,0,-9723261,10952708,1229447
20531,2021-12-31,6123,Value,0,-9723261,10952708,1229447
20597,2020-03-31,785,Value,6374670,-10619526,12312763,1693237
20597,2020-06-30,785,Value,6249690,-10619526,12312763,1693237
20597,2020-08-15,785,Capital Call,-32173,-10651699,12312763,1661064
20597,2020-09-30,785,Value,6821980,-10651699,12312763,1661064
20597,2020-11-15,785,Capital Call,0,-10651699,12312763,1661064
20597,2020-11-15,785,Distribution,2694386,-10651699,15007149,4355450
20597,2020-12-31,785,Value,4637850,-10651699,15007149,4355450
20597,2021-02-14,785,Capital Call,0,-10651699,15007149,4355450
20597,2021-02-14,785,Distribution,0,-10651699,15007149,4355450
20597,2021-03-31,785,Value,4637850,-10651699,15007149,4355450
20597,2021-06-30,785,Value,4882120,-10651699,15007149,4355450
20597,2021-09-30,785,Value,5091860,-10651699,15007149,4355450
20630,2020-02-15,2562,Capital Call,-204,-9000207,7654499,-1345708
20630,2020-02-15,2562,Distribution,1460006,-9000207,9114505,114298
20630,2020-03-31,2562,Value,12774880,-9000207,9114505,114298
20630,2020-06-30,2562,Value,12076470,-9000207,9114505,114298
20630,2020-08-15,2562,Distribution,884720,-9000207,9999225,999018
20630,2020-09-30,2562,Value,11160250,-9000207,9999225,999018
20630,2021-02-14,2562,Capital Call,-796,-9001003,9999225,998222
20630,2021-02-14,2562,Distribution,1324032,-9001003,11323257,2322254
20630,2021-06-30,2562,Value,11152230,-9001003,11323257,2322254
20630,2021-09-30,2562,Distribution,2088232,-9001003,13411489,4410486
20630,2021-12-31,2562,Value,11305250,-9001003,13411489,4410486
20648,2020-01-15,10966,Capital Call,0,-11182177,7376560,-3805617
20648,2020-01-15,10966,Distribution,0,-11182177,7376560,-3805617
20648,2020-02-29,10966,Value,5191820,-11182177,7376560,-3805617
20648,2020-04-15,10966,Capital Call,0,-11182177,7376560,-3805617
20648,2020-04-15,10966,Distribution,47280,-11182177,7423840,-3758337
20648,2020-05-31,10966,Value,3917560,-11182177,7423840,-3758337
20648,2020-07-16,10966,Capital Call,-7018,-11189195,7423840,-3765355
20648,2020-08-31,10966,Value,4193240,-11189195,7423840,-3765355
20648,2020-11-30,10966,Value,3983470,-11189195,7423840,-3765355
20648,2021-01-14,10966,Distribution,195739,-11189195,7619579,-3569616
20648,2021-02-28,10966,Value,3786790,-11189195,7619579,-3569616
20648,2021-05-31,10966,Value,4713260,-11189195,7619579,-3569616
20648,2021-08-31,10966,Value,4436060,-11189195,7619579,-3569616
20648,2021-10-16,10966,Capital Call,-7018,-11196213,7619579,-3576634
20648,2021-10-16,10966,Distribution,215090,-11196213,7834669,-3361544
20648,2021-11-30,10966,Value,5012500,-11196213,7834669,-3361544
20678,2020-03-31,613,Value,8656780,-12142226,11297122,-845104
20678,2020-05-16,613,Capital Call,-46648,-12188874,11297122,-891752
20678,2020-06-30,613,Value,8987300,-12188874,11297122,-891752
20678,2020-08-15,613,Capital Call,-308713,-12497587,11297122,-1200465
20678,2020-08-15,613,Distribution,1898907,-12497587,13196029,698442
20678,2020-09-30,613,Value,8355380,-12497587,13196029,698442
20678,2020-11-15,613,Capital Call,-27828,-12525415,13196029,670614
20678,2020-11-15,613,Distribution,1456253,-12525415,14652282,2126867
20678,2020-12-31,613,Value,8747650,-12525415,14652282,2126867
20678,2021-02-14,613,Capital Call,-997449,-13522864,14652282,1129418
20678,2021-02-14,613,Distribution,481912,-13522864,15134194,1611330
20678,2021-03-31,613,Value,10445590,-13522864,15134194,1611330
20678,2021-05-16,613,Capital Call,-103900,-13626764,15134194,1507430
20678,2021-05-16,613,Distribution,305239,-13626764,15439433,1812669
20678,2021-06-30,613,Value,13603840,-13626764,15439433,1812669
20925,2020-03-31,10775,Value,16944530,-10124185,6246853,-3877332
20925,2020-05-16,10775,Distribution,4508880,-10124185,10755733,631548
20925,2020-06-30,10775,Value,12774500,-10124185,10755733,631548
20925,2020-09-30,10775,Value,12993130,-10124185,10755733,631548
20925,2020-11-15,10775,Capital Call,-280000,-10404185,10755733,351548
20925,2020-12-31,10775,Value,16158430,-10404185,10755733,351548
20925,2021-03-31,10775,Value,15059510,-10404185,10755733,351548
20925,2021-05-16,10775,Capital Call,-180000,-10584185,10755733,171548
20925,2021-06-30,10775,Value,15312870,-10584185,10755733,171548
20928,2020-03-31,211,Value,2160130,-10094925,8117423,-1977502
20928,2020-05-16,211,Distribution,488558,-10094925,8605981,-1488944
20928,2020-06-30,211,Value,1798930,-10094925,8605981,-1488944
20928,2020-09-30,211,Value,1707340,-10094925,8605981,-1488944
20928,2020-12-31,211,Value,1799550,-10094925,8605981,-1488944
20928,2021-02-14,211,Distribution,446866,-10094925,9052847,-1042078
20928,2021-03-31,211,Value,1256110,-10094925,9052847,-1042078
20928,2021-06-30,211,Value,1256540,-10094925,9052847,-1042078
20937,2020-03-31,181,Capital Call,-1952000,-7338000,684022,-6653978
20937,2020-03-31,181,Distribution,3978543,-7338000,4662565,-2675435
20937,2020-06-30,181,Value,5926160,-7338000,4662565,-2675435
20937,2020-09-30,181,Capital Call,-751000,-8089000,4662565,-3426435
20937,2020-09-30,181,Distribution,-66,-8089000,4662499,-3426501
20937,2020-12-31,181,Value,7978180,-8089000,4662499,-3426501
20937,2021-04-01,181,Capital Call,-791000,-8880000,4662499,-4217501
20937,2021-04-01,181,Distribution,4437724,-8880000,9100223,220223
20937,2021-06-30,181,Value,7697180,-8880000,9100223,220223
21014,2020-02-15,18,Capital Call,0,-9490451,12747572,3257121
21014,2020-02-15,18,Distribution,-466,-9490451,12747106,3256655
21014,2020-03-31,18,Value,5093990,-9490451,12747106,3256655
21014,2020-05-16,18,Capital Call,-120006,-9610457,12747106,3136649
21014,2020-05-16,18,Distribution,465756,-9610457,13212862,3602405
21014,2020-06-30,18,Value,5525110,-9610457,13212862,3602405
21014,2020-08-15,18,Distribution,275090,-9610457,13487952,3877495
21014,2020-09-30,18,Value,6013680,-9610457,13487952,3877495
21014,2020-12-31,18,Value,7458550,-9610457,13487952,3877495
21014,2021-02-14,18,Distribution,113830,-9610457,13601782,3991325
21014,2021-03-31,18,Value,7559120,-9610457,13601782,3991325
21014,2021-05-16,18,Capital Call,456,-9610001,13601782,3991781
21014,2021-05-16,18,Distribution,770994,-9610001,14372776,4762775
21014,2021-06-30,18,Value,6974540,-9610001,14372776,4762775
21014,2021-09-30,18,Value,7468760,-9610001,14372776,4762775
21015,2020-02-15,18,Capital Call,-292,-8755065,7904267,-850798
21015,2020-02-15,18,Distribution,263,-8755065,7904530,-850535
21015,2020-03-31,18,Value,6016970,-8755065,7904530,-850535
21015,2020-05-16,18,Distribution,835481,-8755065,8740011,-15054
21015,2020-06-30,18,Value,5990090,-8755065,8740011,-15054
21015,2020-09-30,18,Value,6612820,-8755065,8740011,-15054
21015,2020-11-15,18,Capital Call,-250002,-9005067,8740011,-265056
21015,2020-11-15,18,Distribution,523151,-9005067,9263162,258095
21015,2020-12-31,18,Value,7246250,-9005067,9263162,258095
21015,2021-02-14,18,Distribution,403425,-9005067,9666587,661520
21015,2021-03-31,18,Value,7510310,-9005067,9666587,661520
21015,2021-05-16,18,Capital Call,66,-9005001,9666587,661586
21015,2021-05-16,18,Distribution,502255,-9005001,10168842,1163841
21015,2021-06-30,18,Value,7792910,-9005001,10168842,1163841
21015,2021-08-15,18,Distribution,387806,-9005001,10556648,1551647
21015,2021-09-30,18,Value,7512760,-9005001,10556648,1551647
21020,2020-02-15,496,Distribution,8321333,-10000000,25961770,15961770
21020,2020-03-31,496,Value,7621040,-10000000,25961770,15961770
21020,2020-06-30,496,Value,7895630,-10000000,25961770,15961770
21020,2020-09-30,496,Value,12280000,-10000000,25961770,15961770
21020,2020-12-31,496,Value,14159800,-10000000,25961770,15961770
21020,2021-03-31,496,Value,14686290,-10000000,25961770,15961770
21020,2021-06-30,496,Value,16862120,-10000000,25961770,15961770
21054,2020-02-15,1886,Distribution,600000,-8650000,6990000,-1660000
21054,2020-03-31,1886,Value,12986610,-8650000,6990000,-1660000
21054,2020-05-16,1886,Distribution,750020,-8650000,7740020,-909980
21054,2020-06-30,1886,Value,14705000,-8650000,7740020,-909980
21054,2020-08-15,1886,Capital Call,4806,-8645194,7740020,-905174
21054,2020-08-15,1886,Distribution,-4320,-8645194,7735700,-909494
21054,2020-09-30,1886,Value,17070790,-8645194,7735700,-909494
21054,2020-11-15,1886,Capital Call,82194,-8563000,7735700,-827300
21054,2020-11-15,1886,Distribution,1213491,-8563000,8949191,386191
21054,2020-12-31,1886,Value,19660640,-8563000,8949191,386191
21054,2021-02-14,1886,Distribution,544607,-8563000,9493798,930798
21054,2021-03-31,1886,Value,24681130,-8563000,9493798,930798
21054,2021-06-30,1886,Value,28441140,-8563000,9493798,930798
21054,2021-08-15,1886,Capital Call,-87000,-8650000,9493798,843798
21054,2021-08-15,1886,Distribution,4371287,-8650000,13865085,5215085
21054,2021-09-30,1886,Value,27840020,-8650000,13865085,5215085
21133,2020-02-15,86,Capital Call,-200293,-12865007,17759687,4894680
21133,2020-03-31,86,Value,2914410,-12865007,17759687,4894680
21133,2020-06-30,86,Value,3046870,-12865007,17759687,4894680
21133,2020-09-30,86,Value,3354750,-12865007,17759687,4894680
21133,2020-11-15,86,Distribution,507763,-12865007,18267450,5402443
21133,2020-12-31,86,Value,3319110,-12865007,18267450,5402443
21133,2021-02-14,86,Distribution,580732,-12865007,18848182,5983175
21133,2021-03-31,86,Value,2690590,-12865007,18848182,5983175
21133,2021-06-30,86,Value,2714400,-12865007,18848182,5983175
21217,2020-02-15,1812,Distribution,-104000,-10400000,9464002,-935998
21217,2020-03-31,1812,Value,5096000,-10400000,9464002,-935998
21217,2020-05-16,1812,Capital Call,-400000,-10800000,9464002,-1335998
21217,2020-05-16,1812,Distribution,256000,-10800000,9720002,-1079998
21217,2020-06-30,1812,Value,7344000,-10800000,9720002,-1079998
21217,2020-08-15,1812,Capital Call,100000,-10700000,9720002,-979998
21217,2020-08-15,1812,Distribution,1408000,-10700000,11128002,428002
21217,2020-09-30,1812,Value,6420000,-10700000,11128002,428002
21217,2020-11-15,1812,Distribution,-107000,-10700000,11021002,321002
21217,2020-12-31,1812,Value,6420000,-10700000,11021002,321002
21217,2021-02-14,1812,Distribution,1819000,-10700000,12840002,2140002
21217,2021-03-31,1812,Value,6848000,-10700000,12840002,2140002
21217,2021-05-16,1812,Capital Call,-100000,-10800000,12840002,2040002
21217,2021-05-16,1812,Distribution,2928000,-10800000,15768002,4968002
21217,2021-06-30,1812,Value,4644000,-10800000,15768002,4968002
21217,2021-08-15,1812,Distribution,1188000,-10800000,16956002,6156002
21217,2021-09-30,1812,Value,3024000,-10800000,16956002,6156002
21217,2021-12-31,1812,Value,3456000,-10800000,16956002,6156002
21241,2020-02-15,2317,Capital Call,-52896,-11338265,13573152,2234887
21241,2020-02-15,2317,Distribution,4443,-11338265,13577595,2239330
21241,2020-03-31,2317,Value,5932370,-11338265,13577595,2239330
21241,2020-05-16,2317,Capital Call,-138616,-11476881,13577595,2100714
21241,2020-05-16,2317,Distribution,1077506,-11476881,14655101,3178220
21241,2020-06-30,2317,Value,4435550,-11476881,14655101,3178220
21241,2020-08-15,2317,Capital Call,-329254,-11806135,14655101,2848966
21241,2020-08-15,2317,Distribution,109716,-11806135,14764817,2958682
21241,2020-09-30,2317,Value,5212190,-11806135,14764817,2958682
21241,2020-11-15,2317,Distribution,111856,-11806135,14876673,3070538
21241,2020-12-31,2317,Value,5558090,-11806135,14876673,3070538
21241,2021-02-14,2317,Capital Call,-2351,-11808486,14876673,3068187
21241,2021-02-14,2317,Distribution,2669462,-11808486,17546135,5737649
21241,2021-03-31,2317,Value,3590610,-11808486,17546135,5737649
21286,2020-03-31,1480,Value,7117700,-10900000,25386100,14486100
21286,2020-06-30,1480,Value,9526600,-10900000,25386100,14486100
21286,2020-09-30,1480,Distribution,1395200,-10900000,26781300,15881300
21286,2020-12-31,1480,Value,10224200,-10900000,26781300,15881300
21286,2021-02-14,1480,Capital Call,-700000,-11600000,26781300,15181300
21286,2021-02-14,1480,Distribution,-136100,-11600000,26645200,15045200
21286,2021-03-31,1480,Value,12864400,-11600000,26645200,15045200
21286,2021-07-01,1480,Distribution,4068120,-11600000,30713320,19113320
21286,2021-09-30,1480,Value,9189520,-11600000,30713320,19113320
21286,2021-12-31,1480,Value,15715680,-11600000,30713320,19113320
21341,2020-02-15,103,Capital Call,-253544,-10468244,9928423,-539821
21341,2020-02-15,103,Distribution,26402,-10468244,9954825,-513419
21341,2020-03-31,103,Value,6287870,-10468244,9954825,-513419
21341,2020-05-16,103,Capital Call,-219294,-10687538,9954825,-732713
21341,2020-05-16,103,Distribution,29916,-10687538,9984741,-702797
21341,2020-06-30,103,Value,6477250,-10687538,9984741,-702797
21342,2020-01-20,515145,Distribution,165807,-5729553,3626027,-2103526
21342,2020-02-27,515145,Distribution,73692,-5729553,3699719,-2029834
21342,2020-03-31,515145,Capital Call,-3970450,-9700003,3699719,-6000284
21342,2020-03-31,515145,Distribution,2563573,-9700003,6263292,-3436711
21342,2020-03-31,515145,Value,4413790,-9700003,6263292,-3436711
21342,2020-05-16,515145,Capital Call,2000,-9698003,6263292,-3434711
21342,2020-05-16,515145,Distribution,-1291,-9698003,6262001,-3436002
21342,2020-06-30,515145,Value,8056120,-9698003,6262001,-3436002
21342,2020-08-15,515145,Distribution,249239,-9698003,6511240,-3186763
21342,2020-09-30,515145,Value,8337370,-9698003,6511240,-3186763
21342,2020-11-15,515145,Distribution,63037,-9698003,6574277,-3123726
21342,2020-12-31,515145,Value,9149090,-9698003,6574277,-3123726
21342,2021-04-01,515145,Capital Call,30000,-9668003,6574277,-3093726
21342,2021-04-01,515145,Distribution,726033,-9668003,7300310,-2367693
21342,2021-06-30,515145,Value,9081150,-9668003,7300310,-2367693
21342,2021-08-15,515145,Capital Call,-30000,-9698003,7300310,-2397693
21342,2021-08-15,515145,Distribution,552164,-9698003,7852474,-1845529
21342,2021-09-30,515145,Value,9206310,-9698003,7852474,-1845529
21352,2020-02-15,8072,Distribution,0,-10000000,13674666,3674666
21352,2020-03-31,8072,Value,20422150,-10000000,13674666,3674666
21352,2020-06-30,8072,Value,21191310,-10000000,13674666,3674666
21352,2020-09-30,8072,Value,22179830,-10000000,13674666,3674666
21352,2020-11-15,8072,Distribution,0,-10000000,13674666,3674666
21352,2020-12-31,8072,Value,18715230,-10000000,13674666,3674666
21363,2020-03-31,8258,Value,4973380,-8974620,5567048,-3407572
21363,2020-06-30,8258,Value,5335750,-8974620,5567048,-3407572
21363,2020-09-30,8258,Value,5376290,-8974620,5567048,-3407572
21363,2020-12-31,8258,Value,5918120,-8974620,5567048,-3407572
21363,2021-03-31,8258,Value,6055060,-8974620,5567048,-3407572
21363,2021-05-16,8258,Capital Call,-1501381,-10476001,5567048,-4908953
21363,2021-05-16,8258,Distribution,1924339,-10476001,7491387,-2984614
21363,2021-06-30,8258,Value,6777970,-10476001,7491387,-2984614
21423,2020-01-15,14497,Capital Call,0,-9775000,5523612,-4251388
21423,2020-01-15,14497,Distribution,258667,-9775000,5782279,-3992721
21423,2020-02-29,14497,Value,10866660,-9775000,5782279,-3992721
21423,2020-04-15,14497,Capital Call,0,-9775000,5782279,-3992721
21423,2020-04-15,14497,Distribution,0,-9775000,5782279,-3992721
21423,2020-05-31,14497,Value,10674980,-9775000,5782279,-3992721
21423,2020-07-16,14497,Distribution,43111,-9775000,5825390,-3949610
21423,2020-08-31,14497,Value,10602420,-9775000,5825390,-3949610
21423,2020-11-30,14497,Value,13628460,-9775000,5825390,-3949610
21423,2021-01-14,14497,Distribution,668222,-9775000,6493612,-3281388
21423,2021-02-28,14497,Value,13165820,-9775000,6493612,-3281388
21423,2021-05-31,14497,Value,13169600,-9775000,6493612,-3281388
21423,2021-07-16,14497,Distribution,855270,-9775000,7348882,-2426118
21423,2021-08-31,14497,Value,14572210,-9775000,7348882,-2426118
21423,2021-10-16,14497,Capital Call,0,-9775000,7348882,-2426118
21423,2021-10-16,14497,Distribution,0,-9775000,7348882,-2426118
21423,2021-11-30,14497,Value,22146390,-9775000,7348882,-2426118
21430,2020-03-31,37237,Value,10625210,-9080385,1509227,-7571158
21430,2020-06-30,37237,Value,10625210,-9080385,1509227,-7571158
21430,2020-09-30,37237,Value,9967940,-9080385,1509227,-7571158
21430,2020-12-31,37237,Value,9967940,-9080385,1509227,-7571158
21430,2021-03-31,37237,Value,11479250,-9080385,1509227,-7571158
21430,2021-05-16,37237,Capital Call,-183855,-9264240,1509227,-7755013
21430,2021-05-16,37237,Distribution,525824,-9264240,2035051,-7229189
21430,2021-06-30,37237,Value,11598040,-9264240,2035051,-7229189
21440,2020-02-15,617,Distribution,849143,-9483999,19759714,10275715
21440,2020-03-31,617,Value,2399710,-9483999,19759714,10275715
21440,2020-06-30,617,Value,2519420,-9483999,19759714,10275715
21440,2020-08-15,617,Distribution,27714,-9483999,19787428,10303429
21440,2020-09-30,617,Value,2848280,-9483999,19787428,10303429
21440,2020-11-15,617,Distribution,1232000,-9483999,21019428,11535429
21440,2020-12-31,617,Value,2602570,-9483999,21019428,11535429
21440,2021-03-31,617,Value,3004000,-9483999,21019428,11535429
21440,2021-06-30,617,Value,3695420,-9483999,21019428,11535429
21449,2020-02-15,202,Capital Call,-2475,-10230881,27924582,17693701
21449,2020-02-15,202,Distribution,4424130,-10230881,32348712,22117831
21449,2020-03-31,202,Value,7802320,-10230881,32348712,22117831
21449,2020-05-16,202,Distribution,6160276,-10230881,38508988,28278107
21449,2020-06-30,202,Value,3919120,-10230881,38508988,28278107
21449,2020-08-15,202,Capital Call,-9900,-10240781,38508988,28268207
21449,2020-08-15,202,Distribution,23547,-10240781,38532535,28291754
21449,2020-09-30,202,Value,3926950,-10240781,38532535,28291754
21449,2020-12-31,202,Value,4930460,-10240781,38532535,28291754
21449,2021-02-14,202,Capital Call,-2475,-10243256,38532535,28289279
21449,2021-02-14,202,Distribution,936472,-10243256,39469007,29225751
21449,2021-03-31,202,Value,4912580,-10243256,39469007,29225751
21613,2020-02-15,588,Capital Call,-50000,-9964370,8618743,-1345627
21613,2020-02-15,588,Distribution,189227,-9964370,8807970,-1156400
21613,2020-03-31,588,Value,5062770,-9964370,8807970,-1156400
21613,2020-05-16,588,Capital Call,-100000,-10064370,8807970,-1256400
21613,2020-06-30,588,Value,5309670,-10064370,8807970,-1256400
21613,2020-08-15,588,Distribution,614739,-10064370,9422709,-641661
21613,2020-09-30,588,Value,4963290,-10064370,9422709,-641661
21613,2020-11-15,588,Capital Call,-50000,-10114370,9422709,-691661
21613,2020-11-15,588,Distribution,430640,-10114370,9853349,-261021
21613,2020-12-31,588,Value,5152400,-10114370,9853349,-261021
21613,2021-02-14,588,Capital Call,-50000,-10164370,9853349,-311021
21613,2021-02-14,588,Distribution,448556,-10164370,10301905,137535
21613,2021-03-31,588,Value,5021220,-10164370,10301905,137535
21630,2020-02-15,910,Capital Call,-188316,-10969729,6726877,-4242852
21630,2020-02-15,910,Distribution,458230,-10969729,7185107,-3784622
21630,2020-03-31,910,Value,7823850,-10969729,7185107,-3784622
21630,2020-05-16,910,Capital Call,-262977,-11232706,7185107,-4047599
21630,2020-05-16,910,Distribution,27712,-11232706,7212819,-4019887
21630,2020-06-30,910,Value,8692560,-11232706,7212819,-4019887
21630,2020-08-15,910,Capital Call,-37393,-11270099,7212819,-4057280
21630,2020-08-15,910,Distribution,327968,-11270099,7540787,-3729312
21630,2020-09-30,910,Value,9379340,-11270099,7540787,-3729312
21630,2020-11-15,910,Capital Call,-77382,-11347481,7540787,-3806694
21630,2020-11-15,910,Distribution,774308,-11347481,8315095,-3032386
21630,2020-12-31,910,Value,9946900,-11347481,8315095,-3032386
21630,2021-02-14,910,Capital Call,-45062,-11392543,8315095,-3077448
21630,2021-02-14,910,Distribution,714534,-11392543,9029629,-2362914
21630,2021-03-31,910,Value,10189050,-11392543,9029629,-2362914
21672,2020-01-15,15424,Capital Call,0,-8124090,19318660,11194570
21672,2020-01-15,15424,Distribution,990199,-8124090,20308859,12184769
21672,2020-02-29,15424,Value,8566220,-8124090,20308859,12184769
21672,2020-04-15,15424,Capital Call,-287764,-8411854,20308859,11897005
21672,2020-04-15,15424,Distribution,0,-8411854,20308859,11897005
21672,2020-05-31,15424,Value,9231820,-8411854,20308859,11897005
21672,2020-08-31,15424,Value,9520290,-8411854,20308859,11897005
21672,2020-11-30,15424,Value,10127420,-8411854,20308859,11897005
21672,2021-01-14,15424,Capital Call,-503588,-8915442,20308859,11393417
21672,2021-02-28,15424,Value,10631010,-8915442,20308859,11393417
21672,2021-05-31,15424,Value,11434370,-8915442,20308859,11393417
21672,2021-07-16,15424,Distribution,3300407,-8915442,23609266,14693824
21672,2021-08-31,15424,Value,8337330,-8915442,23609266,14693824
21672,2021-10-16,15424,Capital Call,0,-8915442,23609266,14693824
21672,2021-10-16,15424,Distribution,0,-8915442,23609266,14693824
21672,2021-11-30,15424,Value,8334430,-8915442,23609266,14693824
21812,2020-03-31,462,Capital Call,-457999,-9491353,21941973,12450620
21812,2020-03-31,462,Distribution,141090,-9491353,22083063,12591710
21812,2020-06-30,462,Value,785030,-9491353,22083063,12591710
21812,2020-08-15,462,Capital Call,44859,-9446494,22083063,12636569
21812,2020-08-15,462,Distribution,4341,-9446494,22087404,12640910
21812,2020-09-30,462,Value,779970,-9446494,22087404,12640910
21812,2020-11-15,462,Capital Call,101295,-9345199,22087404,12742205
21812,2020-12-31,462,Value,704000,-9345199,22087404,12742205
21813,2020-02-15,1759,Distribution,31080,-8179000,22686910,14507910
21813,2020-03-31,1759,Value,1472220,-8179000,22686910,14507910
21813,2020-05-16,1759,Capital Call,46000,-8133000,22686910,14553910
21813,2020-05-16,1759,Distribution,-720,-8133000,22686190,14553190
21813,2020-06-30,1759,Value,1463940,-8133000,22686190,14553190
21813,2020-08-15,1759,Capital Call,-49000,-8182000,22686190,14504190
21813,2020-08-15,1759,Distribution,110498,-8182000,22796688,14614688
21813,2020-09-30,1759,Value,1554580,-8182000,22796688,14614688
21813,2020-12-31,1759,Value,1718220,-8182000,22796688,14614688
21813,2021-02-14,1759,Capital Call,-18000,-8200000,22796688,14596688
21813,2021-02-14,1759,Distribution,89512,-8200000,22886200,14686200
21813,2021-03-31,1759,Value,1722000,-8200000,22886200,14686200
21813,2021-05-16,1759,Capital Call,5000,-8195000,22886200,14691200
21813,2021-05-16,1759,Distribution,-13955,-8195000,22872245,14677245
21813,2021-06-30,1759,Value,1966800,-8195000,22872245,14677245
21813,2021-08-15,1759,Capital Call,-5000,-8200000,22872245,14672245
21813,2021-08-15,1759,Distribution,661755,-8200000,23534000,15334000
21813,2021-09-30,1759,Value,1394000,-8200000,23534000,15334000
21824,2020-02-15,4963,Distribution,305970,-9870000,14459550,4589550
21824,2020-03-31,4963,Value,6109530,-9870000,14459550,4589550
21824,2020-05-16,4963,Distribution,671160,-9870000,15130710,5260710
21824,2020-06-30,4963,Value,5616030,-9870000,15130710,5260710
21824,2020-08-15,4963,Distribution,375060,-9870000,15505770,5635770
21824,2020-09-30,4963,Value,6158880,-9870000,15505770,5635770
21824,2020-12-30,4963,Distribution,2250360,-9870000,17756130,7886130
21824,2021-03-31,4963,Value,4777080,-9870000,17756130,7886130
21844,2021-12-31,2288,Value,0,-9977000,7874846,-2102154
21852,2020-02-15,18,Capital Call,0,-8980000,2975971,-6004029
21852,2020-02-15,18,Distribution,260505,-8980000,3236476,-5743524
21852,2020-03-31,18,Value,11511600,-8980000,3236476,-5743524
21852,2020-05-16,18,Distribution,521052,-8980000,3757528,-5222472
21852,2020-06-30,18,Value,11801820,-8980000,3757528,-5222472
21852,2020-08-15,18,Distribution,461503,-8980000,4219031,-4760969
21852,2020-09-30,18,Value,12296640,-8980000,4219031,-4760969
21852,2020-11-15,18,Distribution,669924,-8980000,4888955,-4091045
21852,2020-12-31,18,Value,13804400,-8980000,4888955,-4091045
21852,2021-02-14,18,Distribution,550826,-8980000,5439781,-3540219
21852,2021-03-31,18,Value,14465940,-8980000,5439781,-3540219
21852,2021-05-16,18,Capital Call,241,-8979759,5439781,-3539978
21852,2021-05-16,18,Distribution,513449,-8979759,5953230,-3026529
21852,2021-06-30,18,Value,15255210,-8979759,5953230,-3026529
21852,2021-08-15,18,Capital Call,-10240,-8989999,5953230,-3036769
21852,2021-08-15,18,Distribution,394607,-8989999,6347837,-2642162
21852,2021-09-30,18,Value,14636610,-8989999,6347837,-2642162
21871,2020-03-31,18601,Value,8315430,-9031335,1922991,-7108344
21947,2020-03-31,5752,Value,9843650,-9700000,3428388,-6271612
21947,2020-06-30,5752,Value,10968280,-9700000,3428388,-6271612
21947,2020-09-30,5752,Value,11230500,-9700000,3428388,-6271612
21947,2020-12-31,5752,Value,11801360,-9700000,3428388,-6271612
21947,2021-03-31,5752,Value,13167450,-9700000,3428388,-6271612
21972,2020-03-31,8927,Value,2018510,-10294374,6096884,-4197490
21972,2020-06-30,8927,Value,1829420,-10294374,6096884,-4197490
21972,2020-09-30,8927,Distribution,106367,-10294374,6203251,-4091123
21972,2020-12-31,8927,Value,1763400,-10294374,6203251,-4091123
21972,2021-03-31,8927,Value,1707950,-10294374,6203251,-4091123
21972,2021-05-16,8927,Distribution,72683,-10294374,6275934,-4018440
21972,2021-06-30,8927,Value,1707950,-10294374,6275934,-4018440
21987,2020-03-31,5571,Value,7949460,-7300000,5648503,-1651497
21987,2020-06-30,5571,Value,8260300,-7300000,5648503,-1651497
21987,2020-08-15,5571,Distribution,1166539,-7300000,6815042,-484958
21987,2020-09-30,5571,Value,7479120,-7300000,6815042,-484958
21987,2020-11-15,5571,Distribution,742648,-7300000,7557690,257690
21987,2020-12-31,5571,Value,7121880,-7300000,7557690,257690
21987,2021-02-14,5571,Distribution,460729,-7300000,8018419,718419
21987,2021-03-31,5571,Value,7349960,-7300000,8018419,718419
21987,2021-05-16,5571,Distribution,736761,-7300000,8755180,1455180
21987,2021-06-30,5571,Value,7037070,-7300000,8755180,1455180
21987,2021-08-15,5571,Distribution,1104930,-7300000,9860110,2560110
21987,2021-09-30,5571,Value,6040020,-7300000,9860110,2560110
21990,2020-03-31,1480,Value,6965700,-10700000,22074100,11374100
21990,2020-06-30,1480,Value,9918900,-10700000,22074100,11374100
21990,2020-09-30,1480,Distribution,1005800,-10700000,23079900,12379900
21990,2020-12-31,1480,Value,11277800,-10700000,23079900,12379900
21990,2021-02-14,1480,Capital Call,-400000,-11100000,23079900,11979900
21990,2021-02-14,1480,Distribution,-25200,-11100000,23054700,11954700
21990,2021-03-31,1480,Value,16372500,-11100000,23054700,11954700
21990,2021-07-01,1480,Distribution,3947160,-11100000,27001860,15901860
21990,2021-09-30,1480,Value,13325550,-11100000,27001860,15901860
21990,2021-12-31,1480,Value,10165380,-11100000,27001860,15901860
21992,2020-02-15,6715,Distribution,1160000,-7320000,20840000,13520000
21992,2020-03-31,6715,Value,5680000,-7320000,20840000,13520000
21992,2020-05-16,6715,Distribution,4440000,-7320000,25280000,17960000
21992,2020-06-30,6715,Value,2880000,-7320000,25280000,17960000
21992,2020-09-30,6715,Value,2840000,-7320000,25280000,17960000
21992,2020-12-31,6715,Value,3400000,-7320000,25280000,17960000
21992,2021-03-31,6715,Value,3480000,-7320000,25280000,17960000
21992,2021-06-30,6715,Value,3040000,-7320000,25280000,17960000
21992,2021-08-15,6715,Capital Call,-149000,-7469000,25280000,17811000
21992,2021-08-15,6715,Distribution,514938,-7469000,25794938,18325938
21992,2021-09-30,6715,Value,3060790,-7469000,25794938,18325938
22141,2020-01-15,681,Distribution,1154008,-10000000,12712576,2712576
22141,2020-02-29,681,Value,3250260,-10000000,12712576,2712576
22141,2020-04-15,681,Distribution,0,-10000000,12712576,2712576
22141,2020-05-31,681,Value,3046560,-10000000,12712576,2712576
22141,2020-08-31,681,Value,3873050,-10000000,12712576,2712576
22141,2020-10-16,681,Distribution,2554593,-10000000,15267169,5267169
22141,2020-11-30,681,Value,2607430,-10000000,15267169,5267169
22141,2021-02-28,681,Value,2607430,-10000000,15267169,5267169
22141,2021-04-15,681,Distribution,738546,-10000000,16005715,6005715
22141,2021-05-31,681,Value,3407540,-10000000,16005715,6005715
22141,2021-08-31,681,Distribution,0,-10000000,16005715,6005715
22141,2021-11-30,681,Value,3374900,-10000000,16005715,6005715
22173,2020-03-31,2059,Value,10877850,-9999996,9034034,-965962
22173,2020-06-30,2059,Value,10393860,-9999996,9034034,-965962
22173,2020-09-30,2059,Distribution,1407276,-9999996,10441310,441314
22173,2020-12-31,2059,Value,9083340,-9999996,10441310,441314
22173,2021-02-14,2059,Distribution,644902,-9999996,11086212,1086216
22173,2021-03-31,2059,Value,8570410,-9999996,11086212,1086216
22173,2021-05-16,2059,Distribution,1054804,-9999996,12141016,2141020
22173,2021-06-30,2059,Value,8336280,-9999996,12141016,2141020
22230,2020-02-15,502,Distribution,213292,-9700000,14692539,4992539
22230,2020-03-31,502,Value,5736530,-9700000,14692539,4992539
22230,2020-05-16,502,Distribution,1144838,-9700000,15837377,6137377
22230,2020-06-30,502,Value,5963220,-9700000,15837377,6137377
22230,2020-08-15,502,Capital Call,-149998,-9849998,15837377,5987379
22230,2020-08-15,502,Distribution,1333578,-9849998,17170955,7320957
22230,2020-09-30,502,Value,6352520,-9849998,17170955,7320957
22230,2020-11-15,502,Distribution,2370997,-9849998,19541952,9691954
22230,2020-12-31,502,Value,3550430,-9849998,19541952,9691954
22230,2021-02-14,502,Distribution,1158986,-9849998,20700938,10850940
22230,2021-03-31,502,Value,2478880,-9849998,20700938,10850940
22230,2021-06-30,502,Value,2903810,-9849998,20700938,10850940
22289,2020-03-31,6387,Value,3718800,-10330000,14875200,4545200
22289,2020-06-30,6387,Value,3718800,-10330000,14875200,4545200
22289,2020-09-30,6387,Value,3512200,-10330000,14875200,4545200
22289,2020-12-31,6387,Value,3202300,-10330000,14875200,4545200
22289,2021-02-14,6387,Capital Call,2000,-10328000,14875200,4547200
22289,2021-02-14,6387,Distribution,-2880,-10328000,14872320,4544320
22289,2021-03-31,6387,Value,3201680,-10328000,14872320,4544320
22289,2021-06-30,6387,Value,3201680,-10328000,14872320,4544320
22289,2021-09-30,6387,Value,2685280,-10328000,14872320,4544320
22289,2021-12-31,6387,Value,2995120,-10328000,14872320,4544320
22318,2020-01-15,10966,Capital Call,-47131,-10252033,2551194,-7700839
22318,2020-01-15,10966,Distribution,0,-10252033,2551194,-7700839
22318,2020-02-29,10966,Value,7760500,-10252033,2551194,-7700839
22318,2020-04-15,10966,Capital Call,0,-10252033,2551194,-7700839
22318,2020-04-15,10966,Distribution,32923,-10252033,2584117,-7667916
22318,2020-05-31,10966,Value,5987500,-10252033,2584117,-7667916
22318,2020-07-16,10966,Capital Call,-15260,-10267293,2584117,-7683176
22318,2020-07-16,10966,Distribution,22670,-10267293,2606787,-7660506
22318,2020-08-31,10966,Value,6237360,-10267293,2606787,-7660506
22318,2020-10-16,10966,Distribution,13741,-10267293,2620528,-7646765
22318,2020-11-30,10966,Value,6063100,-10267293,2620528,-7646765
22318,2021-01-14,10966,Capital Call,-5509,-10272802,2620528,-7652274
22318,2021-01-14,10966,Distribution,552973,-10272802,3173501,-7099301
22318,2021-02-28,10966,Value,5508480,-10272802,3173501,-7099301
22318,2021-04-15,10966,Distribution,454568,-10272802,3628069,-6644733
22318,2021-05-31,10966,Value,5891060,-10272802,3628069,-6644733
22318,2021-07-16,10966,Distribution,757041,-10272802,4385110,-5887692
22318,2021-08-31,10966,Value,6171350,-10272802,4385110,-5887692
22318,2021-10-16,10966,Capital Call,0,-10272802,4385110,-5887692
22318,2021-10-16,10966,Distribution,176691,-10272802,4561801,-5711001
22318,2021-11-30,10966,Value,6428780,-10272802,4561801,-5711001
22356,2020-03-31,20382,Value,0,-7140050,5430623,-1709427
22356,2020-06-30,20382,Value,0,-7140050,5430623,-1709427
22356,2020-09-30,20382,Value,0,-7140050,5430623,-1709427
22356,2020-12-31,20382,Value,0,-7140050,5430623,-1709427
22356,2021-03-31,20382,Value,0,-7140050,5430623,-1709427
22356,2021-06-30,20382,Value,0,-7140050,5430623,-1709427
22356,2021-09-30,20382,Value,0,-7140050,5430623,-1709427
22356,2021-12-31,20382,Value,0,-7140050,5430623,-1709427
22378,2020-02-15,18,Capital Call,-490,-8715000,3388319,-5326681
22378,2020-02-15,18,Distribution,238434,-8715000,3626753,-5088247
22378,2020-03-31,18,Value,11868220,-8715000,3626753,-5088247
22378,2020-05-16,18,Distribution,381190,-8715000,4007943,-4707057
22378,2020-06-30,18,Value,13404050,-8715000,4007943,-4707057
22378,2020-08-15,18,Distribution,510523,-8715000,4518466,-4196534
22378,2020-09-30,18,Value,13728310,-8715000,4518466,-4196534
22378,2020-11-15,18,Distribution,1021045,-8715000,5539511,-3175489
22378,2020-12-31,18,Value,16867750,-8715000,5539511,-3175489
22378,2021-02-14,18,Distribution,762381,-8715000,6301892,-2413108
22378,2021-03-31,18,Value,16658600,-8715000,6301892,-2413108
22378,2021-05-16,18,Capital Call,490,-8714510,6301892,-2412618
22378,2021-05-16,18,Distribution,578206,-8714510,6880098,-1834412
22378,2021-06-30,18,Value,17324700,-8714510,6880098,-1834412
22378,2021-08-15,18,Distribution,1102667,-8714510,7982765,-731745
22378,2021-09-30,18,Value,15253700,-8714510,7982765,-731745
22379,2020-02-15,18,Capital Call,-107,-7855109,6361378,-1493731
22379,2020-02-15,18,Distribution,86,-7855109,6361464,-1493645
22379,2020-03-31,18,Value,6433680,-7855109,6361464,-1493645
22379,2020-05-16,18,Distribution,787155,-7855109,7148619,-706490
22379,2020-06-30,18,Value,6480860,-7855109,7148619,-706490
22379,2020-09-30,18,Value,7280780,-7855109,7148619,-706490
22379,2020-11-15,18,Capital Call,-550007,-8405116,7148619,-1256497
22379,2020-11-15,18,Distribution,858198,-8405116,8006817,-398299
22379,2020-12-31,18,Value,7936270,-8405116,8006817,-398299
22379,2021-02-14,18,Distribution,468883,-8405116,8475700,70584
22379,2021-03-31,18,Value,8188790,-8405116,8475700,70584
22379,2021-05-16,18,Capital Call,114,-8405002,8475700,70698
22379,2021-05-16,18,Distribution,519912,-8405002,8995612,590610
22379,2021-06-30,18,Value,8918010,-8405002,8995612,590610
22379,2021-08-15,18,Distribution,471719,-8405002,9467331,1062329
22379,2021-09-30,18,Value,9017070,-8405002,9467331,1062329
22380,2020-02-15,18,Capital Call,0,-8695019,6304759,-2390260
22380,2020-02-15,18,Distribution,684380,-8695019,6989139,-1705880
22380,2020-03-31,18,Value,7894320,-8695019,6989139,-1705880
22380,2020-05-16,18,Distribution,686319,-8695019,7675458,-1019561
22380,2020-06-30,18,Value,8095320,-8695019,7675458,-1019561
22380,2020-08-15,18,Distribution,447203,-8695019,8122661,-572358
22380,2020-09-30,18,Value,9318680,-8695019,8122661,-572358
22380,2020-11-15,18,Distribution,478233,-8695019,8600894,-94125
22380,2020-12-31,18,Value,10290700,-8695019,8600894,-94125
22380,2021-02-14,18,Distribution,702747,-8695019,9303641,608622
22380,2021-03-31,18,Value,10863150,-8695019,9303641,608622
22380,2021-05-16,18,Capital Call,21,-8694998,9303641,608643
22380,2021-05-16,18,Distribution,974695,-8694998,10278336,1583338
22380,2021-06-30,18,Value,11155350,-8694998,10278336,1583338
22380,2021-08-15,18,Distribution,1797933,-8694998,12076269,3381271
22380,2021-09-30,18,Value,10789370,-8694998,12076269,3381271
22409,2020-02-15,1360,Distribution,172038,-8911994,7073103,-1838891
22409,2020-03-31,1360,Value,6550790,-8911994,7073103,-1838891
22409,2020-06-30,1360,Value,6648240,-8911994,7073103,-1838891
22409,2020-08-15,1360,Distribution,156398,-8911994,7229501,-1682493
22409,2020-09-30,1360,Value,5868800,-8911994,7229501,-1682493
22409,2020-11-15,1360,Distribution,168128,-8911994,7397629,-1514365
22409,2020-12-31,1360,Value,7294280,-8911994,7397629,-1514365
22409,2021-03-31,1360,Value,8397470,-8911994,7397629,-1514365
22409,2021-05-16,1360,Distribution,1200355,-8911994,8597984,-314010
22409,2021-06-30,1360,Value,7884280,-8911994,8597984,-314010
22409,2021-08-15,1360,Distribution,252192,-8911994,8850176,-61818
22409,2021-09-30,1360,Value,7630920,-8911994,8850176,-61818
22409,2021-11-15,1360,Distribution,547393,-8911994,9397569,485575
22409,2021-12-31,1360,Value,6335280,-8911994,9397569,485575
22411,2020-02-15,1360,Distribution,602000,-8393999,2476001,-5917998
22411,2020-03-31,1360,Value,11816000,-8393999,2476001,-5917998
22411,2020-06-30,1360,Value,10274000,-8393999,2476001,-5917998
22411,2020-08-15,1360,Distribution,154000,-8393999,2630001,-5763998
22411,2020-09-30,1360,Value,10570000,-8393999,2630001,-5763998
22411,2020-11-15,1360,Distribution,250000,-8393999,2880001,-5513998
22411,2020-12-31,1360,Value,10176000,-8393999,2880001,-5513998
22411,2021-02-14,1360,Distribution,1144000,-8393999,4024001,-4369998
22411,2021-03-31,1360,Value,10228000,-8393999,4024001,-4369998
22411,2021-05-16,1360,Distribution,218000,-8393999,4242001,-4151998
22411,2021-06-30,1360,Value,10834000,-8393999,4242001,-4151998
22411,2021-09-30,1360,Value,11631350,-8393999,4242001,-4151998
22412,2020-03-31,10859,Value,4218760,-9653786,12726283,3072497
22412,2020-06-30,10859,Value,4218760,-9653786,12726283,3072497
22412,2020-09-30,10859,Value,6255870,-9653786,12726283,3072497
22412,2020-11-15,10859,Capital Call,-31780,-9685566,12726283,3040717
22412,2020-11-15,10859,Distribution,1810823,-9685566,14537106,4851540
22412,2020-12-31,10859,Value,5488180,-9685566,14537106,4851540
22412,2021-03-31,10859,Value,5488850,-9685566,14537106,4851540
22414,2020-03-31,11548,Value,11027470,-8714106,280497,-8433609
22414,2020-06-30,11548,Value,10062750,-8714106,280497,-8433609
22414,2020-09-30,11548,Capital Call,-730887,-9444993,280497,-9164496
22414,2020-09-30,11548,Distribution,649385,-9444993,929882,-8515111
22414,2020-12-31,11548,Value,10630080,-9444993,929882,-8515111
22414,2021-02-14,11548,Capital Call,-137583,-9582576,929882,-8652694
22414,2021-03-31,11548,Value,10382620,-9582576,929882,-8652694
22414,2021-07-01,11548,Capital Call,-351826,-9934402,929882,-9004520
22414,2021-09-30,11548,Value,11767850,-9934402,929882,-9004520
22419,2021-12-31,3660,Value,0,-10943961,1392826,-9551135
22420,2020-02-15,8117,Distribution,828000,-9200000,4600000,-4600000
22420,2020-03-31,8117,Value,17940000,-9200000,4600000,-4600000
22420,2020-06-30,8117,Value,17940000,-9200000,4600000,-4600000
22420,2020-08-15,8117,Distribution,3956000,-9200000,8556000,-644000
22420,2020-09-30,8117,Value,13800000,-9200000,8556000,-644000
22420,2020-11-15,8117,Distribution,644000,-9200000,9200000,0
22420,2020-12-31,8117,Value,13064000,-9200000,9200000,0
22420,2021-03-31,8117,Value,13064000,-9200000,9200000,0
22420,2021-05-16,8117,Distribution,1656000,-9200000,10856000,1656000
22420,2021-06-30,8117,Value,11960000,-9200000,10856000,1656000
22448,2020-02-15,32423,Distribution,496080,-9360000,9865440,505440
22448,2020-03-31,32423,Value,3600790,-9360000,9865440,505440
22448,2020-05-16,32423,Distribution,50544,-9360000,9915984,555984
22448,2020-06-30,32423,Value,4001400,-9360000,9915984,555984
22448,2020-09-30,32423,Value,4355200,-9360000,9915984,555984
22448,2020-11-15,32423,Distribution,676728,-9360000,10592712,1232712
22448,2020-12-31,32423,Value,3637290,-9360000,10592712,1232712
22448,2021-03-31,32423,Value,3861930,-9360000,10592712,1232712
22448,2021-05-16,32423,Distribution,281736,-9360000,10874448,1514448
22448,2021-06-30,32423,Value,3686900,-9360000,10874448,1514448
22448,2021-09-30,32423,Value,4021050,-9360000,10874448,1514448
22452,2020-02-15,673,Distribution,625000,-8255000,6692090,-1562910
22452,2020-03-31,673,Value,14303640,-8255000,6692090,-1562910
22452,2020-05-16,673,Distribution,475000,-8255000,7167090,-1087910
22452,2020-06-30,673,Value,15977530,-8255000,7167090,-1087910
22452,2020-08-15,673,Distribution,1336298,-8255000,8503388,248388
22452,2020-09-30,673,Value,19872280,-8255000,8503388,248388
22452,2020-11-15,673,Distribution,2312763,-8255000,10816151,2561151
22452,2020-12-31,673,Value,23781020,-8255000,10816151,2561151
22452,2021-02-14,673,Distribution,2664000,-8255000,13480151,5225151
22452,2021-03-31,673,Value,31613550,-8255000,13480151,5225151
22466,2020-02-15,355,Distribution,97453,-9100000,10914070,1814070
22466,2020-03-31,355,Value,3666170,-9100000,10914070,1814070
22466,2020-05-16,355,Distribution,69610,-9100000,10983680,1883680
22466,2020-06-30,355,Value,3191440,-9100000,10983680,1883680
22466,2020-08-15,355,Distribution,178200,-9100000,11161880,2061880
22466,2020-09-30,355,Value,3379920,-9100000,11161880,2061880
22466,2020-11-15,355,Distribution,222750,-9100000,11384630,2284630
22466,2020-12-31,355,Value,3452160,-9100000,11384630,2284630
22466,2021-02-14,355,Capital Call,-100000,-9200000,11384630,2184630
22466,2021-02-14,355,Distribution,509890,-9200000,11894520,2694520
22466,2021-03-31,355,Value,3042270,-9200000,11894520,2694520
22487,2020-02-15,2129,Distribution,-35208,-10000000,5664338,-4335662
22487,2020-03-31,2129,Value,8278610,-10000000,5664338,-4335662
22487,2020-05-16,2129,Distribution,-19039,-10000000,5645299,-4354701
22487,2020-06-30,2129,Value,8449470,-10000000,5645299,-4354701
22487,2020-08-15,2129,Distribution,-22299,-10000000,5623000,-4377000
22487,2020-09-30,2129,Value,8763000,-10000000,5623000,-4377000
22487,2020-11-15,2129,Distribution,2956000,-10000000,8579000,-1421000
22487,2020-12-31,2129,Value,6170000,-10000000,8579000,-1421000
22487,2021-02-14,2129,Distribution,-33000,-10000000,8546000,-1454000
22487,2021-03-31,2129,Value,6228000,-10000000,8546000,-1454000
22487,2021-05-16,2129,Distribution,-23569,-10000000,8522431,-1477569
22487,2021-06-30,2129,Value,6696870,-10000000,8522431,-1477569
22487,2021-08-15,2129,Distribution,143046,-10000000,8665477,-1334523
22487,2021-09-30,2129,Value,7885220,-10000000,8665477,-1334523
22533,2020-03-31,11,Value,3511210,-10978878,14603932,3625054
22533,2020-06-30,11,Value,3730790,-10978878,14603932,3625054
22533,2020-09-30,11,Value,3730790,-10978878,14603932,3625054
22533,2020-11-15,11,Capital Call,-80746,-11059624,14603932,3544308
22533,2020-11-15,11,Distribution,220,-11059624,14604152,3544528
22533,2020-12-31,11,Value,4086610,-11059624,14604152,3544528
22533,2021-02-14,11,Distribution,9765,-11059624,14613917,3554293
22533,2021-03-31,11,Value,4519230,-11059624,14613917,3554293
22533,2021-06-30,11,Value,4961620,-11059624,14613917,3554293
22632,2020-02-15,18619,Capital Call,-77821,-8525064,11876234,3351170
22632,2020-02-15,18619,Distribution,262723,-8525064,12138957,3613893
22632,2020-03-31,18619,Value,1702270,-8525064,12138957,3613893
22632,2020-05-16,18619,Capital Call,-65056,-8590120,12138957,3548837
22632,2020-05-16,18619,Distribution,82542,-8590120,12221499,3631379
22632,2020-06-30,18619,Value,1721590,-8590120,12221499,3631379
22632,2020-08-15,18619,Capital Call,-88526,-8678646,12221499,3542853
22632,2020-08-15,18619,Distribution,200812,-8678646,12422311,3743665
22632,2020-09-30,18619,Value,1435910,-8678646,12422311,3743665
22632,2020-11-15,18619,Capital Call,-4905,-8683551,12422311,3738760
22632,2020-11-15,18619,Distribution,72453,-8683551,12494764,3811213
22632,2020-12-31,18619,Value,1426280,-8683551,12494764,3811213
22632,2021-02-14,18619,Capital Call,-6948,-8690499,12494764,3804265
22632,2021-02-14,18619,Distribution,157162,-8690499,12651926,3961427
22632,2021-03-31,18619,Value,1354410,-8690499,12651926,3961427
22632,2021-05-16,18619,Capital Call,215,-8690284,12651926,3961642
22632,2021-05-16,18619,Distribution,166384,-8690284,12818310,4128026
22632,2021-06-30,18619,Value,1325640,-8690284,12818310,4128026
22632,2021-08-15,18619,Capital Call,-107,-8690391,12818310,4127919
22632,2021-08-15,18619,Distribution,169572,-8690391,12987882,4297491
22632,2021-09-30,18619,Value,1334950,-8690391,12987882,4297491
22636,2020-02-15,4936,Distribution,696110,-9999601,19118996,9119395
22636,2020-03-31,4936,Value,6758450,-9999601,19118996,9119395
22636,2020-05-16,4936,Capital Call,-141758,-10141359,19118996,8977637
22636,2020-06-30,4936,Value,7082290,-10141359,19118996,8977637
22636,2020-09-30,4936,Value,8509740,-10141359,19118996,8977637
22636,2020-11-15,4936,Capital Call,-105607,-10246966,19118996,8872030
22636,2020-12-31,4936,Value,9803820,-10246966,19118996,8872030
22636,2021-03-31,4936,Value,9618700,-10246966,19118996,8872030
22641,2020-02-15,733,Capital Call,-30064,-11132350,17768756,6636406
22641,2020-02-15,733,Distribution,1551808,-11132350,19320564,8188214
22641,2020-03-31,733,Value,719030,-11132350,19320564,8188214
22641,2020-05-16,733,Capital Call,-2083,-11134433,19320564,8186131
22641,2020-05-16,733,Distribution,202068,-11134433,19522632,8388199
22641,2020-06-30,733,Value,667560,-11134433,19522632,8388199
22641,2020-08-15,733,Capital Call,-977,-11135410,19522632,8387222
22641,2020-08-15,733,Distribution,200799,-11135410,19723431,8588021
22641,2020-09-30,733,Value,459040,-11135410,19723431,8588021
22641,2020-11-15,733,Distribution,44732,-11135410,19768163,8632753
22641,2020-12-31,733,Value,445480,-11135410,19768163,8632753
22791,2020-07-01,21315,Capital Call,-272000,-9528000,8729333,-798667
22791,2020-07-01,21315,Distribution,5696058,-9528000,14425391,4897391
22791,2020-12-31,21315,Value,5196570,-9528000,14425391,4897391
22791,2021-04-01,21315,Capital Call,-272000,-9800000,14425391,4625391
22791,2021-04-01,21315,Distribution,764608,-9800000,15189999,5389999
22791,2021-06-30,21315,Value,6762000,-9800000,15189999,5389999
22791,2021-08-15,21315,Distribution,-98000,-9800000,15091999,5291999
22791,2021-09-30,21315,Value,7448000,-9800000,15091999,5291999
22806,2020-03-31,8661,Value,5607220,-9750000,22980750,13230750
22806,2020-05-16,8661,Distribution,98475,-9750000,23079225,13329225
22806,2020-06-30,8661,Value,5439520,-9750000,23079225,13329225
22806,2020-09-30,8661,Value,5536050,-9750000,23079225,13329225
22806,2020-11-15,8661,Distribution,2503800,-9750000,25583025,15833025
22806,2020-12-31,8661,Value,3082950,-9750000,25583025,15833025
22806,2021-04-01,8661,Distribution,3036150,-9750000,28619175,18869175
22806,2021-06-30,8661,Value,1285050,-9750000,28619175,18869175
22806,2021-09-30,8661,Value,1298700,-9750000,28619175,18869175
22806,2021-11-15,8661,Distribution,117975,-9750000,28737150,18987150
22806,2021-12-31,8661,Value,1262620,-9750000,28737150,18987150
22815,2020-03-31,7168,Value,4258610,-9236847,8706160,-530687
22815,2020-05-16,7168,Capital Call,-149846,-9386693,8706160,-680533
22815,2020-06-30,7168,Value,3097560,-9386693,8706160,-680533
22815,2020-09-30,7168,Value,3611920,-9386693,8706160,-680533
22815,2020-11-15,7168,Capital Call,-70922,-9457615,8706160,-751455
22815,2020-12-31,7168,Value,3645070,-9457615,8706160,-751455
22815,2021-02-14,7168,Capital Call,3614,-9454001,8706160,-747841
22815,2021-02-14,7168,Distribution,-3752,-9454001,8702408,-751593
22815,2021-03-31,7168,Value,3611420,-9454001,8702408,-751593
22821,2020-01-15,10131,Capital Call,547378,-9208806,0,-9208806
22821,2020-02-29,10131,Value,9480480,-9208806,0,-9208806
22821,2020-04-15,10131,Capital Call,-172929,-9381735,0,-9381735
22821,2020-05-31,10131,Value,6512960,-9381735,0,-9381735
22821,2020-07-16,10131,Capital Call,-547378,-9929113,0,-9929113
22821,2020-07-16,10131,Distribution,547378,-9929113,547378,-9381735
22821,2020-08-31,10131,Value,6755130,-9929113,547378,-9381735
22821,2020-11-30,10131,Value,6487700,-9929113,547378,-9381735
22821,2021-01-14,10131,Capital Call,-70889,-10000002,547378,-9452624
22821,2021-02-28,10131,Value,6558580,-10000002,547378,-9452624
22821,2021-04-15,10131,Distribution,659736,-10000002,1207114,-8792888
22821,2021-05-31,10131,Value,4741380,-10000002,1207114,-8792888
22821,2021-08-31,10131,Value,4471340,-10000002,1207114,-8792888
22821,2021-10-16,10131,Capital Call,0,-10000002,1207114,-8792888
22821,2021-10-16,10131,Distribution,0,-10000002,1207114,-8792888
22821,2021-11-30,10131,Value,4176150,-10000002,1207114,-8792888
22824,2020-02-15,737,Capital Call,-319885,-10022939,5431251,-4591688
22824,2020-02-15,737,Distribution,31248,-10022939,5462499,-4560440
22824,2020-03-31,737,Value,5679670,-10022939,5462499,-4560440
22824,2020-05-16,737,Capital Call,-206430,-10229369,5462499,-4766870
22824,2020-06-30,737,Value,5418330,-10229369,5462499,-4766870
22824,2020-08-15,737,Capital Call,-278140,-10507509,5462499,-5045010
22824,2020-09-30,737,Value,6734110,-10507509,5462499,-5045010
22824,2020-11-15,737,Capital Call,-396148,-10903657,5462499,-5441158
22824,2020-12-31,737,Value,8321720,-10903657,5462499,-5441158
22878,2020-03-31,703,Value,3693280,-10586326,4088516,-6497810
22878,2020-06-30,703,Value,3942530,-10586326,4088516,-6497810
22878,2020-08-15,703,Capital Call,174897,-10411429,4088516,-6322913
22878,2020-08-15,703,Distribution,-309201,-10411429,3779315,-6632114
22878,2020-09-30,703,Value,4380060,-10411429,3779315,-6632114
22878,2020-11-15,703,Capital Call,-69032,-10480461,3779315,-6701146
22878,2020-12-31,703,Value,4684120,-10480461,3779315,-6701146
22878,2021-03-31,703,Value,5894010,-10480461,3779315,-6701146
22878,2021-05-16,703,Capital Call,580460,-9900001,3779315,-6120686
22878,2021-05-16,703,Distribution,-209374,-9900001,3569941,-6330060
22878,2021-06-30,703,Value,6298380,-9900001,3569941,-6330060
22889,2020-03-31,809,Value,5709190,-10514860,11624559,1109699
22889,2020-05-16,809,Capital Call,-27919,-10542779,11624559,1081780
22889,2020-06-30,809,Value,5662800,-10542779,11624559,1081780
22889,2020-08-15,809,Capital Call,-11838,-10554617,11624559,1069942
22889,2020-09-30,809,Value,7375270,-10554617,11624559,1069942
22889,2020-11-15,809,Capital Call,-12273,-10566890,11624559,1057669
22889,2020-11-15,809,Distribution,2364667,-10566890,13989226,3422336
22889,2020-12-31,809,Value,6064970,-10566890,13989226,3422336
22889,2021-02-14,809,Capital Call,-9499,-10576389,13989226,3412837
22889,2021-03-31,809,Value,8166090,-10576389,13989226,3412837
22928,2020-03-31,506,Value,9916780,-7750000,1576433,-6173567
22928,2020-05-16,506,Capital Call,-450000,-8200000,1576433,-6623567
22928,2020-05-16,506,Distribution,450000,-8200000,2026433,-6173567
22928,2020-06-30,506,Value,9985360,-8200000,2026433,-6173567
22928,2020-08-15,506,Capital Call,-200000,-8400000,2026433,-6373567
22928,2020-08-15,506,Distribution,350000,-8400000,2376433,-6023567
22928,2020-09-30,506,Value,11051540,-8400000,2376433,-6023567
22928,2020-11-15,506,Capital Call,-100000,-8500000,2376433,-6123567
22928,2020-11-15,506,Distribution,700000,-8500000,3076433,-5423567
22928,2020-12-31,506,Value,12017060,-8500000,3076433,-5423567
22928,2021-02-14,506,Capital Call,-150000,-8650000,3076433,-5573567
22928,2021-02-14,506,Distribution,870000,-8650000,3946433,-4703567
22928,2021-03-31,506,Value,11297060,-8650000,3946433,-4703567
22989,2020-02-15,18619,Capital Call,-16960,-11441521,15416000,3974479
22989,2020-02-15,18619,Distribution,263855,-11441521,15679855,4238334
22989,2020-03-31,18619,Value,3008000,-11441521,15679855,4238334
22989,2020-05-16,18619,Capital Call,-32845,-11474366,15679855,4205489
22989,2020-05-16,18619,Distribution,231147,-11474366,15911002,4436636
22989,2020-06-30,18619,Value,2682690,-11474366,15911002,4436636
22989,2020-08-15,18619,Capital Call,-14099,-11488465,15911002,4422537
22989,2020-08-15,18619,Distribution,132164,-11488465,16043166,4554701
22989,2020-09-30,18619,Value,2792150,-11488465,16043166,4554701
22989,2020-11-15,18619,Capital Call,-22738,-11511203,16043166,4531963
22989,2020-11-15,18619,Distribution,181719,-11511203,16224885,4713682
22989,2020-12-31,18619,Value,2543750,-11511203,16224885,4713682
22989,2021-02-14,18619,Capital Call,-3683796,-15194999,16224885,1029886
22989,2021-02-14,18619,Distribution,5686309,-15194999,21911194,6716195
22989,2021-03-31,18619,Value,3276040,-15194999,21911194,6716195
22995,2020-02-15,18,Capital Call,188,-9135999,11181100,2045101
22995,2020-02-15,18,Distribution,-230,-9135999,11180870,2044871
22995,2020-03-31,18,Value,7209610,-9135999,11180870,2044871
22995,2020-05-16,18,Capital Call,-115000,-9250999,11180870,1929871
22995,2020-06-30,18,Value,7673650,-9250999,11180870,1929871
22995,2020-08-15,18,Distribution,633425,-9250999,11814295,2563296
22995,2020-09-30,18,Value,8863320,-9250999,11814295,2563296
22995,2020-11-15,18,Distribution,310986,-9250999,12125281,2874282
22995,2020-12-31,18,Value,10591780,-9250999,12125281,2874282
22995,2021-02-14,18,Distribution,643461,-9250999,12768742,3517743
22995,2021-03-31,18,Value,10609900,-9250999,12768742,3517743
22995,2021-05-16,18,Capital Call,28,-9250971,12768742,3517771
22995,2021-05-16,18,Distribution,791002,-9250971,13559744,4308773
22995,2021-06-30,18,Value,9864590,-9250971,13559744,4308773
22995,2021-09-30,18,Value,10058150,-9250971,13559744,4308773
23002,2020-02-15,519,Capital Call,-533333,-8933333,7666666,-1266667
23002,2020-02-15,519,Distribution,533333,-8933333,8199999,-733334
23002,2020-03-31,519,Value,2986660,-8933333,8199999,-733334
23002,2020-05-16,519,Distribution,520000,-8933333,8719999,-213334
23002,2020-06-30,519,Value,2426660,-8933333,8719999,-213334
23002,2020-08-15,519,Distribution,133333,-8933333,8853332,-80001
23002,2020-09-30,519,Value,2413330,-8933333,8853332,-80001
23002,2020-12-30,519,Distribution,1813333,-8933333,10666665,1733332
23002,2021-03-31,519,Value,0,-8933333,10666665,1733332
23002,2021-06-30,519,Value,0,-8933333,10666665,1733332
23002,2021-09-30,519,Value,0,-8933333,10666665,1733332
23028,2020-02-15,58200,Distribution,0,-9340000,11101525,1761525
23028,2020-03-31,58200,Value,19025580,-9340000,11101525,1761525
23028,2020-05-16,58200,Capital Call,-193000,-9533000,11101525,1568525
23028,2020-05-16,58200,Distribution,115004,-9533000,11216529,1683529
23028,2020-06-30,58200,Value,19287160,-9533000,11216529,1683529
23028,2020-08-15,58200,Capital Call,95000,-9438000,11216529,1778529
23028,2020-08-15,58200,Distribution,-111777,-9438000,11104752,1666752
23028,2020-09-30,58200,Value,19091180,-9438000,11104752,1666752
23028,2020-12-31,58200,Value,22533220,-9438000,11104752,1666752
23028,2021-03-31,58200,Value,23107990,-9438000,11104752,1666752
23115,2020-03-31,11436,Value,3989960,-7776676,23617233,15840557
23115,2020-06-30,11436,Value,3989960,-7776676,23617233,15840557
23115,2020-09-30,11436,Value,4534330,-7776676,23617233,15840557
23115,2020-12-31,11436,Value,5312000,-7776676,23617233,15840557
23115,2021-02-14,11436,Distribution,290765,-7776676,23907998,16131322
23115,2021-03-31,11436,Value,5254530,-7776676,23907998,16131322
23115,2021-06-30,11436,Value,7354240,-7776676,23907998,16131322
23137,2020-03-31,1484,Value,3779130,-10356543,11972261,1615718
23137,2020-05-16,1484,Capital Call,-205448,-10561991,11972261,1410270
23137,2020-06-30,1484,Value,3392000,-10561991,11972261,1410270
23137,2020-09-30,1484,Value,3541490,-10561991,11972261,1410270
23137,2020-11-15,1484,Distribution,281950,-10561991,12254211,1692220
23137,2020-12-31,1484,Value,5256020,-10561991,12254211,1692220
23137,2021-03-31,1484,Value,5048750,-10561991,12254211,1692220
23195,2020-03-31,59150,Value,9030550,-11228749,6309299,-4919450
23195,2020-06-30,59150,Value,9249370,-11228749,6309299,-4919450
23195,2020-08-15,59150,Capital Call,-90869,-11319618,6309299,-5010319
23195,2020-08-15,59150,Distribution,792786,-11319618,7102085,-4217533
23195,2020-09-30,59150,Value,8402460,-11319618,7102085,-4217533
23195,2020-11-15,59150,Capital Call,-29145,-11348763,7102085,-4246678
23195,2020-11-15,59150,Distribution,2512701,-11348763,9614786,-1733977
23195,2020-12-31,59150,Value,5063820,-11348763,9614786,-1733977
23195,2021-03-31,59150,Value,4684270,-11348763,9614786,-1733977
23195,2021-05-16,59150,Capital Call,-55404,-11404167,9614786,-1789381
23195,2021-05-16,59150,Distribution,680656,-11404167,10295442,-1108725
23195,2021-06-30,59150,Value,4147790,-11404167,10295442,-1108725
23254,2021-12-31,10380,Value,0,-6389944,0,-6389944
23260,2020-03-31,710,Value,9784280,-11843143,12725715,882572
23260,2020-05-16,710,Capital Call,-100857,-11944000,12725715,781715
23260,2020-05-16,710,Distribution,100857,-11944000,12826572,882572
23260,2020-06-30,710,Value,11497710,-11944000,12826572,882572
23260,2020-08-15,710,Capital Call,-100000,-12044000,12826572,782572
23260,2020-08-15,710,Distribution,100000,-12044000,12926572,882572
23260,2020-09-30,710,Value,11936850,-12044000,12926572,882572
23260,2020-11-15,710,Distribution,9866000,-12044000,22792572,10748572
23260,2020-12-31,710,Value,2276000,-12044000,22792572,10748572
23260,2021-02-14,710,Distribution,266571,-12044000,23059143,11015143
23260,2021-03-31,710,Value,1985140,-12044000,23059143,11015143
23260,2021-06-30,710,Value,1934280,-12044000,23059143,11015143
23377,2020-02-15,7292,Distribution,519000,-10000000,7945000,-2055000
23377,2020-03-31,7292,Value,10783000,-10000000,7945000,-2055000
23377,2020-05-16,7292,Distribution,460000,-10000000,8405000,-1595000
23377,2020-06-30,7292,Value,8772000,-10000000,8405000,-1595000
23377,2020-09-30,7292,Value,10286000,-10000000,8405000,-1595000
23377,2020-11-15,7292,Distribution,1105000,-10000000,9510000,-490000
23377,2020-12-31,7292,Value,9303000,-10000000,9510000,-490000
23404,2020-03-31,6955,Value,79990,-11370000,11190000,-180000
23404,2020-06-30,6955,Value,79990,-11370000,11190000,-180000
23404,2020-09-30,6955,Value,79990,-11370000,11190000,-180000
23404,2020-11-15,6955,Distribution,110000,-11370000,11300000,-70000
23404,2020-12-31,6955,Value,79990,-11370000,11300000,-70000
23404,2021-03-31,6955,Value,79990,-11370000,11300000,-70000
23404,2021-06-30,6955,Value,69990,-11370000,11300000,-70000
23404,2021-09-30,6955,Value,69990,-11370000,11300000,-70000
23467,2020-02-15,11324,Capital Call,-35666,-10106965,13053877,2946912
23467,2020-03-31,11324,Value,5786070,-10106965,13053877,2946912
23467,2020-06-30,11324,Value,6317520,-10106965,13053877,2946912
23467,2020-08-15,11324,Capital Call,-38530,-10145495,13053877,2908382
23467,2020-08-15,11324,Distribution,4509,-10145495,13058386,2912891
23467,2020-09-30,11324,Value,6326380,-10145495,13058386,2912891
23467,2020-12-31,11324,Value,6298370,-10145495,13058386,2912891
23467,2021-02-14,11324,Capital Call,-34144,-10179639,13058386,2878747
23467,2021-03-31,11324,Value,6368420,-10179639,13058386,2878747
23470,2020-02-15,133,Capital Call,-40000,-10500000,1980000,-8520000
23470,2020-02-15,133,Distribution,1810000,-10500000,3790000,-6710000
23470,2020-03-31,133,Value,6510000,-10500000,3790000,-6710000
23470,2020-06-30,133,Value,7920000,-10500000,3790000,-6710000
23470,2020-08-15,133,Capital Call,-90000,-10590000,3790000,-6800000
23470,2020-08-15,133,Distribution,1070000,-10590000,4860000,-5730000
23470,2020-09-30,133,Value,6939990,-10590000,4860000,-5730000
23470,2020-11-15,133,Capital Call,-20000,-10610000,4860000,-5750000
23470,2020-12-31,133,Value,7430000,-10610000,4860000,-5750000
23470,2021-02-14,133,Capital Call,-10000,-10620000,4860000,-5760000
23470,2021-03-31,133,Value,7069990,-10620000,4860000,-5760000
23470,2021-05-16,133,Capital Call,-10000,-10630000,4860000,-5770000
23470,2021-06-30,133,Value,7519990,-10630000,4860000,-5770000
23470,2021-08-15,133,Capital Call,-20000,-10650000,4860000,-5790000
23470,2021-08-15,133,Distribution,10000,-10650000,4870000,-5780000
23470,2021-09-30,133,Value,6860000,-10650000,4870000,-5780000
23489,2020-03-31,5177,Value,11172130,-10510000,6053760,-4456240
23489,2020-06-30,5177,Value,11130090,-10510000,6053760,-4456240
23489,2020-09-30,5177,Value,12790670,-10510000,6053760,-4456240
23489,2020-11-15,5177,Distribution,7230880,-10510000,13284640,2774640
23489,2020-12-31,5177,Value,6190390,-10510000,13284640,2774640
23489,2021-02-14,5177,Distribution,-10510,-10510000,13274130,2764130
23489,2021-03-31,5177,Value,6169370,-10510000,13274130,2764130
23489,2021-05-16,5177,Distribution,357340,-10510000,13631470,3121470
23489,2021-06-30,5177,Value,10110620,-10510000,13631470,3121470
23489,2021-08-15,5177,Distribution,1051000,-10510000,14682470,4172470
23489,2021-09-30,5177,Value,8281880,-10510000,14682470,4172470
23526,2020-02-15,2385,Capital Call,-30000,-9260000,16098000,6838000
23526,2020-02-15,2385,Distribution,2134000,-9260000,18232000,8972000
23526,2020-03-31,2385,Value,5588000,-9260000,18232000,8972000
23526,2020-05-16,2385,Distribution,42000,-9260000,18274000,9014000
23526,2020-06-30,2385,Value,5502000,-9260000,18274000,9014000
23577,2020-02-15,1718,Distribution,485000,-9700000,3686000,-6014000
23577,2020-03-31,1718,Value,9409000,-9700000,3686000,-6014000
23577,2020-05-16,1718,Distribution,582000,-9700000,4268000,-5432000
23577,2020-06-30,1718,Value,9603000,-9700000,4268000,-5432000
23577,2020-09-30,1718,Value,10088000,-9700000,4268000,-5432000
23577,2020-11-15,1718,Distribution,485000,-9700000,4753000,-4947000
23577,2020-12-31,1718,Value,9312000,-9700000,4753000,-4947000
23577,2021-02-14,1718,Distribution,2328000,-9700000,7081000,-2619000
23577,2021-03-31,1718,Value,7469000,-9700000,7081000,-2619000
23577,2021-06-30,1718,Value,7469000,-9700000,7081000,-2619000
23577,2021-08-15,1718,Distribution,485000,-9700000,7566000,-2134000
23577,2021-09-30,1718,Value,7081000,-9700000,7566000,-2134000
23577,2021-12-31,1718,Value,7566000,-9700000,7566000,-2134000
23618,2020-02-15,60789,Capital Call,-1020000,-10129997,8654501,-1475496
23618,2020-02-15,60789,Distribution,-44000,-10129997,8610501,-1519496
23618,2020-03-31,60789,Value,7597500,-10129997,8610501,-1519496
23618,2020-05-16,60789,Capital Call,-40000,-10169997,8610501,-1559496
23618,2020-05-16,60789,Distribution,-67700,-10169997,8542801,-1627196
23618,2020-06-30,60789,Value,10373400,-10169997,8542801,-1627196
23650,2020-03-31,10504,Value,6575180,-9481177,3584962,-5896215
23650,2020-06-30,10504,Value,4190000,-9481177,3584962,-5896215
23650,2020-08-15,10504,Capital Call,0,-9481177,3584962,-5896215
23650,2020-08-15,10504,Distribution,0,-9481177,3584962,-5896215
23650,2020-09-30,10504,Value,4399390,-9481177,3584962,-5896215
23650,2020-12-30,10504,Distribution,1112879,-9481177,4697841,-4783336
23650,2021-03-31,10504,Value,3805520,-9481177,4697841,-4783336
23650,2021-06-30,10504,Value,3682140,-9481177,4697841,-4783336
23807,2020-02-15,5296,Distribution,504800,-6310000,504800,-5805200
23807,2020-03-31,5296,Value,10032900,-6310000,504800,-5805200
23807,2020-06-30,5296,Value,9843600,-6310000,504800,-5805200
23807,2020-09-30,5296,Value,9654300,-6310000,504800,-5805200
23807,2020-12-31,5296,Value,10537700,-6310000,504800,-5805200
23807,2021-02-14,5296,Distribution,252400,-6310000,757200,-5552800
23807,2021-03-31,5296,Value,10537700,-6310000,757200,-5552800
23807,2021-05-16,5296,Distribution,378600,-6310000,1135800,-5174200
23807,2021-06-30,5296,Value,11358000,-6310000,1135800,-5174200
23807,2021-08-15,5296,Distribution,631000,-6310000,1766800,-4543200
23807,2021-09-30,5296,Value,11989000,-6310000,1766800,-4543200
23812,2020-02-15,5296,Capital Call,-26578,-8000000,1036545,-6963455
23812,2020-02-15,5296,Distribution,3455,-8000000,1040000,-6960000
23812,2020-03-31,5296,Value,8800000,-8000000,1040000,-6960000
23812,2020-05-16,5296,Distribution,320000,-8000000,1360000,-6640000
23812,2020-06-30,5296,Value,8000000,-8000000,1360000,-6640000
23812,2020-08-15,5296,Distribution,560000,-8000000,1920000,-6080000
23812,2020-09-30,5296,Value,7360000,-8000000,1920000,-6080000
23812,2020-11-15,5296,Distribution,240000,-8000000,2160000,-5840000
23812,2020-12-31,5296,Value,7600000,-8000000,2160000,-5840000
23812,2021-02-14,5296,Distribution,320000,-8000000,2480000,-5520000
23812,2021-03-31,5296,Value,7360000,-8000000,2480000,-5520000
23812,2021-06-30,5296,Value,8000000,-8000000,2480000,-5520000
23812,2021-09-30,5296,Value,8800000,-8000000,2480000,-5520000
23861,2020-01-15,181549,Capital Call,-18039,-9945885,4776877,-5169008
23861,2020-01-15,181549,Distribution,211182,-9945885,4988059,-4957826
23861,2020-02-29,181549,Value,6634720,-9945885,4988059,-4957826
23861,2020-04-15,181549,Capital Call,-15963,-9961848,4988059,-4973789
23861,2020-04-15,181549,Distribution,0,-9961848,4988059,-4973789
23861,2020-05-31,181549,Value,6146880,-9961848,4988059,-4973789
23861,2020-07-16,181549,Capital Call,-16569,-9978417,4988059,-4990358
23861,2020-07-16,181549,Distribution,383868,-9978417,5371927,-4606490
23861,2020-08-31,181549,Value,6408830,-9978417,5371927,-4606490
23861,2020-10-16,181549,Capital Call,-15404,-9993821,5371927,-4621894
23861,2020-10-16,181549,Distribution,46196,-9993821,5418123,-4575698
23861,2020-11-30,181549,Value,6537460,-9993821,5418123,-4575698
23861,2021-01-14,181549,Capital Call,-16385,-10010206,5418123,-4592083
23861,2021-02-28,181549,Value,6666540,-10010206,5418123,-4592083
23861,2021-04-15,181549,Capital Call,-16238,-10026444,5418123,-4608321
23861,2021-04-15,181549,Distribution,688543,-10026444,6106666,-3919778
23861,2021-05-31,181549,Value,6108870,-10026444,6106666,-3919778
23861,2021-07-16,181549,Capital Call,-16263,-10042707,6106666,-3936041
23861,2021-08-31,181549,Value,5672370,-10042707,6106666,-3936041
23861,2021-10-16,181549,Capital Call,-14769,-10057476,6106666,-3950810
23861,2021-10-16,181549,Distribution,0,-10057476,6106666,-3950810
23861,2021-12-31,181549,Value,0,-10057476,6106666,-3950810
23965,2021-12-31,435,Value,0,-10278402,12687660,2409258
23972,2020-01-15,62096,Capital Call,-827944,-10598804,2724519,-7874285
23972,2020-01-15,62096,Distribution,3281363,-10598804,6005882,-4592922
23972,2020-02-29,62096,Value,14448490,-10598804,6005882,-4592922
23972,2020-04-15,62096,Capital Call,0,-10598804,6005882,-4592922
23972,2020-04-15,62096,Distribution,0,-10598804,6005882,-4592922
23972,2020-05-31,62096,Value,11337800,-10598804,6005882,-4592922
23972,2020-07-16,62096,Distribution,667742,-10598804,6673624,-3925180
23972,2020-08-31,62096,Value,12198090,-10598804,6673624,-3925180
23972,2020-11-30,62096,Value,12965090,-10598804,6673624,-3925180
23972,2021-02-28,62096,Value,12965090,-10598804,6673624,-3925180
23972,2021-05-31,62096,Value,17561500,-10598804,6673624,-3925180
23972,2021-08-31,62096,Value,18729530,-10598804,6673624,-3925180
23972,2021-10-16,62096,Capital Call,0,-10598804,6673624,-3925180
23972,2021-10-16,62096,Distribution,0,-10598804,6673624,-3925180
23972,2021-11-30,62096,Value,16718330,-10598804,6673624,-3925180
23979,2020-02-15,4982,Capital Call,-37565,-9279992,9631209,351217
23979,2020-02-15,4982,Distribution,1310896,-9279992,10942105,1662113
23979,2020-03-31,4982,Value,3231770,-9279992,10942105,1662113
23979,2020-06-30,4982,Value,3244160,-9279992,10942105,1662113
23979,2020-09-30,4982,Value,3152300,-9279992,10942105,1662113
23979,2020-12-31,4982,Value,3216490,-9279992,10942105,1662113
23979,2021-03-31,4982,Value,3618600,-9279992,10942105,1662113
24001,2020-03-31,60,Value,2599030,-10199383,19285380,9085997
24001,2020-06-30,60,Value,2428820,-10199383,19285380,9085997
24001,2020-08-15,60,Capital Call,-369212,-10568595,19285380,8716785
24001,2020-08-15,60,Distribution,824,-10568595,19286204,8717609
24001,2020-09-30,60,Value,2941650,-10568595,19286204,8717609
24001,2020-11-15,60,Capital Call,-13543,-10582138,19286204,8704066
24001,2020-11-15,60,Distribution,2530768,-10582138,21816972,11234834
24001,2020-12-31,60,Value,1899100,-10582138,21816972,11234834
24001,2021-03-31,60,Value,3563390,-10582138,21816972,11234834
24001,2021-05-16,60,Capital Call,-12576,-10594714,21816972,11222258
24001,2021-05-16,60,Distribution,303492,-10594714,22120464,11525750
24001,2021-06-30,60,Value,2657030,-10594714,22120464,11525750
24001,2021-08-15,60,Capital Call,-4899,-10599613,22120464,11520851
24001,2021-08-15,60,Distribution,763139,-10599613,22883603,12283990
24001,2021-09-30,60,Value,1965910,-10599613,22883603,12283990
24009,2020-01-15,62315,Capital Call,-21748,-9155229,0,-9155229
24009,2020-01-15,62315,Distribution,224032,-9155229,224032,-8931197
24009,2020-02-29,62315,Value,5783790,-9155229,224032,-8931197
24009,2020-04-15,62315,Capital Call,-14734,-9169963,224032,-8945931
24009,2020-05-31,62315,Value,5778290,-9169963,224032,-8945931
24009,2020-07-16,62315,Capital Call,-19461,-9189424,224032,-8965392
24009,2020-08-31,62315,Value,6365080,-9189424,224032,-8965392
24009,2020-10-16,62315,Capital Call,-14734,-9204158,224032,-8980126
24009,2020-11-30,62315,Value,6362120,-9204158,224032,-8980126
24009,2021-01-14,62315,Capital Call,-24188,-9228346,224032,-9004314
24009,2021-02-28,62315,Value,6386310,-9228346,224032,-9004314
24009,2021-05-31,62315,Value,6280220,-9228346,224032,-9004314
24009,2021-07-16,62315,Capital Call,-4346,-9232692,224032,-9008660
24009,2021-07-16,62315,Distribution,3834,-9232692,227866,-9004826
24009,2021-08-31,62315,Value,6275160,-9232692,227866,-9004826
24009,2021-11-30,62315,Value,6727610,-9232692,227866,-9004826
24070,2020-02-15,579,Capital Call,-75998,-9563481,6527115,-3036366
24070,2020-02-15,579,Distribution,264196,-9563481,6791311,-2772170
24070,2020-03-31,579,Value,8526310,-9563481,6791311,-2772170
24070,2020-05-16,579,Capital Call,-66520,-9630001,6791311,-2838690
24070,2020-05-16,579,Distribution,498598,-9630001,7289909,-2340092
24070,2020-06-30,579,Value,9302580,-9630001,7289909,-2340092
24070,2020-12-30,579,Capital Call,-131000,-9761001,7289909,-2471092
24070,2020-12-30,579,Distribution,1797581,-9761001,9087490,-673511
24070,2021-06-30,579,Value,13095350,-9761001,9087490,-673511
24070,2021-08-15,579,Capital Call,-16000,-9777001,9087490,-689511
24070,2021-08-15,579,Distribution,706130,-9777001,9793620,16619
24070,2021-09-30,579,Value,13204810,-9777001,9793620,16619
24076,2020-03-31,22872,Value,9713980,-9760742,0,-9760742
24076,2020-06-30,22872,Value,9517770,-9760742,0,-9760742
24076,2020-09-30,22872,Value,9517770,-9760742,0,-9760742
24076,2020-11-15,22872,Distribution,2541955,-9760742,2541955,-7218787
24076,2020-12-31,22872,Value,9108640,-9760742,2541955,-7218787
24076,2021-02-14,22872,Distribution,1569793,-9760742,4111748,-5648994
24076,2021-03-31,22872,Value,8395750,-9760742,4111748,-5648994
24087,2020-02-15,12475,Capital Call,-106260,-10892808,3737337,-7155471
24087,2020-02-15,12475,Distribution,-12805,-10892808,3724532,-7168276
24087,2020-03-31,12475,Value,10280710,-10892808,3724532,-7168276
24087,2020-05-16,12475,Capital Call,-329065,-11221873,3724532,-7497341
24087,2020-06-30,12475,Value,12452090,-11221873,3724532,-7497341
24087,2020-08-15,12475,Distribution,5478002,-11221873,9202534,-2019339
24087,2020-09-30,12475,Value,8907510,-11221873,9202534,-2019339
24087,2020-11-15,12475,Distribution,928821,-11221873,10131355,-1090518
24087,2020-12-31,12475,Value,6650360,-11221873,10131355,-1090518
24087,2021-02-14,12475,Distribution,290512,-11221873,10421867,-800006
24087,2021-03-31,12475,Value,6905330,-11221873,10421867,-800006
24087,2021-05-16,12475,Capital Call,-83351,-11305224,10421867,-883357
24087,2021-05-16,12475,Distribution,-40383,-11305224,10381484,-923740
24087,2021-06-30,12475,Value,6734990,-11305224,10381484,-923740
24199,2020-02-15,18,Capital Call,-51541,-7619899,4257960,-3361939
24199,2020-02-15,18,Distribution,650,-7619899,4258610,-3361289
24199,2020-03-31,18,Value,4422530,-7619899,4258610,-3361289
24199,2020-05-16,18,Distribution,219144,-7619899,4477754,-3142145
24199,2020-06-30,18,Value,4420560,-7619899,4477754,-3142145
24199,2020-09-30,18,Value,4802700,-7619899,4477754,-3142145
24199,2020-11-15,18,Distribution,370933,-7619899,4848687,-2771212
24199,2020-12-31,18,Value,4976320,-7619899,4848687,-2771212
24199,2021-03-31,18,Value,5329500,-7619899,4848687,-2771212
24270,2020-02-15,9004,Distribution,1160992,-9810000,14452880,4642880
24270,2020-03-31,9004,Value,14409320,-9810000,14452880,4642880
24270,2020-05-16,9004,Distribution,699937,-9810000,15152817,5342817
24270,2020-06-30,9004,Value,14139490,-9810000,15152817,5342817
24270,2020-09-30,9004,Value,14714600,-9810000,15152817,5342817
24270,2020-11-15,9004,Distribution,350000,-9810000,15502817,5692817
24270,2020-12-31,9004,Value,25019470,-9810000,15502817,5692817
24331,2020-02-15,17268,Capital Call,-12629,-6450627,6777825,327198
24331,2020-02-15,17268,Distribution,191506,-6450627,6969331,518704
24331,2020-03-31,17268,Value,1423250,-6450627,6969331,518704
24331,2020-05-16,17268,Capital Call,-1582,-6452209,6969331,517122
24331,2020-05-16,17268,Distribution,106707,-6452209,7076038,623829
24331,2020-06-30,17268,Value,1418120,-6452209,7076038,623829
24331,2020-08-15,17268,Distribution,64007,-6452209,7140045,687836
24331,2020-09-30,17268,Value,1427870,-6452209,7140045,687836
24331,2020-11-15,17268,Distribution,81678,-6452209,7221723,769514
24331,2020-12-31,17268,Value,1803340,-6452209,7221723,769514
24331,2021-02-14,17268,Capital Call,-6337,-6458546,7221723,763177
24331,2021-02-14,17268,Distribution,6337,-6458546,7228060,769514
24331,2021-03-31,17268,Value,1622060,-6458546,7228060,769514
24331,2021-05-16,17268,Distribution,1618726,-6458546,8846786,2388240
24331,2021-06-30,17268,Value,0,-6458546,8846786,2388240
24342,2020-02-15,475912,Capital Call,-125000,-12868998,13848906,979908
24342,2020-02-15,475912,Distribution,1064979,-12868998,14913885,2044887
24342,2020-03-31,475912,Value,6343130,-12868998,14913885,2044887
24342,2020-06-30,475912,Value,6744640,-12868998,14913885,2044887
24342,2020-08-15,475912,Capital Call,-196000,-13064998,14913885,1848887
24342,2020-08-15,475912,Distribution,876475,-13064998,15790360,2725362
24342,2020-09-30,475912,Value,6549480,-13064998,15790360,2725362
24342,2020-11-15,475912,Capital Call,-135000,-13199998,15790360,2590362
24342,2020-11-15,475912,Distribution,577641,-13199998,16368001,3168003
24342,2020-12-31,475912,Value,6468000,-13199998,16368001,3168003
24342,2021-02-14,475912,Distribution,264000,-13199998,16632001,3432003
24342,2021-03-31,475912,Value,6864000,-13199998,16632001,3432003
24359,2020-03-31,191595,Value,6885300,-8850000,10310250,1460250
24359,2020-06-30,191595,Value,7867650,-8850000,10310250,1460250
24359,2020-09-30,191595,Value,8398650,-8850000,10310250,1460250
24359,2020-11-15,191595,Capital Call,-1000,-8851000,10310250,1459250
24359,2020-11-15,191595,Distribution,-1490,-8851000,10308760,1457760
24359,2020-12-31,191595,Value,9280270,-8851000,10308760,1457760
24359,2021-03-31,191595,Value,11678000,-8851000,10308760,1457760
24359,2021-05-16,191595,Distribution,5307945,-8851000,15616705,6765705
24359,2021-06-30,191595,Value,7522460,-8851000,15616705,6765705
24359,2021-09-30,191595,Value,7866760,-8851000,15616705,6765705
24359,2021-11-15,191595,Distribution,101786,-8851000,15718491,6867491
24359,2021-12-31,191595,Value,7965010,-8851000,15718491,6867491
24404,2020-03-31,63660,Value,7888530,-10758509,14909037,4150528
24404,2020-06-30,63660,Value,7698980,-10758509,14909037,4150528
24404,2020-09-30,63660,Value,7411150,-10758509,14909037,4150528
24404,2020-11-15,63660,Capital Call,-158720,-10917229,14909037,3991808
24404,2020-12-31,63660,Value,7305650,-10917229,14909037,3991808
24404,2021-02-14,63660,Capital Call,-34060,-10951289,14909037,3957748
24404,2021-02-14,63660,Distribution,1442396,-10951289,16351433,5400144
24404,2021-03-31,63660,Value,5824210,-10951289,16351433,5400144
24404,2021-06-30,63660,Value,5977900,-10951289,16351433,5400144
24408,2020-01-15,89,Capital Call,-525898,-11487852,1629968,-9857884
24408,2020-01-15,89,Distribution,1035429,-11487852,2665397,-8822455
24408,2020-02-29,89,Value,11079960,-11487852,2665397,-8822455
24408,2020-04-15,89,Capital Call,-111042,-11598894,2665397,-8933497
24408,2020-04-15,89,Distribution,0,-11598894,2665397,-8933497
24408,2020-05-31,89,Value,9652070,-11598894,2665397,-8933497
24408,2020-08-31,89,Value,11186110,-11598894,2665397,-8933497
24408,2020-10-16,89,Capital Call,-43839,-11642733,2665397,-8977336
24408,2020-10-16,89,Distribution,1493715,-11642733,4159112,-7483621
24408,2020-11-30,89,Value,13484990,-11642733,4159112,-7483621
24408,2021-01-14,89,Capital Call,-218714,-11861447,4159112,-7702335
24408,2021-01-14,89,Distribution,433668,-11861447,4592780,-7268667
24408,2021-02-28,89,Value,13270030,-11861447,4592780,-7268667
24408,2021-05-31,89,Value,24138910,-11861447,4592780,-7268667
24408,2021-07-16,89,Capital Call,-345235,-12206682,4592780,-7613902
24408,2021-07-16,89,Distribution,1180373,-12206682,5773153,-6433529
24408,2021-08-31,89,Value,28939610,-12206682,5773153,-6433529
24408,2021-10-16,89,Capital Call,0,-12206682,5773153,-6433529
24408,2021-10-16,89,Distribution,0,-12206682,5773153,-6433529
24408,2021-11-30,89,Value,30055820,-12206682,5773153,-6433529
24548,2020-02-15,24,Distribution,149933,-9200001,10960880,1760879
24548,2020-03-31,24,Value,5028720,-9200001,10960880,1760879
24548,2020-06-30,24,Value,5508960,-9200001,10960880,1760879
24548,2020-08-15,24,Distribution,96600,-9200001,11057480,1857479
24548,2020-09-30,24,Value,5830960,-9200001,11057480,1857479
24548,2020-12-31,24,Value,7033400,-9200001,11057480,1857479
24548,2021-02-14,24,Distribution,618240,-9200001,11675720,2475719
24548,2021-03-31,24,Value,7001200,-9200001,11675720,2475719
24548,2021-05-16,24,Distribution,394680,-9200001,12070400,2870399
24548,2021-06-30,24,Value,7352640,-9200001,12070400,2870399
24548,2021-09-30,24,Value,7828280,-9200001,12070400,2870399
24550,2020-02-15,1314,Capital Call,-100196,-8813244,4607462,-4205782
24550,2020-02-15,1314,Distribution,860277,-8813244,5467739,-3345505
24550,2020-03-31,1314,Value,10019780,-8813244,5467739,-3345505
24550,2020-05-16,1314,Capital Call,-150294,-8963538,5467739,-3495799
24550,2020-05-16,1314,Distribution,635537,-8963538,6103276,-2860262
24550,2020-06-30,1314,Value,10289240,-8963538,6103276,-2860262
24550,2020-08-15,1314,Distribution,120111,-8963538,6223387,-2740151
24550,2020-09-30,1314,Value,11495740,-8963538,6223387,-2740151
24550,2020-11-15,1314,Distribution,618484,-8963538,6841871,-2121667
24550,2020-12-31,1314,Value,13356570,-8963538,6841871,-2121667
24550,2021-02-14,1314,Distribution,616692,-8963538,7458563,-1504975
24550,2021-03-31,1314,Value,13971470,-8963538,7458563,-1504975
24550,2021-05-16,1314,Distribution,976130,-8963538,8434693,-528845
24550,2021-06-30,1314,Value,14796110,-8963538,8434693,-528845
24550,2021-08-15,1314,Capital Call,17926,-8945612,8434693,-510919
24550,2021-08-15,1314,Distribution,-15613,-8945612,8419080,-526532
24550,2021-09-30,1314,Value,14539960,-8945612,8419080,-526532
24620,2020-02-15,577,Distribution,2213333,-10040001,26146666,16106665
24620,2020-03-31,577,Value,10666660,-10040001,26146666,16106665
24620,2020-05-16,577,Capital Call,-200000,-10240001,26146666,15906665
24620,2020-06-30,577,Value,11466660,-10240001,26146666,15906665
24620,2020-09-30,577,Value,11933330,-10240001,26146666,15906665
24620,2020-11-15,577,Capital Call,-240000,-10480001,26146666,15666665
24620,2020-11-15,577,Distribution,520000,-10480001,26666666,16186665
24620,2020-12-31,577,Value,12920000,-10480001,26666666,16186665
24620,2021-03-31,577,Value,14866660,-10480001,26666666,16186665
24620,2021-05-16,577,Capital Call,-160000,-10640001,26666666,16026665
24620,2021-05-16,577,Distribution,1026667,-10640001,27693333,17053332
24620,2021-06-30,577,Value,15573330,-10640001,27693333,17053332
24620,2021-08-15,577,Distribution,1853333,-10640001,29546666,18906665
24620,2021-09-30,577,Value,15079990,-10640001,29546666,18906665
24705,2020-02-15,589,Distribution,1692000,-9400000,9118000,-282000
24705,2020-03-31,589,Value,14570000,-9400000,9118000,-282000
24705,2020-07-01,589,Distribution,3384000,-9400000,12502000,3102000
24705,2020-09-30,589,Value,13818000,-9400000,12502000,3102000
24705,2020-11-15,589,Capital Call,-400000,-9800000,12502000,2702000
24705,2020-11-15,589,Distribution,1218000,-9800000,13720000,3920000
24705,2020-12-31,589,Value,15974000,-9800000,13720000,3920000
24705,2021-02-14,589,Distribution,2646000,-9800000,16366000,6566000
24705,2021-03-31,589,Value,14406000,-9800000,16366000,6566000
24705,2021-05-16,589,Distribution,98000,-9800000,16464000,6664000
24705,2021-06-30,589,Value,16072000,-9800000,16464000,6664000
24816,2020-02-15,8927,Capital Call,-150000,-14265000,4270000,-9995000
24816,2020-02-15,8927,Distribution,150000,-14265000,4420000,-9845000
24816,2020-03-31,8927,Value,9294990,-14265000,4420000,-9845000
24816,2020-05-16,8927,Capital Call,-255000,-14520000,4420000,-10100000
24816,2020-05-16,8927,Distribution,255000,-14520000,4675000,-9845000
24816,2020-06-30,8927,Value,7164990,-14520000,4675000,-9845000
24816,2020-08-15,8927,Capital Call,-195000,-14715000,4675000,-10040000
24816,2020-08-15,8927,Distribution,205000,-14715000,4880000,-9835000
24816,2020-09-30,8927,Value,7854990,-14715000,4880000,-9835000
24816,2020-11-15,8927,Capital Call,10000,-14705000,4880000,-9825000
24816,2020-11-15,8927,Distribution,1675000,-14705000,6555000,-8150000
24816,2020-12-31,8927,Value,6929990,-14705000,6555000,-8150000
24816,2021-02-14,8927,Capital Call,-1845000,-16550000,6555000,-9995000
24816,2021-02-14,8927,Distribution,1840000,-16550000,8395000,-8155000
24816,2021-03-31,8927,Value,6695000,-16550000,8395000,-8155000
24816,2021-05-16,8927,Capital Call,-85000,-16635000,8395000,-8240000
24816,2021-05-16,8927,Distribution,510000,-16635000,8905000,-7730000
24816,2021-06-30,8927,Value,7009990,-16635000,8905000,-7730000
24816,2021-08-15,8927,Capital Call,-205500,-16840500,8905000,-7935500
24816,2021-08-15,8927,Distribution,204000,-16840500,9109000,-7731500
24816,2021-09-30,8927,Value,5759490,-16840500,9109000,-7731500
24847,2020-03-31,12680,Value,11506120,-11746939,5089797,-6657142
24847,2020-06-30,12680,Value,10979590,-11746939,5089797,-6657142
24847,2020-08-15,12680,Capital Call,-28571,-11775510,5089797,-6685713
24847,2020-09-30,12680,Value,11171420,-11775510,5089797,-6685713
24847,2020-11-15,12680,Capital Call,-134694,-11910204,5089797,-6820407
24847,2020-11-15,12680,Distribution,8163,-11910204,5097960,-6812244
24847,2020-12-31,12680,Value,11546930,-11910204,5097960,-6812244
24847,2021-02-14,12680,Capital Call,-73469,-11983673,5097960,-6885713
24847,2021-03-31,12680,Value,11869380,-11983673,5097960,-6885713
24847,2021-05-16,12680,Capital Call,-65306,-12048979,5097960,-6951019
24847,2021-05-16,12680,Distribution,8163,-12048979,5106123,-6942856
24847,2021-06-30,12680,Value,12012240,-12048979,5106123,-6942856
24847,2021-08-15,12680,Capital Call,-84898,-12133877,5106123,-7027754
24847,2021-08-15,12680,Distribution,1224,-12133877,5107347,-7026530
24847,2021-09-30,12680,Value,12031020,-12133877,5107347,-7026530
24849,2020-03-31,5772,Value,5356000,-10299999,6695001,-3604998
24894,2020-01-15,9022,Capital Call,0,-9731430,7875025,-1856405
24894,2020-01-15,9022,Distribution,0,-9731430,7875025,-1856405
24894,2020-02-29,9022,Value,11999880,-9731430,7875025,-1856405
24894,2020-04-15,9022,Capital Call,0,-9731430,7875025,-1856405
24894,2020-04-15,9022,Distribution,349990,-9731430,8225015,-1506415
24894,2020-05-31,9022,Value,11466270,-9731430,8225015,-1506415
24894,2020-08-31,9022,Value,11403400,-9731430,8225015,-1506415
24894,2020-11-30,9022,Value,14562490,-9731430,8225015,-1506415
24894,2021-01-14,9022,Capital Call,-300000,-10031430,8225015,-1806415
24894,2021-02-28,9022,Value,14862490,-10031430,8225015,-1806415
24894,2021-04-15,9022,Distribution,5722240,-10031430,13947255,3915825
24894,2021-05-31,9022,Value,16737960,-10031430,13947255,3915825
24894,2021-08-31,9022,Value,17842000,-10031430,13947255,3915825
24894,2021-10-16,9022,Distribution,260591,-10031430,14207846,4176416
24894,2021-11-30,9022,Value,22009480,-10031430,14207846,4176416
24938,2020-03-31,795,Value,6266940,-10014998,10172097,157099
24938,2020-05-16,795,Distribution,174900,-10014998,10346997,331999
24938,2020-06-30,795,Value,5093800,-10014998,10346997,331999
24938,2020-08-15,795,Capital Call,-2125,-10017123,10346997,329874
24938,2020-08-15,795,Distribution,453890,-10017123,10800887,783764
24938,2020-09-30,795,Value,4979230,-10017123,10800887,783764
24938,2020-11-15,795,Capital Call,0,-10017123,10800887,783764
24938,2020-11-15,795,Distribution,0,-10017123,10800887,783764
24938,2020-12-31,795,Value,5524770,-10017123,10800887,783764
24938,2021-02-14,795,Capital Call,0,-10017123,10800887,783764
24938,2021-02-14,795,Distribution,566750,-10017123,11367637,1350514
24938,2021-03-31,795,Value,5779740,-10017123,11367637,1350514
24938,2021-05-16,795,Distribution,305000,-10017123,11672637,1655514
24938,2021-06-30,795,Value,5648950,-10017123,11672637,1655514
24983,2020-03-31,333,Value,14137530,-8035402,6403478,-1631924
24983,2020-06-30,333,Value,14269830,-8035402,6403478,-1631924
25090,2020-02-15,58707,Capital Call,-46452,-10062732,2450260,-7612472
25090,2020-03-31,58707,Value,5353120,-10062732,2450260,-7612472
25090,2020-06-30,58707,Value,6103860,-10062732,2450260,-7612472
25090,2020-09-30,58707,Value,5313230,-10062732,2450260,-7612472
25090,2020-11-15,58707,Capital Call,-42000,-10104732,2450260,-7654472
25090,2020-12-31,58707,Value,5910450,-10104732,2450260,-7654472
25090,2021-03-31,58707,Value,5004990,-10104732,2450260,-7654472
25090,2021-05-16,58707,Capital Call,-31777,-10136509,2450260,-7686249
25090,2021-06-30,58707,Value,5352610,-10136509,2450260,-7686249
25188,2020-02-15,2512,Capital Call,-141000,-9478999,1989928,-7489071
25188,2020-02-15,2512,Distribution,383614,-9478999,2373542,-7105457
25188,2020-03-31,2512,Value,5919630,-9478999,2373542,-7105457
25188,2020-06-30,2512,Value,6039070,-9478999,2373542,-7105457
25188,2020-12-31,2512,Value,6463730,-9478999,2373542,-7105457
25188,2021-02-14,2512,Distribution,2943230,-9478999,5316772,-4162227
25188,2021-03-31,2512,Value,4097770,-9478999,5316772,-4162227
25188,2021-05-16,2512,Distribution,703342,-9478999,6020114,-3458885
25188,2021-06-30,2512,Value,3434240,-9478999,6020114,-3458885
25188,2021-09-30,2512,Value,3470260,-9478999,6020114,-3458885
25199,2020-03-16,8935,Distribution,-16656,-16214035,17879644,1665609
25199,2020-06-30,8935,Value,0,-16214035,17879644,1665609
25199,2020-09-30,8935,Value,0,-16214035,17879644,1665609
25199,2020-12-31,8935,Value,0,-16214035,17879644,1665609
25199,2021-03-31,8935,Value,0,-16214035,17879644,1665609
25199,2021-06-30,8935,Value,0,-16214035,17879644,1665609
25199,2021-09-30,8935,Value,0,-16214035,17879644,1665609
25199,2021-12-31,8935,Value,0,-16214035,17879644,1665609
25206,2020-02-15,2214,Capital Call,-200000,-9700000,4590000,-5110000
25206,2020-03-31,2214,Value,8562000,-9700000,4590000,-5110000
25206,2020-05-16,2214,Distribution,1500000,-9700000,6090000,-3610000
25206,2020-06-30,2214,Value,9073000,-9700000,6090000,-3610000
25206,2020-08-15,2214,Distribution,3533000,-9700000,9623000,-77000
25206,2020-09-30,2214,Value,8279000,-9700000,9623000,-77000
25206,2020-11-15,2214,Distribution,11396000,-9700000,21019000,11319000
25206,2020-12-31,2214,Value,3460000,-9700000,21019000,11319000
25223,2020-03-31,66152,Value,1559050,-10730687,12497302,1766615
25223,2020-05-16,66152,Capital Call,-121625,-10852312,12497302,1644990
25223,2020-06-30,66152,Value,1737490,-10852312,12497302,1644990
25223,2020-08-15,66152,Capital Call,-209439,-11061751,12497302,1435551
25223,2020-08-15,66152,Distribution,939,-11061751,12498241,1436490
25223,2020-09-30,66152,Value,2333410,-11061751,12498241,1436490
25223,2020-12-31,66152,Value,2664470,-11061751,12498241,1436490
25223,2021-03-31,66152,Value,2656960,-11061751,12498241,1436490
25223,2021-06-30,66152,Value,2568200,-11061751,12498241,1436490
25299,2020-02-15,9954,Capital Call,-302558,-11691974,10557485,-1134489
25299,2020-03-31,9954,Value,7375430,-11691974,10557485,-1134489
25299,2020-05-16,9954,Distribution,1884321,-11691974,12441806,749832
25299,2020-06-30,9954,Value,6565720,-11691974,12441806,749832
25299,2020-08-15,9954,Distribution,103553,-11691974,12545359,853385
25299,2020-09-30,9954,Value,6630880,-11691974,12545359,853385
25299,2020-11-15,9954,Distribution,2416621,-11691974,14961980,3270006
25299,2020-12-31,9954,Value,6023870,-11691974,14961980,3270006
25299,2021-02-14,9954,Distribution,3969922,-11691974,18931902,7239928
25299,2021-03-31,9954,Value,3337970,-11691974,18931902,7239928
25299,2021-05-16,9954,Distribution,545562,-11691974,19477464,7785490
25299,2021-06-30,9954,Value,3498630,-11691974,19477464,7785490
25360,2020-03-31,20278,Value,42500000,-10000000,0,-10000000
25360,2020-06-30,20278,Value,40500000,-10000000,0,-10000000
25360,2020-09-30,20278,Value,40424000,-10000000,0,-10000000
25360,2020-12-31,20278,Value,40000000,-10000000,0,-10000000
25360,2021-03-31,20278,Value,42600000,-10000000,0,-10000000
25360,2021-06-30,20278,Value,48900000,-10000000,0,-10000000
25455,2020-03-31,2305,Value,3871420,-9580530,13322139,3741609
25455,2020-05-16,2305,Distribution,263601,-9580530,13585740,4005210
25455,2020-06-30,2305,Value,4525050,-9580530,13585740,4005210
25463,2020-02-15,1360,Distribution,1021875,-8440625,12346875,3906250
25463,2020-03-31,1360,Value,7775000,-8440625,12346875,3906250
25463,2020-07-01,1360,Distribution,1059375,-8440625,13406250,4965625
25463,2020-09-30,1360,Value,6084370,-8440625,13406250,4965625
25463,2020-11-15,1360,Distribution,134375,-8440625,13540625,5100000
25463,2020-12-31,1360,Value,6028120,-8440625,13540625,5100000
25463,2021-02-14,1360,Distribution,525000,-8440625,14065625,5625000
25463,2021-03-31,1360,Value,5928120,-8440625,14065625,5625000
25463,2021-05-16,1360,Distribution,456250,-8440625,14521875,6081250
25463,2021-06-30,1360,Value,5853120,-8440625,14521875,6081250
25463,2021-08-15,1360,Distribution,1228125,-8440625,15750000,7309375
25463,2021-09-30,1360,Value,6378210,-8440625,15750000,7309375
25502,2020-02-15,15275,Capital Call,-250000,-9350000,2863794,-6486206
25502,2020-03-31,15275,Value,10741320,-9350000,2863794,-6486206
25502,2020-06-30,15275,Value,11757750,-9350000,2863794,-6486206
25502,2020-08-15,15275,Capital Call,-200000,-9550000,2863794,-6686206
25502,2020-08-15,15275,Distribution,2280621,-9550000,5144415,-4405585
25502,2020-09-30,15275,Value,13946070,-9550000,5144415,-4405585
25502,2020-12-31,15275,Value,15897140,-9550000,5144415,-4405585
25502,2021-02-14,15275,Distribution,3325349,-9550000,8469764,-1080236
25502,2021-03-31,15275,Value,13425020,-9550000,8469764,-1080236
25511,2020-02-15,9110,Capital Call,-30436,-11950433,12923665,973232
25511,2020-02-15,9110,Distribution,209444,-11950433,13133109,1182676
25511,2020-03-31,9110,Value,8137870,-11950433,13133109,1182676
25511,2020-05-16,9110,Capital Call,-171564,-12121997,13133109,1011112
25511,2020-05-16,9110,Distribution,75023,-12121997,13208132,1086135
25511,2020-06-30,9110,Value,8487820,-12121997,13208132,1086135
25511,2020-08-15,9110,Capital Call,-119000,-12240997,13208132,967135
25511,2020-08-15,9110,Distribution,1101598,-12240997,14309730,2068733
25511,2020-09-30,9110,Value,8120670,-12240997,14309730,2068733
25511,2020-11-15,9110,Capital Call,-21000,-12261997,14309730,2047733
25511,2020-11-15,9110,Distribution,269789,-12261997,14579519,2317522
25511,2020-12-31,9110,Value,9017470,-12261997,14579519,2317522
25511,2021-02-14,9110,Capital Call,-57000,-12318997,14579519,2260522
25511,2021-02-14,9110,Distribution,261181,-12318997,14840700,2521703
25511,2021-03-31,9110,Value,9511490,-12318997,14840700,2521703
25511,2021-05-16,9110,Distribution,2717571,-12318997,17558271,5239274
25511,2021-06-30,9110,Value,7425890,-12318997,17558271,5239274
25511,2021-08-15,9110,Capital Call,-263000,-12581997,17558271,4976274
25511,2021-08-15,9110,Distribution,304395,-12581997,17862666,5280669
25511,2021-09-30,9110,Value,7584420,-12581997,17862666,5280669
25515,2020-02-15,9110,Capital Call,-99000,-11851000,8745839,-3105161
25515,2020-02-15,9110,Distribution,813178,-11851000,9559017,-2291983
25515,2020-03-31,9110,Value,8658340,-11851000,9559017,-2291983
25515,2020-06-30,9110,Value,9670410,-11851000,9559017,-2291983
25515,2020-08-15,9110,Capital Call,-46000,-11897000,9559017,-2337983
25515,2020-08-15,9110,Distribution,873463,-11897000,10432480,-1464520
25515,2020-09-30,9110,Value,9836430,-11897000,10432480,-1464520
25515,2020-11-15,9110,Capital Call,-3000,-11900000,10432480,-1467520
25515,2020-11-15,9110,Distribution,407231,-11900000,10839711,-1060289
25515,2020-12-31,9110,Value,10581480,-11900000,10839711,-1060289
25515,2021-02-14,9110,Capital Call,-83000,-11983000,10839711,-1143289
25515,2021-02-14,9110,Distribution,832930,-11983000,11672641,-310359
25515,2021-03-31,9110,Value,10548630,-11983000,11672641,-310359
25515,2021-05-16,9110,Capital Call,-52000,-12035000,11672641,-362359
25515,2021-05-16,9110,Distribution,362360,-12035000,12035001,1
25515,2021-06-30,9110,Value,11003600,-12035000,12035001,1
25515,2021-08-15,9110,Capital Call,-23000,-12058000,12035001,-22999
25515,2021-08-15,9110,Distribution,1051547,-12058000,13086548,1028548
25515,2021-09-30,9110,Value,9788680,-12058000,13086548,1028548
25516,2020-02-15,9110,Capital Call,-91281,-10767279,8911257,-1856022
25516,2020-02-15,9110,Distribution,594139,-10767279,9505396,-1261883
25516,2020-03-31,9110,Value,8408050,-10767279,9505396,-1261883
25516,2020-05-16,9110,Capital Call,281,-10766998,9505396,-1261602
25516,2020-05-16,9110,Distribution,-289,-10766998,9505107,-1261891
25516,2020-06-30,9110,Value,9347900,-10766998,9505107,-1261891
25516,2020-08-15,9110,Capital Call,-57000,-10823998,9505107,-1318891
25516,2020-08-15,9110,Distribution,710584,-10823998,10215691,-608307
25516,2020-09-30,9110,Value,9669070,-10823998,10215691,-608307
25516,2020-11-15,9110,Capital Call,-165000,-10988998,10215691,-773307
25516,2020-11-15,9110,Distribution,474408,-10988998,10690099,-298899
25516,2020-12-31,9110,Value,10695590,-10988998,10690099,-298899
25516,2021-02-14,9110,Capital Call,58000,-10930998,10690099,-240899
25516,2021-02-14,9110,Distribution,495593,-10930998,11185692,254694
25516,2021-03-31,9110,Value,11005330,-10930998,11185692,254694
25516,2021-05-16,9110,Distribution,425216,-10930998,11610908,679910
25516,2021-06-30,9110,Value,11477550,-10930998,11610908,679910
25516,2021-08-15,9110,Capital Call,-27000,-10957998,11610908,652910
25516,2021-08-15,9110,Distribution,1055444,-10957998,12666352,1708354
25516,2021-09-30,9110,Value,10034240,-10957998,12666352,1708354
25559,2020-03-31,10486,Value,7764180,-9345076,15780921,6435845
25559,2020-06-30,10486,Value,8427330,-9345076,15780921,6435845
25559,2020-08-15,10486,Capital Call,-72475,-9417551,15780921,6363370
25559,2020-08-15,10486,Distribution,1348962,-9417551,17129883,7712332
25559,2020-09-30,10486,Value,7601600,-9417551,17129883,7712332
25559,2020-11-15,10486,Capital Call,-23068,-9440619,17129883,7689264
25559,2020-11-15,10486,Distribution,115340,-9440619,17245223,7804604
25559,2020-12-31,10486,Value,6864890,-9440619,17245223,7804604
25581,2020-02-15,1632,Distribution,680835,-12424001,28450959,16026958
25581,2020-03-31,1632,Value,5749820,-12424001,28450959,16026958
25581,2020-05-16,1632,Capital Call,16000,-12408001,28450959,16042958
25581,2020-05-16,1632,Distribution,1542898,-12408001,29993857,17585856
25581,2020-06-30,1632,Value,6457120,-12408001,29993857,17585856
25581,2020-08-15,1632,Distribution,796594,-12408001,30790451,18382450
25581,2020-09-30,1632,Value,5787090,-12408001,30790451,18382450
25581,2020-11-15,1632,Distribution,372240,-12408001,31162691,18754690
25581,2020-12-31,1632,Value,5677900,-12408001,31162691,18754690
25581,2021-03-31,1632,Value,6550180,-12408001,31162691,18754690
25581,2021-05-16,1632,Distribution,1536110,-12408001,32698801,20290800
25581,2021-06-30,1632,Value,6078670,-12408001,32698801,20290800
25581,2021-09-30,1632,Value,6881470,-12408001,32698801,20290800
25703,2020-02-15,6307,Capital Call,-70000,-9980001,2770000,-7210001
25703,2020-02-15,6307,Distribution,3430000,-9980001,6200000,-3780001
25703,2020-03-31,6307,Value,12090000,-9980001,6200000,-3780001
25703,2020-06-30,6307,Value,12449990,-9980001,6200000,-3780001
25703,2020-09-30,6307,Value,12759990,-9980001,6200000,-3780001
25703,2020-11-15,6307,Capital Call,-80000,-10060001,6200000,-3860001
25703,2020-11-15,6307,Distribution,850000,-10060001,7050000,-3010001
25703,2020-12-31,6307,Value,12360000,-10060001,7050000,-3010001
25703,2021-03-31,6307,Value,12580000,-10060001,7050000,-3010001
25703,2021-05-16,6307,Distribution,1760000,-10060001,8810000,-1250001
25703,2021-06-30,6307,Value,11349990,-10060001,8810000,-1250001
25703,2021-09-30,6307,Value,11890000,-10060001,8810000,-1250001
25759,2020-01-15,1697,Capital Call,-114183,-9931548,1772943,-8158605
25759,2020-01-15,1697,Distribution,0,-9931548,1772943,-8158605
25759,2020-02-29,1697,Value,6207040,-9931548,1772943,-8158605
25759,2020-04-15,1697,Capital Call,0,-9931548,1772943,-8158605
25759,2020-04-15,1697,Distribution,986477,-9931548,2759420,-7172128
25759,2020-05-31,1697,Value,3707160,-9931548,2759420,-7172128
25759,2020-07-16,1697,Capital Call,-114514,-10046062,2759420,-7286642
25759,2020-08-31,1697,Value,4221180,-10046062,2759420,-7286642
25759,2020-11-30,1697,Value,2949200,-10046062,2759420,-7286642
25759,2021-01-14,1697,Capital Call,-200302,-10246364,2759420,-7486944
25759,2021-01-14,1697,Distribution,72417,-10246364,2831837,-7414527
25759,2021-02-28,1697,Value,2871620,-10246364,2831837,-7414527
25759,2021-04-15,1697,Capital Call,-78702,-10325066,2831837,-7493229
25759,2021-05-31,1697,Value,2951260,-10325066,2831837,-7493229
25759,2021-08-31,1697,Value,2807580,-10325066,2831837,-7493229
25759,2021-10-16,1697,Capital Call,-69948,-10395014,2831837,-7563177
25759,2021-10-16,1697,Distribution,0,-10395014,2831837,-7563177
25759,2021-11-30,1697,Value,2476040,-10395014,2831837,-7563177
25765,2020-03-31,7,Value,8186400,-9900000,7850000,-2050000
25765,2020-06-30,7,Value,9153330,-9900000,7850000,-2050000
25765,2020-08-15,7,Capital Call,-50000,-9950000,7850000,-2100000
25765,2020-08-15,7,Distribution,300000,-9950000,8150000,-1800000
25765,2020-09-30,7,Value,10575760,-9950000,8150000,-1800000
25765,2020-11-15,7,Distribution,1050000,-9950000,9200000,-750000
25765,2020-12-31,7,Value,11091530,-9950000,9200000,-750000
25765,2021-03-31,7,Value,12545830,-9950000,9200000,-750000
25873,2020-01-15,12267,Capital Call,-23741,-9894186,9393442,-500744
25873,2020-01-15,12267,Distribution,26533,-9894186,9419975,-474211
25873,2020-02-29,12267,Value,6393980,-9894186,9419975,-474211
25873,2020-04-15,12267,Capital Call,-26340,-9920526,9419975,-500551
25873,2020-04-15,12267,Distribution,2137837,-9920526,11557812,1637286
25873,2020-05-31,12267,Value,3585600,-9920526,11557812,1637286
25873,2020-07-16,12267,Distribution,1106627,-9920526,12664439,2743913
25873,2020-08-31,12267,Value,2744700,-9920526,12664439,2743913
25873,2020-11-30,12267,Value,2650930,-9920526,12664439,2743913
25873,2021-01-14,12267,Capital Call,-202236,-10122762,12664439,2541677
25873,2021-01-14,12267,Distribution,936325,-10122762,13600764,3478002
25873,2021-02-28,12267,Value,2787290,-10122762,13600764,3478002
25873,2021-04-15,12267,Distribution,575590,-10122762,14176354,4053592
25873,2021-05-31,12267,Value,1990430,-10122762,14176354,4053592
25873,2021-07-16,12267,Distribution,1832244,-10122762,16008598,5885836
25873,2021-08-31,12267,Value,541310,-10122762,16008598,5885836
25873,2021-10-16,12267,Capital Call,0,-10122762,16008598,5885836
25873,2021-10-16,12267,Distribution,25313,-10122762,16033911,5911149
25873,2021-11-30,12267,Value,933420,-10122762,16033911,5911149
25876,2020-03-31,454,Value,11082730,-10997376,7942723,-3054653
25876,2020-05-16,454,Capital Call,-160801,-11158177,7942723,-3215454
25876,2020-05-16,454,Distribution,52851,-11158177,7995574,-3162603
25876,2020-06-30,454,Value,11642820,-11158177,7995574,-3162603
25876,2020-08-15,454,Capital Call,-17023,-11175200,7995574,-3179626
25876,2020-08-15,454,Distribution,5777,-11175200,8001351,-3173849
25876,2020-09-30,454,Value,12561020,-11175200,8001351,-3173849
25876,2020-11-15,454,Capital Call,-1608,-11176808,8001351,-3175457
25876,2020-11-15,454,Distribution,454621,-11176808,8455972,-2720836
25876,2020-12-31,454,Value,13450570,-11176808,8455972,-2720836
25939,2020-02-15,571,Capital Call,-40000,-9460000,4775941,-4684059
25939,2020-02-15,571,Distribution,1360,-9460000,4777301,-4682699
25939,2020-03-31,571,Value,6688220,-9460000,4777301,-4682699
25939,2020-05-16,571,Capital Call,590000,-8870000,4777301,-4092699
25939,2020-05-16,571,Distribution,-856760,-8870000,3920541,-4949459
25939,2020-06-30,571,Value,7087130,-8870000,3920541,-4949459
25939,2020-08-15,571,Capital Call,-30000,-8900000,3920541,-4979459
25939,2020-08-15,571,Distribution,13260,-8900000,3933801,-4966199
25939,2020-09-30,571,Value,7217900,-8900000,3933801,-4966199
25939,2020-11-15,571,Capital Call,-70000,-8970000,3933801,-5036199
25939,2020-11-15,571,Distribution,4030,-8970000,3937831,-5032169
25939,2020-12-31,571,Value,8279310,-8970000,3937831,-5032169
25939,2021-02-14,571,Capital Call,-30000,-9000000,3937831,-5062169
25939,2021-02-14,571,Distribution,-4830,-9000000,3933001,-5066999
25939,2021-03-31,571,Value,8802000,-9000000,3933001,-5066999
25939,2021-05-16,571,Capital Call,-240000,-9240000,3933001,-5306999
25939,2021-05-16,571,Distribution,206520,-9240000,4139521,-5100479
25939,2021-06-30,571,Value,9378600,-9240000,4139521,-5100479
25939,2021-08-15,571,Capital Call,-20000,-9260000,4139521,-5120479
25939,2021-08-15,571,Distribution,36740,-9260000,4176261,-5083739
25939,2021-09-30,571,Value,9584100,-9260000,4176261,-5083739
25965,2020-02-15,6322,Distribution,210526,-9368421,9926316,557895
25965,2020-03-31,6322,Value,4263150,-9368421,9926316,557895
25965,2020-06-30,6322,Value,4589470,-9368421,9926316,557895
25965,2020-09-30,6322,Value,5642100,-9368421,9926316,557895
25965,2020-12-30,6322,Distribution,4010526,-9368421,13936842,4568421
25965,2021-03-31,6322,Value,0,-9368421,13936842,4568421
25965,2021-06-30,6322,Value,0,-9368421,13936842,4568421
25965,2021-09-30,6322,Value,0,-9368421,13936842,4568421
25987,2020-03-31,579,Capital Call,-145000,-9510000,7387113,-2122887
25987,2020-03-31,579,Distribution,439618,-9510000,7826731,-1683269
25987,2020-06-30,579,Value,7617510,-9510000,7826731,-1683269
25987,2020-12-30,579,Capital Call,-184000,-9694000,7826731,-1867269
25987,2020-12-30,579,Distribution,1645277,-9694000,9472008,-221992
25987,2021-06-30,579,Value,10710900,-9694000,9472008,-221992
25987,2021-08-15,579,Capital Call,-32000,-9726000,9472008,-253992
25987,2021-08-15,579,Distribution,466019,-9726000,9938027,212027
25987,2021-09-30,579,Value,10897980,-9726000,9938027,212027
26019,2020-03-31,709,Value,0,-9702340,14971358,5269018
26019,2020-06-30,709,Value,0,-9702340,14971358,5269018
26019,2020-09-30,709,Value,0,-9702340,14971358,5269018
26019,2020-12-31,709,Value,0,-9702340,14971358,5269018
26019,2021-03-31,709,Value,0,-9702340,14971358,5269018
26019,2021-12-31,709,Value,0,-9702340,14971358,5269018
26322,2020-02-15,212,Capital Call,67692,-10812308,5710771,-5101537
26322,2020-02-15,212,Distribution,1647692,-10812308,7358463,-3453845
26322,2020-03-31,212,Value,8784610,-10812308,7358463,-3453845
26322,2020-05-16,212,Distribution,104615,-10812308,7463078,-3349230
26322,2020-06-30,212,Value,8281530,-10812308,7463078,-3349230
26322,2020-09-30,212,Value,8229230,-10812308,7463078,-3349230
26322,2020-11-15,212,Capital Call,-212308,-11024616,7463078,-3561538
26322,2020-11-15,212,Distribution,112308,-11024616,7575386,-3449230
26322,2020-12-31,212,Value,9624610,-11024616,7575386,-3449230
26322,2021-02-14,212,Distribution,53846,-11024616,7629232,-3395384
26322,2021-03-31,212,Value,10263070,-11024616,7629232,-3395384
26322,2021-05-16,212,Distribution,747692,-11024616,8376924,-2647692
26322,2021-06-30,212,Value,11055380,-11024616,8376924,-2647692
26322,2021-08-15,212,Capital Call,-615,-11025231,8376924,-2648307
26322,2021-08-15,212,Distribution,1357231,-11025231,9734155,-1291076
26322,2021-09-30,212,Value,9888760,-11025231,9734155,-1291076
26400,2020-03-31,15,Value,3954190,-7941487,6571484,-1370003
26444,2020-03-31,5571,Value,7592530,-7000000,971429,-6028571
26444,2020-05-16,5571,Capital Call,-400000,-7400000,971429,-6428571
26444,2020-06-30,5571,Value,8272000,-7400000,971429,-6428571
26444,2020-09-30,5571,Value,8878640,-7400000,971429,-6428571
26444,2020-11-15,5571,Distribution,191,-7400000,971620,-6428380
26444,2020-12-31,5571,Value,10052900,-7400000,971620,-6428380
26444,2021-02-14,5571,Distribution,556951,-7400000,1528571,-5871429
26444,2021-03-31,5571,Value,10504080,-7400000,1528571,-5871429
26444,2021-06-30,5571,Value,10872530,-7400000,1528571,-5871429
26444,2021-08-15,5571,Distribution,371749,-7400000,1900320,-5499680
26444,2021-09-30,5571,Value,10685600,-7400000,1900320,-5499680
26460,2020-02-15,2238,Distribution,200000,-9960000,6640000,-3320000
26460,2020-03-31,2238,Value,19540000,-9960000,6640000,-3320000
26460,2020-05-16,2238,Capital Call,-100000,-10060000,6640000,-3420000
26460,2020-05-16,2238,Distribution,440000,-10060000,7080000,-2980000
26460,2020-06-30,2238,Value,22500000,-10060000,7080000,-2980000
26460,2020-09-30,2238,Value,24440000,-10060000,7080000,-2980000
26460,2020-12-31,2238,Value,23040000,-10060000,7080000,-2980000
26460,2021-02-14,2238,Distribution,1740000,-10060000,8820000,-1240000
26460,2021-03-31,2238,Value,20360000,-10060000,8820000,-1240000
26460,2021-05-16,2238,Distribution,1040000,-10060000,9860000,-200000
26460,2021-06-30,2238,Value,18940000,-10060000,9860000,-200000
26460,2021-08-15,2238,Distribution,1080000,-10060000,10940000,880000
26460,2021-09-30,2238,Value,12400000,-10060000,10940000,880000
26499,2020-02-15,9048,Distribution,1113000,-10000000,2199000,-7801000
26499,2020-03-31,9048,Value,9940000,-10000000,2199000,-7801000
26499,2020-06-30,9048,Value,10279000,-10000000,2199000,-7801000
26499,2020-08-15,9048,Distribution,5903000,-10000000,8102000,-1898000
26499,2020-09-30,9048,Value,4218000,-10000000,8102000,-1898000
26499,2020-12-31,9048,Value,4457000,-10000000,8102000,-1898000
26499,2021-03-31,9048,Value,4756000,-10000000,8102000,-1898000
26499,2021-06-30,9048,Value,4758000,-10000000,8102000,-1898000
26518,2020-02-15,350,Capital Call,-22517,-9497259,11075500,1578241
26518,2020-02-15,350,Distribution,146406,-9497259,11221906,1724647
26518,2020-03-31,350,Value,4034700,-9497259,11221906,1724647
26518,2020-05-16,350,Capital Call,-36929,-9534188,11221906,1687718
26518,2020-05-16,350,Distribution,2598,-9534188,11224504,1690316
26518,2020-06-30,350,Value,3907090,-9534188,11224504,1690316
26518,2020-08-15,350,Capital Call,-1615,-9535803,11224504,1688701
26518,2020-08-15,350,Distribution,26175,-9535803,11250679,1714876
26518,2020-09-30,350,Value,3701420,-9535803,11250679,1714876
26518,2020-11-15,350,Capital Call,-2221,-9538024,11250679,1712655
26518,2020-11-15,350,Distribution,111825,-9538024,11362504,1824480
26518,2020-12-31,350,Value,4039200,-9538024,11362504,1824480
26518,2021-02-14,350,Capital Call,-4313,-9542337,11362504,1820167
26518,2021-02-14,350,Distribution,103356,-9542337,11465860,1923523
26518,2021-03-31,350,Value,4126370,-9542337,11465860,1923523
26535,2020-02-15,545,Capital Call,-253333,-10240001,6173334,-4066667
26535,2020-02-15,545,Distribution,1373333,-10240001,7546667,-2693334
26535,2020-03-31,545,Value,6400000,-10240001,7546667,-2693334
26535,2020-06-30,545,Value,7440000,-10240001,7546667,-2693334
26535,2020-08-15,545,Capital Call,-493333,-10733334,7546667,-3186667
26535,2020-09-30,545,Value,8466660,-10733334,7546667,-3186667
26535,2020-11-15,545,Capital Call,-240000,-10973334,7546667,-3426667
26535,2020-11-15,545,Distribution,1653333,-10973334,9200000,-1773334
26535,2020-12-31,545,Value,8760000,-10973334,9200000,-1773334
26535,2021-02-14,545,Capital Call,-106667,-11080001,9200000,-1880001
26535,2021-02-14,545,Distribution,1066667,-11080001,10266667,-813334
26535,2021-03-31,545,Value,9319990,-11080001,10266667,-813334
26535,2021-05-16,545,Capital Call,-440000,-11520001,10266667,-1253334
26535,2021-05-16,545,Distribution,1293333,-11520001,11560000,39999
26535,2021-06-30,545,Value,9546660,-11520001,11560000,39999
26535,2021-08-15,545,Capital Call,-26667,-11546668,11560000,13332
26535,2021-08-15,545,Distribution,4960000,-11546668,16520000,4973332
26535,2021-09-30,545,Value,4386660,-11546668,16520000,4973332
26631,2020-03-31,70992,Value,13031000,-10000000,4212000,-5788000
26631,2020-06-30,70992,Value,14059000,-10000000,4212000,-5788000
26631,2020-09-30,70992,Value,15804000,-10000000,4212000,-5788000
26631,2020-12-31,70992,Value,13584000,-10000000,4212000,-5788000
26631,2021-02-14,70992,Distribution,1500000,-10000000,5712000,-4288000
26631,2021-03-31,70992,Value,12244000,-10000000,5712000,-4288000
26631,2021-06-30,70992,Value,12460000,-10000000,5712000,-4288000
26722,2020-02-29,6715,Value,27582960,-9350000,4879674,-4470326
26722,2020-04-15,6715,Distribution,2500020,-9350000,7379694,-1970306
26722,2020-05-31,6715,Value,28973490,-9350000,7379694,-1970306
26722,2020-07-16,6715,Distribution,1395165,-9350000,8774859,-575141
26722,2020-08-31,6715,Value,28452370,-9350000,8774859,-575141
26722,2020-10-16,6715,Distribution,1546336,-9350000,10321195,971195
26722,2020-11-30,6715,Value,29692750,-9350000,10321195,971195
26722,2021-02-28,6715,Value,29692750,-9350000,10321195,971195
26722,2021-04-15,6715,Distribution,182227747,-9350000,192548942,183198942
26722,2021-05-31,6715,Value,21733320,-9350000,192548942,183198942
26722,2021-07-16,6715,Capital Call,-80000,-9430000,192548942,183118942
26722,2021-07-16,6715,Distribution,9080000,-9430000,201628942,192198942
26722,2021-08-31,6715,Value,21980530,-9430000,201628942,192198942
26722,2021-10-16,6715,Distribution,6414640,-9430000,208043582,198613582
26722,2021-11-30,6715,Value,37731210,-9430000,208043582,198613582
26725,2020-02-29,7473,Value,1457200,-10000000,1418907,-8581093
26725,2020-05-31,7473,Value,1458430,-10000000,1418907,-8581093
26725,2020-08-31,7473,Value,1521790,-10000000,1418907,-8581093
26725,2020-11-30,7473,Value,1519420,-10000000,1418907,-8581093
26725,2021-02-28,7473,Value,1519420,-10000000,1418907,-8581093
26725,2021-05-31,7473,Value,1176100,-10000000,1418907,-8581093
26725,2021-08-31,7473,Value,1165110,-10000000,1418907,-8581093
26725,2021-11-30,7473,Value,1156020,-10000000,1418907,-8581093
26933,2020-02-15,11832,Capital Call,-54816,-10588705,6879151,-3709554
26933,2020-03-31,11832,Value,7072540,-10588705,6879151,-3709554
26933,2020-05-16,11832,Capital Call,-30959,-10619664,6879151,-3740513
26933,2020-06-30,11832,Value,5594130,-10619664,6879151,-3740513
26933,2020-08-15,11832,Capital Call,-157923,-10777587,6879151,-3898436
26933,2020-09-30,11832,Value,5328650,-10777587,6879151,-3898436
26933,2020-12-31,11832,Value,5356750,-10777587,6879151,-3898436
26933,2021-02-14,11832,Capital Call,-63911,-10841498,6879151,-3962347
26933,2021-03-31,11832,Value,5974780,-10841498,6879151,-3962347
26933,2021-05-16,11832,Capital Call,-95306,-10936804,6879151,-4057653
26933,2021-06-30,11832,Value,5913100,-10936804,6879151,-4057653
26933,2021-08-15,11832,Capital Call,-146687,-11083491,6879151,-4204340
26933,2021-09-30,11832,Value,7586360,-11083491,6879151,-4204340
27087,2020-02-15,162111,Distribution,318668,-10200000,8211351,-1988649
27087,2020-03-31,162111,Value,11854530,-10200000,8211351,-1988649
27087,2020-06-30,162111,Value,11026500,-10200000,8211351,-1988649
27087,2020-09-30,162111,Value,11837600,-10200000,8211351,-1988649
27087,2020-11-15,162111,Distribution,643872,-10200000,8855223,-1344777
27087,2020-12-31,162111,Value,13869860,-10200000,8855223,-1344777
27087,2021-02-14,162111,Distribution,4554814,-10200000,13410037,3210037
27087,2021-03-31,162111,Value,13150680,-10200000,13410037,3210037
27114,2020-02-15,12,Capital Call,460,-9718000,3580000,-6138000
27114,2020-02-15,12,Distribution,679399,-9718000,4259399,-5458601
27114,2020-03-31,12,Value,10599420,-9718000,4259399,-5458601
27114,2020-05-16,12,Capital Call,-460,-9718460,4259399,-5459061
27114,2020-05-16,12,Distribution,-19399,-9718460,4240000,-5478460
27114,2020-06-30,12,Value,10559990,-9718460,4240000,-5478460
27114,2020-08-15,12,Capital Call,460,-9718000,4240000,-5478000
27114,2020-08-15,12,Distribution,-36965,-9718000,4203035,-5514965
27114,2020-09-30,12,Value,11524570,-9718000,4203035,-5514965
27114,2020-11-15,12,Capital Call,-460,-9718460,4203035,-5515425
27114,2020-11-15,12,Distribution,7232205,-9718460,11435240,1716780
27114,2020-12-31,12,Value,4819790,-9718460,11435240,1716780
27114,2021-02-14,12,Capital Call,460,-9718000,11435240,1717240
27114,2021-02-14,12,Distribution,1707383,-9718000,13142623,3424623
27114,2021-03-31,12,Value,4150550,-9718000,13142623,3424623
27114,2021-05-16,12,Capital Call,-460,-9718460,13142623,3424163
27114,2021-05-16,12,Distribution,957,-9718460,13143580,3425120
27114,2021-06-30,12,Value,4496750,-9718460,13143580,3425120
27114,2021-08-15,12,Distribution,1124980,-9718460,14268560,4550100
27114,2021-09-30,12,Value,5155670,-9718460,14268560,4550100
27114,2021-12-31,12,Value,5169540,-9718460,14268560,4550100
27311,2020-03-31,733,Value,8129010,-10576190,5290453,-5285737
27311,2020-05-16,733,Capital Call,-58959,-10635149,5290453,-5344696
27311,2020-06-30,733,Value,8436770,-10635149,5290453,-5344696
27311,2020-08-15,733,Capital Call,-271488,-10906637,5290453,-5616184
27311,2020-08-15,733,Distribution,566170,-10906637,5856623,-5050014
27311,2020-09-30,733,Value,8436700,-10906637,5856623,-5050014
27311,2020-11-15,733,Distribution,403140,-10906637,6259763,-4646874
27311,2020-12-31,733,Value,8919190,-10906637,6259763,-4646874
27311,2021-02-14,733,Capital Call,-219640,-11126277,6259763,-4866514
27311,2021-02-14,733,Distribution,796139,-11126277,7055902,-4070375
27311,2021-03-31,733,Value,10832900,-11126277,7055902,-4070375
27311,2021-05-16,733,Distribution,170264,-11126277,7226166,-3900111
27311,2021-06-30,733,Value,11090650,-11126277,7226166,-3900111
27312,2020-03-31,6757,Value,9819990,-11220000,4490000,-6730000
27312,2020-05-16,6757,Capital Call,-150000,-11370000,4490000,-6880000
27312,2020-05-16,6757,Distribution,210000,-11370000,4700000,-6670000
27312,2020-06-30,6757,Value,9960000,-11370000,4700000,-6670000
27312,2020-08-15,6757,Capital Call,-20000,-11390000,4700000,-6690000
27312,2020-08-15,6757,Distribution,170000,-11390000,4870000,-6520000
27312,2020-09-30,6757,Value,9999990,-11390000,4870000,-6520000
27312,2020-12-31,6757,Value,10190000,-11390000,4870000,-6520000
27312,2021-03-31,6757,Value,10389990,-11390000,4870000,-6520000
27312,2021-05-16,6757,Capital Call,-350000,-11740000,4870000,-6870000
27312,2021-05-16,6757,Distribution,1380000,-11740000,6250000,-5490000
27312,2021-06-30,6757,Value,9549990,-11740000,6250000,-5490000
27312,2021-08-15,6757,Distribution,310000,-11740000,6560000,-5180000
27312,2021-09-30,6757,Value,9429990,-11740000,6560000,-5180000
27414,2020-02-15,436,Capital Call,-55000,-11775000,6275000,-5500000
27414,2020-02-15,436,Distribution,210000,-11775000,6485000,-5290000
27414,2020-03-31,436,Value,9034990,-11775000,6485000,-5290000
27414,2020-05-16,436,Capital Call,-430000,-12205000,6485000,-5720000
27414,2020-05-16,436,Distribution,830000,-12205000,7315000,-4890000
27414,2020-06-30,436,Value,8965000,-12205000,7315000,-4890000
27414,2020-08-15,436,Capital Call,-10000,-12215000,7315000,-4900000
27414,2020-08-15,436,Distribution,375000,-12215000,7690000,-4525000
27414,2020-09-30,436,Value,8460000,-12215000,7690000,-4525000
27414,2020-11-15,436,Capital Call,-70000,-12285000,7690000,-4595000
27414,2020-11-15,436,Distribution,215000,-12285000,7905000,-4380000
27414,2020-12-31,436,Value,8764990,-12285000,7905000,-4380000
27414,2021-02-14,436,Capital Call,-5000,-12290000,7905000,-4385000
27414,2021-02-14,436,Distribution,525000,-12290000,8430000,-3860000
27414,2021-03-31,436,Value,8814990,-12290000,8430000,-3860000
27414,2021-05-16,436,Capital Call,-5000,-12295000,8430000,-3865000
27414,2021-05-16,436,Distribution,565000,-12295000,8995000,-3300000
27414,2021-06-30,436,Value,8349990,-12295000,8995000,-3300000
27414,2021-08-15,436,Capital Call,-10000,-12305000,8995000,-3310000
27414,2021-08-15,436,Distribution,265000,-12305000,9260000,-3045000
27414,2021-09-30,436,Value,7954990,-12305000,9260000,-3045000
27447,2020-03-31,672,Value,6801570,-9330000,7482660,-1847340
27447,2020-05-16,672,Capital Call,-20000,-9350000,7482660,-1867340
27447,2020-05-16,672,Distribution,-2660,-9350000,7480000,-1870000
27447,2020-06-30,672,Value,6844200,-9350000,7480000,-1870000
27447,2020-08-15,672,Capital Call,-60000,-9410000,7480000,-1930000
27447,2020-08-15,672,Distribution,245610,-9410000,7725610,-1684390
27447,2020-09-30,672,Value,7001040,-9410000,7725610,-1684390
27447,2020-11-15,672,Distribution,272890,-9410000,7998500,-1411500
27447,2020-12-31,672,Value,7575050,-9410000,7998500,-1411500
27447,2021-02-14,672,Distribution,639880,-9410000,8638380,-771620
27447,2021-03-31,672,Value,7669150,-9410000,8638380,-771620
27447,2021-05-16,672,Distribution,988050,-9410000,9626430,216430
27447,2021-06-30,672,Value,7358620,-9410000,9626430,216430
27447,2021-08-15,672,Distribution,1336220,-9410000,10962650,1552650
27447,2021-09-30,672,Value,6370570,-9410000,10962650,1552650
27475,2020-03-31,600,Value,3427220,-8584581,9663405,1078824
27475,2020-05-16,600,Capital Call,-169674,-8754255,9663405,909150
27475,2020-05-16,600,Distribution,1058335,-8754255,10721740,1967485
27475,2020-06-30,600,Value,3466980,-8754255,10721740,1967485
27479,2020-02-15,668,Capital Call,-80706,-8679339,10896720,2217381
27479,2020-02-15,668,Distribution,51207,-8679339,10947927,2268588
27479,2020-03-31,668,Value,7886230,-8679339,10947927,2268588
27479,2020-05-16,668,Capital Call,-4569,-8683908,10947927,2264019
27479,2020-05-16,668,Distribution,1286696,-8683908,12234623,3550715
27479,2020-06-30,668,Value,7391000,-8683908,12234623,3550715
27479,2020-08-15,668,Capital Call,-65342,-8749250,12234623,3485373
27479,2020-08-15,668,Distribution,3262456,-8749250,15497079,6747829
27479,2020-09-30,668,Value,5326130,-8749250,15497079,6747829
27479,2020-11-15,668,Capital Call,-31925,-8781175,15497079,6715904
27479,2020-11-15,668,Distribution,1465409,-8781175,16962488,8181313
27479,2020-12-31,668,Value,5078250,-8781175,16962488,8181313
27479,2021-02-14,668,Capital Call,-51275,-8832450,16962488,8130038
27479,2021-02-14,668,Distribution,2105364,-8832450,19067852,10235402
27479,2021-03-31,668,Value,3454890,-8832450,19067852,10235402
27479,2021-05-16,668,Distribution,22230,-8832450,19090082,10257632
27479,2021-06-30,668,Value,3785960,-8832450,19090082,10257632
27633,2020-03-31,52720,Value,2783190,-7744000,43067481,35323481
27633,2020-05-16,52720,Distribution,171917,-7744000,43239398,35495398
27633,2020-06-30,52720,Value,2676320,-7744000,43239398,35495398
27667,2020-03-31,1360,Value,9602670,-9172767,7680186,-1492581
27725,2020-01-15,54294,Capital Call,0,-9662438,5000000,-4662438
27725,2020-02-29,54294,Value,58218050,-9662438,5000000,-4662438
27725,2020-04-15,54294,Capital Call,0,-9662438,5000000,-4662438
27725,2020-05-31,54294,Value,57925650,-9662438,5000000,-4662438
27725,2020-07-16,54294,Capital Call,-337561,-9999999,5000000,-4999999
27725,2020-08-31,54294,Value,64970250,-9999999,5000000,-4999999
27725,2020-11-30,54294,Value,75213660,-9999999,5000000,-4999999
27725,2021-02-28,54294,Value,80902320,-9999999,5000000,-4999999
27725,2021-05-31,54294,Value,131069580,-9999999,5000000,-4999999
27725,2021-07-16,54294,Distribution,25424959,-9999999,30424959,20424960
27725,2021-08-31,54294,Value,172275020,-9999999,30424959,20424960
27725,2021-10-16,54294,Capital Call,0,-9999999,30424959,20424960
27725,2021-10-16,54294,Distribution,50938698,-9999999,81363657,71363658
27725,2021-11-30,54294,Value,183869660,-9999999,81363657,71363658
27880,2020-02-15,24,Distribution,110285,-9700000,2991794,-6708206
27880,2020-03-31,24,Value,12828570,-9700000,2991794,-6708206
27880,2020-05-16,24,Capital Call,-1000,-9701000,2991794,-6709206
27880,2020-05-16,24,Distribution,-4,-9701000,2991790,-6709210
27880,2020-06-30,24,Value,13988840,-9701000,2991790,-6709210
27880,2020-08-15,24,Capital Call,1000,-9700000,2991790,-6708210
27880,2020-08-15,24,Distribution,280992,-9700000,3272782,-6427218
27880,2020-09-30,24,Value,14348240,-9700000,3272782,-6427218
27880,2020-11-15,24,Capital Call,0,-9700000,3272782,-6427218
27880,2020-11-15,24,Distribution,821292,-9700000,4094074,-5605926
27880,2020-12-31,24,Value,16391780,-9700000,4094074,-5605926
27880,2021-02-14,24,Capital Call,0,-9700000,4094074,-5605926
27880,2021-02-14,24,Distribution,463958,-9700000,4558032,-5141968
27880,2021-03-31,24,Value,16300850,-9700000,4558032,-5141968
27880,2021-05-16,24,Distribution,97970,-9700000,4656002,-5043998
27880,2021-06-30,24,Value,17197130,-9700000,4656002,-5043998
27880,2021-08-15,24,Distribution,1644150,-9700000,6300152,-3399848
27880,2021-09-30,24,Value,15015600,-9700000,6300152,-3399848
27884,2020-03-31,24,Value,6851410,-8950000,5771456,-3178544
27884,2020-05-16,24,Capital Call,0,-8950000,5771456,-3178544
27884,2020-05-16,24,Distribution,286800,-8950000,6058256,-2891744
27884,2020-06-30,24,Value,6935350,-8950000,6058256,-2891744
27884,2020-08-15,24,Distribution,483300,-8950000,6541556,-2408444
27884,2020-09-30,24,Value,6675800,-8950000,6541556,-2408444
27884,2020-11-15,24,Capital Call,0,-8950000,6541556,-2408444
27884,2020-11-15,24,Distribution,169,-8950000,6541725,-2408275
27884,2020-12-31,24,Value,7222200,-8950000,6541725,-2408275
27884,2021-02-14,24,Capital Call,0,-8950000,6541725,-2408275
27884,2021-02-14,24,Distribution,131396,-8950000,6673121,-2276879
27884,2021-03-31,24,Value,7895690,-8950000,6673121,-2276879
27884,2021-05-16,24,Distribution,312355,-8950000,6985476,-1964524
27884,2021-06-30,24,Value,8267110,-8950000,6985476,-1964524
27884,2021-08-15,24,Distribution,1210040,-8950000,8195516,-754484
27884,2021-09-30,24,Value,7638820,-8950000,8195516,-754484
27885,2020-02-15,24,Distribution,352032,-10000000,4531774,-5468226
27885,2020-03-31,24,Value,15545180,-10000000,4531774,-5468226
27885,2020-05-16,24,Capital Call,0,-10000000,4531774,-5468226
27885,2020-05-16,24,Distribution,227,-10000000,4532001,-5467999
27885,2020-06-30,24,Value,17296000,-10000000,4532001,-5467999
27885,2020-08-15,24,Distribution,226000,-10000000,4758001,-5241999
27885,2020-09-30,24,Value,28107000,-10000000,4758001,-5241999
27885,2020-11-15,24,Capital Call,0,-10000000,4758001,-5241999
27885,2020-11-15,24,Distribution,921933,-10000000,5679934,-4320066
27885,2020-12-31,24,Value,30991330,-10000000,5679934,-4320066
27885,2021-02-14,24,Capital Call,0,-10000000,5679934,-4320066
27885,2021-02-14,24,Distribution,6527067,-10000000,12207001,2207001
27885,2021-03-31,24,Value,26300000,-10000000,12207001,2207001
27885,2021-05-16,24,Distribution,2846000,-10000000,15053001,5053001
27885,2021-06-30,24,Value,32190000,-10000000,15053001,5053001
27885,2021-08-15,24,Distribution,4017000,-10000000,19070001,9070001
27885,2021-09-30,24,Value,31770000,-10000000,19070001,9070001
27922,2020-02-15,7951,Capital Call,0,-10402789,14678363,4275574
27922,2020-02-15,7951,Distribution,46213,-10402789,14724576,4321787
27922,2020-03-31,7951,Value,1938020,-10402789,14724576,4321787
27922,2020-05-16,7951,Capital Call,-6889,-10409678,14724576,4314898
27922,2020-05-16,7951,Distribution,157616,-10409678,14882192,4472514
27922,2020-06-30,7951,Value,2085580,-10409678,14882192,4472514
27922,2020-08-15,7951,Capital Call,-2330,-10412008,14882192,4470184
27922,2020-08-15,7951,Distribution,423461,-10412008,15305653,4893645
27922,2020-09-30,7951,Value,1926220,-10412008,15305653,4893645
27922,2020-11-15,7951,Distribution,249888,-10412008,15555541,5143533
27922,2020-12-31,7951,Value,1752340,-10412008,15555541,5143533
27922,2021-02-14,7951,Capital Call,-5024,-10417032,15555541,5138509
27922,2021-02-14,7951,Distribution,131734,-10417032,15687275,5270243
27922,2021-03-31,7951,Value,1969470,-10417032,15687275,5270243
27922,2021-05-16,7951,Capital Call,-1967,-10418999,15687275,5268276
27922,2021-05-16,7951,Distribution,2697,-10418999,15689972,5270973
27922,2021-06-30,7951,Value,2022320,-10418999,15689972,5270973
27922,2021-08-15,7951,Capital Call,-6000,-10424999,15689972,5264973
27922,2021-08-15,7951,Distribution,467735,-10424999,16157707,5732708
27922,2021-09-30,7951,Value,1531430,-10424999,16157707,5732708
27956,2020-03-31,681,Value,9786840,-9700000,3215867,-6484133
27956,2020-06-30,681,Value,10524940,-9700000,3215867,-6484133
27956,2020-08-15,681,Capital Call,-100000,-9800000,3215867,-6584133
27956,2020-09-30,681,Value,11449000,-9800000,3215867,-6584133
27956,2020-12-31,681,Value,12703590,-9800000,3215867,-6584133
27956,2021-02-14,681,Distribution,1660013,-9800000,4875880,-4924120
27956,2021-03-31,681,Value,9886400,-9800000,4875880,-4924120
27956,2021-05-16,681,Distribution,803600,-9800000,5679480,-4120520
27956,2021-06-30,681,Value,9010360,-9800000,5679480,-4120520
28038,2020-03-31,906,Value,25612460,-9850000,8966213,-883787
28038,2020-05-16,906,Distribution,2066560,-9850000,11032773,1182773
28038,2020-06-30,906,Value,21584310,-9850000,11032773,1182773
28038,2020-09-30,906,Value,33880650,-9850000,11032773,1182773
28038,2020-11-15,906,Distribution,8912609,-9850000,19945382,10095382
28038,2020-12-31,906,Value,39430940,-9850000,19945382,10095382
28038,2021-02-14,906,Distribution,3241501,-9850000,23186883,13336883
28038,2021-03-31,906,Value,40314300,-9850000,23186883,13336883
28146,2020-02-15,6657,Capital Call,-85892,-9989812,5497371,-4492441
28146,2020-03-31,6657,Value,13863080,-9989812,5497371,-4492441
28146,2020-05-16,6657,Capital Call,-15315,-10005127,5497371,-4507756
28146,2020-06-30,6657,Value,13814050,-10005127,5497371,-4507756
28146,2020-08-15,6657,Capital Call,-3368,-10008495,5497371,-4511124
28146,2020-08-15,6657,Distribution,1991,-10008495,5499362,-4509133
28146,2020-09-30,6657,Value,14277550,-10008495,5499362,-4509133
28146,2020-11-15,6657,Capital Call,-4800,-10013295,5499362,-4513933
28146,2020-12-31,6657,Value,17170480,-10013295,5499362,-4513933
28146,2021-03-31,6657,Value,17261460,-10013295,5499362,-4513933
28146,2021-05-16,6657,Distribution,593921,-10013295,6093283,-3920012
28146,2021-06-30,6657,Value,20075000,-10013295,6093283,-3920012
28217,2020-03-31,674,Capital Call,-149542,-11263612,7681953,-3581659
28217,2020-03-31,674,Distribution,976133,-11263612,8658086,-2605526
28217,2020-06-30,674,Value,11903020,-11263612,8658086,-2605526
28217,2020-08-15,674,Capital Call,-28503,-11292115,8658086,-2634029
28217,2020-08-15,674,Distribution,164387,-11292115,8822473,-2469642
28217,2020-09-30,674,Value,12729480,-11292115,8822473,-2469642
28217,2020-11-15,674,Capital Call,-17855,-11309970,8822473,-2487497
28217,2020-11-15,674,Distribution,923718,-11309970,9746191,-1563779
28217,2020-12-31,674,Value,14763570,-11309970,9746191,-1563779
28217,2021-02-14,674,Capital Call,-20484,-11330454,9746191,-1584263
28217,2021-02-14,674,Distribution,315804,-11330454,10061995,-1268459
28217,2021-03-31,674,Value,16984490,-11330454,10061995,-1268459
28217,2021-05-16,674,Capital Call,-133049,-11463503,10061995,-1401508
28217,2021-05-16,674,Distribution,413175,-11463503,10475170,-988333
28217,2021-06-30,674,Value,16972030,-11463503,10475170,-988333
28217,2021-09-30,674,Value,16972030,-11463503,10475170,-988333
28221,2020-02-15,10266,Capital Call,-665218,-10658995,11898947,1239952
28221,2020-02-15,10266,Distribution,28024,-10658995,11926971,1267976
28221,2020-03-31,10266,Value,5564560,-10658995,11926971,1267976
28221,2020-06-30,10266,Value,5923420,-10658995,11926971,1267976
28221,2020-09-30,10266,Value,7817620,-10658995,11926971,1267976
28221,2020-12-31,10266,Value,9329720,-10658995,11926971,1267976
28221,2021-03-31,10266,Value,11057450,-10658995,11926971,1267976
28221,2021-05-16,10266,Capital Call,-17336,-10676331,11926971,1250640
28221,2021-05-16,10266,Distribution,991313,-10676331,12918284,2241953
28221,2021-06-30,10266,Value,12738810,-10676331,12918284,2241953
28258,2020-03-31,357,Value,7953910,-8940998,10677343,1736345
28258,2020-05-16,357,Capital Call,-356000,-9296998,10677343,1380345
28258,2020-05-16,357,Distribution,262,-9296998,10677605,1380607
28258,2020-06-30,357,Value,8270610,-9296998,10677605,1380607
28258,2020-08-15,357,Capital Call,21528,-9275470,10677605,1402135
28258,2020-08-15,357,Distribution,1612962,-9275470,12290567,3015097
28258,2020-09-30,357,Value,7807540,-9275470,12290567,3015097
28258,2020-11-15,357,Distribution,2788679,-9275470,15079246,5803776
28258,2020-12-31,357,Value,4739620,-9275470,15079246,5803776
28258,2021-02-14,357,Capital Call,-24528,-9299998,15079246,5779248
28258,2021-02-14,357,Distribution,42555,-9299998,15121801,5821803
28258,2021-03-31,357,Value,4761600,-9299998,15121801,5821803
28258,2021-06-30,357,Value,5077800,-9299998,15121801,5821803
28258,2021-08-15,357,Distribution,1422900,-9299998,16544701,7244703
28258,2021-09-30,357,Value,3654900,-9299998,16544701,7244703
28434,2020-06-30,16986,Value,14017990,-10095933,4069236,-6026697
28590,2020-02-15,437,Capital Call,-75403,-9500000,11121024,1621024
28590,2020-02-15,437,Distribution,-196024,-9500000,10925000,1425000
28590,2020-03-31,437,Value,4180000,-9500000,10925000,1425000
28590,2020-05-16,437,Capital Call,-233763,-9733763,10925000,1191237
28590,2020-05-16,437,Distribution,171490,-9733763,11096490,1362727
28590,2020-06-30,437,Value,4535930,-9733763,11096490,1362727
28590,2020-08-15,437,Capital Call,-66237,-9800000,11096490,1296490
28590,2020-08-15,437,Distribution,-120490,-9800000,10976000,1176000
28590,2020-09-30,437,Value,3430000,-9800000,10976000,1176000
28590,2020-12-31,437,Value,3724000,-9800000,10976000,1176000
28590,2021-07-02,437,Distribution,-98000,-9800000,10878000,1078000
28590,2021-12-31,437,Value,3626000,-9800000,10878000,1078000
28673,2020-03-31,632,Value,8975000,-10300001,5275000,-5025001
28673,2020-07-01,632,Capital Call,-75000,-10375001,5275000,-5100001
28673,2020-09-30,632,Value,9475000,-10375001,5275000,-5100001
28700,2020-06-30,60408,Value,8311840,-12413553,14623093,2209540
28700,2020-09-30,60408,Value,8451120,-12413553,14623093,2209540
28700,2020-12-31,60408,Value,8294820,-12413553,14623093,2209540
28700,2021-03-31,60408,Value,9112200,-12413553,14623093,2209540
28717,2020-03-31,14429,Value,4421260,-9700000,11390710,1690710
28717,2020-09-30,14429,Value,4295160,-9700000,11390710,1690710
28717,2020-11-15,14429,Distribution,692580,-9700000,12083290,2383290
28717,2020-12-31,14429,Value,3671450,-9700000,12083290,2383290
28717,2021-02-14,14429,Distribution,3127280,-9700000,15210570,5510570
28717,2021-03-31,14429,Value,4080790,-9700000,15210570,5510570
28743,2020-02-15,1973,Distribution,22000,-10014000,476000,-9538000
28743,2020-03-31,1973,Value,11508000,-10014000,476000,-9538000
28743,2020-06-30,1973,Value,11612000,-10014000,476000,-9538000
28743,2020-09-30,1973,Value,8328000,-10014000,476000,-9538000
28743,2020-12-31,1973,Value,8468000,-10014000,476000,-9538000
28743,2021-03-31,1973,Value,11158000,-10014000,476000,-9538000
28743,2021-05-16,1973,Distribution,20000,-10014000,496000,-9518000
28743,2021-06-30,1973,Value,7418000,-10014000,496000,-9518000
28743,2021-08-15,1973,Capital Call,-240000,-10254000,496000,-9758000
28743,2021-08-15,1973,Distribution,8632000,-10254000,9128000,-1126000
28743,2021-09-30,1973,Value,4175230,-10254000,9128000,-1126000
28761,2020-03-31,384,Value,8550000,-9499999,8265000,-1234999
28761,2020-05-16,384,Distribution,4085000,-9499999,12350000,2850001
28761,2020-06-30,384,Value,4750000,-9499999,12350000,2850001
28761,2020-09-30,384,Value,5035000,-9499999,12350000,2850001
28761,2020-12-31,384,Value,5605000,-9499999,12350000,2850001
28761,2021-02-14,384,Distribution,1140000,-9499999,13490000,3990001
28761,2021-03-31,384,Value,5225000,-9499999,13490000,3990001
28761,2021-05-16,384,Distribution,1995000,-9499999,15485000,5985001
28761,2021-06-30,384,Value,3610000,-9499999,15485000,5985001
28761,2021-08-15,384,Distribution,380000,-9499999,15865000,6365001
28761,2021-09-30,384,Value,3705000,-9499999,15865000,6365001
28761,2021-11-15,384,Distribution,855000,-9499999,16720000,7220001
28761,2021-12-31,384,Value,2945000,-9499999,16720000,7220001
28849,2020-02-15,2115,Capital Call,-580485,-10777794,11227156,449362
28849,2020-02-15,2115,Distribution,34120,-10777794,11261276,483482
28849,2020-03-31,2115,Value,2847850,-10777794,11261276,483482
28849,2020-05-16,2115,Capital Call,-50000,-10827794,11261276,433482
28849,2020-05-16,2115,Distribution,315581,-10827794,11576857,749063
28849,2020-06-30,2115,Value,2554230,-10827794,11576857,749063
28849,2020-09-30,2115,Value,2536640,-10827794,11576857,749063
28849,2020-12-31,2115,Value,2729340,-10827794,11576857,749063
28849,2021-02-14,2115,Capital Call,-75577,-10903371,11576857,673486
28849,2021-02-14,2115,Distribution,541964,-10903371,12118821,1215450
28849,2021-03-31,2115,Value,1891910,-10903371,12118821,1215450
28849,2021-05-16,2115,Distribution,767199,-10903371,12886020,1982649
28849,2021-06-30,2115,Value,2284600,-10903371,12886020,1982649
28957,2020-03-31,23839,Capital Call,-205000,-11503001,10289090,-1213911
28957,2020-03-31,23839,Distribution,805555,-11503001,11094645,-408356
28957,2020-09-30,23839,Value,5496130,-11503001,11094645,-408356
28957,2020-11-15,23839,Capital Call,-8830,-11511831,11094645,-417186
28957,2020-11-15,23839,Distribution,109821,-11511831,11204466,-307365
28957,2020-12-31,23839,Value,5798500,-11511831,11204466,-307365
28957,2021-02-14,23839,Capital Call,-39490,-11551321,11204466,-346855
28957,2021-02-14,23839,Distribution,122296,-11551321,11326762,-224559
28957,2021-03-31,23839,Value,6106660,-11551321,11326762,-224559
28957,2021-05-16,23839,Capital Call,320,-11551001,11326762,-224239
28957,2021-05-16,23839,Distribution,151,-11551001,11326913,-224088
28957,2021-06-30,23839,Value,6685710,-11551001,11326913,-224088
29019,2020-03-31,9498,Value,0,-8887576,15883417,6995841
29019,2020-06-30,9498,Value,0,-8887576,15883417,6995841
29019,2020-09-30,9498,Value,0,-8887576,15883417,6995841
29019,2020-12-31,9498,Value,0,-8887576,15883417,6995841
29019,2021-03-31,9498,Value,0,-8887576,15883417,6995841
29019,2021-06-30,9498,Value,0,-8887576,15883417,6995841
29019,2021-09-30,9498,Value,0,-8887576,15883417,6995841
29019,2021-12-31,9498,Value,0,-8887576,15883417,6995841
29071,2020-03-31,813,Value,12756280,-8952441,4110135,-4842306
29071,2020-05-16,813,Capital Call,-521632,-9474073,4110135,-5363938
29071,2020-06-30,813,Value,11784580,-9474073,4110135,-5363938
29071,2020-09-30,813,Value,12142400,-9474073,4110135,-5363938
29071,2020-11-15,813,Capital Call,0,-9474073,4110135,-5363938
29071,2020-11-15,813,Distribution,5229141,-9474073,9339276,-134797
29071,2020-12-31,813,Value,7500530,-9474073,9339276,-134797
29071,2021-02-14,813,Capital Call,0,-9474073,9339276,-134797
29071,2021-02-14,813,Distribution,0,-9474073,9339276,-134797
29071,2021-03-31,813,Value,7500530,-9474073,9339276,-134797
29071,2021-06-30,813,Value,8188540,-9474073,9339276,-134797
29071,2021-08-15,813,Distribution,3303230,-9474073,12642506,3168433
29071,2021-09-30,813,Value,5757100,-9474073,12642506,3168433
29076,2020-02-15,739,Distribution,1422834,-10619374,17058660,6439286
29076,2020-03-31,739,Value,4044330,-10619374,17058660,6439286
29076,2020-06-30,739,Value,4044330,-10619374,17058660,6439286
29076,2020-09-30,739,Value,4954110,-10619374,17058660,6439286
29076,2020-12-31,739,Value,5180660,-10619374,17058660,6439286
29076,2021-03-31,739,Value,5983150,-10619374,17058660,6439286
29076,2021-05-16,739,Capital Call,1373626,-9245748,17058660,7812912
29076,2021-06-30,739,Value,6406880,-9245748,17058660,7812912
29095,2020-03-31,134353,Value,8626410,-9499612,19358846,9859234
29095,2020-05-21,134353,Distribution,498706,-9499612,19857552,10357940
29095,2020-07-13,134353,Distribution,376382,-9499612,20233934,10734322
29095,2020-09-30,134353,Value,9497280,-9499612,20233934,10734322
29095,2020-12-21,134353,Distribution,771583,-9499612,21005517,11505905
29095,2020-12-31,134353,Value,9232090,-9499612,21005517,11505905
29095,2021-04-13,134353,Distribution,576823,-9499612,21582340,12082728
29095,2021-06-30,134353,Value,11869360,-9499612,21582340,12082728
29129,2020-06-30,60869,Value,11765770,-10739076,7613000,-3126076
29147,2020-02-15,1430,Capital Call,-100000,-9800000,7404419,-2395581
29147,2020-02-15,1430,Distribution,1059116,-9800000,8463535,-1336465
29147,2020-03-31,1430,Value,10652480,-9800000,8463535,-1336465
29147,2020-05-16,1430,Distribution,549724,-9800000,9013259,-786741
29147,2020-06-30,1430,Value,10913810,-9800000,9013259,-786741
29147,2020-08-15,1430,Distribution,247514,-9800000,9260773,-539227
29147,2020-09-30,1430,Value,10015460,-9800000,9260773,-539227
29147,2020-11-15,1430,Distribution,569613,-9800000,9830386,30386
29147,2020-12-31,1430,Value,12848610,-9800000,9830386,30386
29147,2021-03-31,1430,Value,17129830,-9800000,9830386,30386
29147,2021-05-16,1430,Distribution,659669,-9800000,10490055,690055
29147,2021-06-30,1430,Value,17562980,-9800000,10490055,690055
29188,2020-02-15,7976,Capital Call,-42000,-10954997,10313878,-641119
29188,2020-02-15,7976,Distribution,102138,-10954997,10416016,-538981
29188,2020-03-31,7976,Value,11002100,-10954997,10416016,-538981
29188,2020-05-16,7976,Capital Call,-47000,-11001997,10416016,-585981
29188,2020-05-16,7976,Distribution,1798406,-11001997,12214422,1212425
29188,2020-06-30,7976,Value,9877590,-11001997,12214422,1212425
29188,2020-08-15,7976,Capital Call,-89000,-11090997,12214422,1123425
29188,2020-08-15,7976,Distribution,25607,-11090997,12240029,1149032
29188,2020-09-30,7976,Value,9989660,-11090997,12240029,1149032
29188,2020-11-15,7976,Capital Call,-34000,-11124997,12240029,1115032
29188,2020-11-15,7976,Distribution,454710,-11124997,12694739,1569742
29188,2020-12-31,7976,Value,10508670,-11124997,12694739,1569742
29188,2021-02-14,7976,Capital Call,-57000,-11181997,12694739,1512742
29188,2021-02-14,7976,Distribution,1638350,-11181997,14333089,3151092
29188,2021-03-31,7976,Value,10025780,-11181997,14333089,3151092
29188,2021-05-16,7976,Capital Call,-18000,-11199997,14333089,3133092
29188,2021-05-16,7976,Distribution,129472,-11199997,14462561,3262564
29188,2021-06-30,7976,Value,11345600,-11199997,14462561,3262564
29188,2021-08-15,7976,Capital Call,-24000,-11223997,14462561,3238564
29188,2021-08-15,7976,Distribution,467605,-11223997,14930166,3706169
29188,2021-09-30,7976,Value,11304810,-11223997,14930166,3706169
29203,2020-02-15,18,Capital Call,0,-7985001,5012979,-2972022
29203,2020-02-15,18,Distribution,4,-7985001,5012983,-2972018
29203,2020-03-31,18,Value,6397580,-7985001,5012983,-2972018
29203,2020-05-16,18,Distribution,394459,-7985001,5407442,-2577559
29203,2020-06-30,18,Value,6354460,-7985001,5407442,-2577559
29203,2020-09-30,18,Value,7170530,-7985001,5407442,-2577559
29203,2020-11-15,18,Capital Call,-300000,-8285001,5407442,-2877559
29203,2020-11-15,18,Distribution,656350,-8285001,6063792,-2221209
29203,2020-12-31,18,Value,7937030,-8285001,6063792,-2221209
29203,2021-02-14,18,Distribution,421706,-8285001,6485498,-1799503
29203,2021-03-31,18,Value,7889800,-8285001,6485498,-1799503
29203,2021-05-16,18,Distribution,531391,-8285001,7016889,-1268112
29203,2021-06-30,18,Value,8376130,-8285001,7016889,-1268112
29203,2021-08-15,18,Distribution,539859,-8285001,7556748,-728253
29203,2021-09-30,18,Value,8940340,-8285001,7556748,-728253
29204,2020-02-15,18,Capital Call,0,-9290000,2447915,-6842085
29204,2020-02-15,18,Distribution,291318,-9290000,2739233,-6550767
29204,2020-03-31,18,Value,12832160,-9290000,2739233,-6550767
29204,2020-06-30,18,Value,15680270,-9290000,2739233,-6550767
29204,2020-08-15,18,Distribution,1096248,-9290000,3835481,-5454519
29204,2020-09-30,18,Value,15173180,-9290000,3835481,-5454519
29204,2020-11-15,18,Distribution,555062,-9290000,4390543,-4899457
29204,2020-12-31,18,Value,20682530,-9290000,4390543,-4899457
29204,2021-02-14,18,Distribution,388544,-9290000,4779087,-4510913
29204,2021-03-31,18,Value,20244030,-9290000,4779087,-4510913
29204,2021-05-16,18,Capital Call,0,-9290000,4779087,-4510913
29204,2021-05-16,18,Distribution,617210,-9290000,5396297,-3893703
29204,2021-06-30,18,Value,20593140,-9290000,5396297,-3893703
29204,2021-08-15,18,Distribution,1096484,-9290000,6492781,-2797219
29204,2021-09-30,18,Value,17420600,-9290000,6492781,-2797219
29218,2020-02-15,461,Distribution,228009,-9850000,22880426,13030426
29218,2020-03-31,461,Value,13745860,-9850000,22880426,13030426
29218,2020-06-30,461,Value,12849430,-9850000,22880426,13030426
29218,2020-09-30,461,Value,15496650,-9850000,22880426,13030426
29218,2020-11-15,461,Distribution,263163,-9850000,23143589,13293589
29218,2020-12-31,461,Value,21715190,-9850000,23143589,13293589
29218,2021-03-31,461,Value,25594810,-9850000,23143589,13293589
29218,2021-05-16,461,Distribution,1159227,-9850000,24302816,14452816
29218,2021-06-30,461,Value,33047970,-9850000,24302816,14452816
29240,2020-02-15,1718,Distribution,658000,-9400000,15698000,6298000
29240,2020-03-31,1718,Value,2350000,-9400000,15698000,6298000
29240,2020-06-30,1718,Value,2538000,-9400000,15698000,6298000
29240,2020-08-15,1718,Distribution,94000,-9400000,15792000,6392000
29240,2020-09-30,1718,Value,2538000,-9400000,15792000,6392000
29240,2020-12-31,1718,Value,2820000,-9400000,15792000,6392000
29240,2021-02-14,1718,Distribution,470000,-9400000,16262000,6862000
29240,2021-03-31,1718,Value,2444000,-9400000,16262000,6862000
29240,2021-06-30,1718,Value,2820000,-9400000,16262000,6862000
29240,2021-09-30,1718,Value,2820000,-9400000,16262000,6862000
29240,2021-12-31,1718,Value,3572000,-9400000,16262000,6862000
29258,2020-02-15,46046,Capital Call,-3000,-8710000,2295166,-6414834
29258,2020-02-15,46046,Distribution,1265483,-8710000,3560649,-5149351
29258,2020-03-31,46046,Value,5813920,-8710000,3560649,-5149351
29258,2020-05-16,46046,Capital Call,-38000,-8748000,3560649,-5187351
29258,2020-05-16,46046,Distribution,14660,-8748000,3575309,-5172691
29258,2020-06-30,46046,Value,5265420,-8748000,3575309,-5172691
29258,2020-08-15,46046,Capital Call,2000,-8746000,3575309,-5170691
29258,2020-08-15,46046,Distribution,160984,-8746000,3736293,-5009707
29258,2020-09-30,46046,Value,5049940,-8746000,3736293,-5009707
29258,2020-12-31,46046,Value,5017580,-8746000,3736293,-5009707
29258,2021-02-14,46046,Capital Call,-35000,-8781000,3736293,-5044707
29258,2021-02-14,46046,Distribution,13196,-8781000,3749489,-5031511
29258,2021-03-31,46046,Value,5039410,-8781000,3749489,-5031511
29258,2021-06-30,46046,Value,5714670,-8781000,3749489,-5031511
29258,2021-08-15,46046,Capital Call,-97000,-8878000,3749489,-5128511
29258,2021-08-15,46046,Distribution,2356,-8878000,3751845,-5126155
29258,2021-09-30,46046,Value,5917180,-8878000,3751845,-5126155
29317,2020-02-15,9036,Capital Call,-13699,-10378886,6322553,-4056333
29317,2020-02-15,9036,Distribution,240358,-10378886,6562911,-3815975
29317,2020-03-31,9036,Value,10351070,-10378886,6562911,-3815975
29317,2020-05-16,9036,Capital Call,-40173,-10419059,6562911,-3856148
29317,2020-05-16,9036,Distribution,37817,-10419059,6600728,-3818331
29317,2020-06-30,9036,Value,9933850,-10419059,6600728,-3818331
29317,2020-09-30,9036,Value,10010850,-10419059,6600728,-3818331
29317,2020-11-15,9036,Capital Call,-101010,-10520069,6600728,-3919341
29317,2020-11-15,9036,Distribution,1193649,-10520069,7794377,-2725692
29317,2020-12-31,9036,Value,9319640,-10520069,7794377,-2725692
29317,2021-02-14,9036,Capital Call,-15937,-10536006,7794377,-2741629
29317,2021-02-14,9036,Distribution,917473,-10536006,8711850,-1824156
29317,2021-03-31,9036,Value,8789900,-10536006,8711850,-1824156
29317,2021-05-16,9036,Capital Call,-15937,-10551943,8711850,-1840093
29317,2021-05-16,9036,Distribution,563398,-10551943,9275248,-1276695
29317,2021-06-30,9036,Value,9170260,-10551943,9275248,-1276695
29317,2021-08-15,9036,Capital Call,-138020,-10689963,9275248,-1414715
29317,2021-08-15,9036,Distribution,609343,-10689963,9884591,-805372
29317,2021-09-30,9036,Value,9268820,-10689963,9884591,-805372
29325,2020-03-31,303,Value,10707920,-10000000,12466288,2466288
29325,2020-05-16,303,Distribution,75081,-10000000,12541369,2541369
29325,2020-06-30,303,Value,12612760,-10000000,12541369,2541369
29325,2020-09-30,303,Value,13843960,-10000000,12541369,2541369
29325,2020-11-15,303,Distribution,7102707,-10000000,19644076,9644076
29325,2020-12-31,303,Value,8609080,-10000000,19644076,9644076
29325,2021-02-14,303,Distribution,578651,-10000000,20222727,10222727
29325,2021-03-31,303,Value,8805730,-10000000,20222727,10222727
29325,2021-06-30,303,Value,8527910,-10000000,20222727,10222727
29431,2020-03-31,28819,Value,5550000,-10000000,3800000,-6200000
29431,2020-09-30,28819,Distribution,400000,-10000000,4200000,-5800000
29431,2021-03-31,28819,Value,7540000,-10000000,4200000,-5800000
29484,2020-01-15,2281,Capital Call,-45238,-10802265,1605914,-9196351
29484,2020-01-15,2281,Distribution,0,-10802265,1605914,-9196351
29484,2020-02-29,2281,Value,10955420,-10802265,1605914,-9196351
29484,2020-05-31,2281,Capital Call,-130952,-10933217,1605914,-9327303
29484,2020-05-31,2281,Distribution,0,-10933217,1605914,-9327303
29484,2020-08-31,2281,Value,10404980,-10933217,1605914,-9327303
29484,2020-10-16,2281,Capital Call,-35714,-10968931,1605914,-9363017
29484,2020-11-30,2281,Value,10256110,-10968931,1605914,-9363017
29484,2021-01-14,2281,Capital Call,-35714,-11004645,1605914,-9398731
29484,2021-02-28,2281,Value,11089190,-11004645,1605914,-9398731
29484,2021-04-15,2281,Capital Call,-42619,-11047264,1605914,-9441350
29484,2021-04-15,2281,Distribution,684523,-11047264,2290437,-8756827
29484,2021-05-31,2281,Value,10824610,-11047264,2290437,-8756827
29484,2021-07-16,2281,Capital Call,-39286,-11086550,2290437,-8796113
29484,2021-08-31,2281,Value,10975320,-11086550,2290437,-8796113
29484,2021-10-16,2281,Capital Call,-32024,-11118574,2290437,-8828137
29484,2021-10-16,2281,Distribution,1924105,-11118574,4214542,-6904032
29484,2021-11-30,2281,Value,8632870,-11118574,4214542,-6904032
29491,2020-02-15,54,Capital Call,-12347,-10580090,6601811,-3978279
29491,2020-02-15,54,Distribution,3063646,-10580090,9665457,-914633
29491,2020-03-31,54,Value,6288540,-10580090,9665457,-914633
29491,2020-05-16,54,Capital Call,-8102,-10588192,9665457,-922735
29491,2020-05-16,54,Distribution,50663,-10588192,9716120,-872072
29491,2020-06-30,54,Value,7844540,-10588192,9716120,-872072
29491,2020-08-15,54,Capital Call,-53859,-10642051,9716120,-925931
29491,2020-08-15,54,Distribution,1157088,-10642051,10873208,231157
29491,2020-09-30,54,Value,7142220,-10642051,10873208,231157
29491,2020-11-15,54,Capital Call,-3812,-10645863,10873208,227345
29491,2020-11-15,54,Distribution,1593941,-10645863,12467149,1821286
29491,2020-12-31,54,Value,6326490,-10645863,12467149,1821286
29491,2021-02-14,54,Capital Call,-8853,-10654716,12467149,1812433
29491,2021-02-14,54,Distribution,836791,-10654716,13303940,2649224
29491,2021-03-31,54,Value,6445030,-10654716,13303940,2649224
29491,2021-05-16,54,Capital Call,-2980,-10657696,13303940,2646244
29491,2021-05-16,54,Distribution,704285,-10657696,14008225,3350529
29491,2021-06-30,54,Value,6389510,-10657696,14008225,3350529
29533,2020-02-15,289,Capital Call,-577864,-10028516,3321147,-6707369
29533,2020-02-15,289,Distribution,15184,-10028516,3336331,-6692185
29533,2020-03-31,289,Value,7814720,-10028516,3336331,-6692185
29533,2020-05-16,289,Capital Call,-452986,-10481502,3336331,-7145171
29533,2020-05-16,289,Distribution,8178,-10481502,3344509,-7136993
29533,2020-06-30,289,Value,6413950,-10481502,3344509,-7136993
29533,2020-09-30,289,Capital Call,-271952,-10753454,3344509,-7408945
29533,2020-09-30,289,Distribution,214761,-10753454,3559270,-7194184
29533,2020-12-31,289,Value,6111040,-10753454,3559270,-7194184
29533,2021-02-14,289,Capital Call,-14332,-10767786,3559270,-7208516
29533,2021-02-14,289,Distribution,8802,-10767786,3568072,-7199714
29533,2021-03-31,289,Value,6107920,-10767786,3568072,-7199714
29533,2021-05-16,289,Capital Call,-281154,-11048940,3568072,-7480868
29533,2021-05-16,289,Distribution,18253,-11048940,3586325,-7462615
29533,2021-06-30,289,Value,6256860,-11048940,3586325,-7462615
29533,2021-08-15,289,Capital Call,-88510,-11137450,3586325,-7551125
29533,2021-08-15,289,Distribution,12185,-11137450,3598510,-7538940
29533,2021-09-30,289,Value,6711450,-11137450,3598510,-7538940
29565,2020-02-15,121,Distribution,73789,-12417254,5783721,-6633533
29565,2020-03-31,121,Value,8123600,-12417254,5783721,-6633533
29565,2020-05-16,121,Capital Call,-177326,-12594580,5783721,-6810859
29565,2020-05-16,121,Distribution,132649,-12594580,5916370,-6678210
29565,2020-06-30,121,Value,8693340,-12594580,5916370,-6678210
29565,2020-08-15,121,Capital Call,-64683,-12659263,5916370,-6742893
29565,2020-08-15,121,Distribution,5989,-12659263,5922359,-6736904
29565,2020-09-30,121,Value,8888970,-12659263,5922359,-6736904
29565,2020-11-15,121,Capital Call,-72476,-12731739,5922359,-6809380
29565,2020-11-15,121,Distribution,33493,-12731739,5955852,-6775887
29565,2020-12-31,121,Value,9576870,-12731739,5955852,-6775887
29565,2021-02-14,121,Capital Call,-156325,-12888064,5955852,-6932212
29565,2021-02-14,121,Distribution,50379,-12888064,6006231,-6881833
29565,2021-03-31,121,Value,10361610,-12888064,6006231,-6881833
29565,2021-06-30,121,Value,11392650,-12888064,6006231,-6881833
29654,2020-06-30,6093,Value,7427650,-8505467,6080348,-2425119
29829,2020-03-31,22829,Capital Call,-100000,-6700000,2500000,-4200000
29829,2020-03-31,22829,Distribution,1100000,-6700000,3600000,-3100000
29829,2020-09-30,22829,Value,5300000,-6700000,3600000,-3100000
29862,2020-03-31,81348,Value,8318580,-11836135,11997032,160897
29862,2020-05-16,81348,Capital Call,-110526,-11946661,11997032,50371
29862,2020-06-30,81348,Value,8487420,-11946661,11997032,50371
29970,2020-03-31,6963,Value,12285000,-9100000,5642000,-3458000
29970,2020-05-16,6963,Capital Call,-200000,-9300000,5642000,-3658000
29970,2020-05-16,6963,Distribution,124000,-9300000,5766000,-3534000
29970,2020-06-30,6963,Value,12369000,-9300000,5766000,-3534000
29970,2020-12-31,6963,Value,15345000,-9300000,5766000,-3534000
29970,2021-02-14,6963,Capital Call,-100000,-9400000,5766000,-3634000
29970,2021-02-14,6963,Distribution,9274000,-9400000,15040000,5640000
29970,2021-03-31,6963,Value,14100000,-9400000,15040000,5640000
29970,2021-05-16,6963,Distribution,282000,-9400000,15322000,5922000
29970,2021-06-30,6963,Value,16074000,-9400000,15322000,5922000
29970,2021-09-30,6963,Value,17202000,-9400000,15322000,5922000
29992,2020-02-15,6330,Distribution,1957511,-9607765,6456732,-3151033
29992,2020-03-31,6330,Value,8845510,-9607765,6456732,-3151033
29992,2020-06-30,6330,Value,8892370,-9607765,6456732,-3151033
29992,2020-09-30,6330,Value,8445200,-9607765,6456732,-3151033
29992,2020-11-15,6330,Distribution,137864,-9607765,6594596,-3013169
29992,2020-12-31,6330,Value,8125460,-9607765,6594596,-3013169
29992,2021-03-31,6330,Value,9145190,-9607765,6594596,-3013169
29992,2021-05-16,6330,Distribution,1224405,-9607765,7819001,-1788764
29992,2021-06-30,6330,Value,7546910,-9607765,7819001,-1788764
29992,2021-09-30,6330,Value,9896530,-9607765,7819001,-1788764
30025,2020-02-15,1886,Capital Call,-130000,-7620000,6360000,-1260000
30025,2020-02-15,1886,Distribution,720000,-7620000,7080000,-540000
30025,2020-03-31,1886,Value,8370150,-7620000,7080000,-540000
30025,2020-05-16,1886,Distribution,100000,-7620000,7180000,-440000
30025,2020-06-30,1886,Value,9652250,-7620000,7180000,-440000
30025,2020-08-15,1886,Capital Call,76000,-7544000,7180000,-364000
30025,2020-08-15,1886,Distribution,472634,-7544000,7652634,108634
30025,2020-09-30,1886,Value,9562020,-7544000,7652634,108634
30025,2020-11-15,1886,Distribution,1108968,-7544000,8761602,1217602
30025,2020-12-31,1886,Value,9047510,-7544000,8761602,1217602
30025,2021-02-14,1886,Capital Call,-100000,-7644000,8761602,1117602
30025,2021-02-14,1886,Distribution,818624,-7644000,9580226,1936226
30025,2021-03-31,1886,Value,9342490,-7644000,9580226,1936226
30025,2021-05-16,1886,Capital Call,100000,-7544000,9580226,2036226
30025,2021-05-16,1886,Distribution,420856,-7544000,10001082,2457082
30025,2021-06-30,1886,Value,9635190,-7544000,10001082,2457082
30025,2021-08-15,1886,Capital Call,-76000,-7620000,10001082,2381082
30025,2021-08-15,1886,Distribution,829919,-7620000,10831001,3211001
30025,2021-09-30,1886,Value,9396920,-7620000,10831001,3211001
30026,2020-03-31,1886,Value,6790520,-8505000,3970000,-4535000
30026,2020-05-16,1886,Distribution,134,-8505000,3970134,-4534866
30026,2020-06-30,1886,Value,6812500,-8505000,3970134,-4534866
30026,2020-08-15,1886,Distribution,449915,-8505000,4420049,-4084951
30026,2020-09-30,1886,Value,6934970,-8505000,4420049,-4084951
30026,2020-11-15,1886,Distribution,399735,-8505000,4819784,-3685216
30026,2020-12-31,1886,Value,7384890,-8505000,4819784,-3685216
30026,2021-02-14,1886,Distribution,599603,-8505000,5419387,-3085613
30026,2021-03-31,1886,Value,6762320,-8505000,5419387,-3085613
30026,2021-05-16,1886,Distribution,280665,-8505000,5700052,-2804948
30026,2021-06-30,1886,Value,7271770,-8505000,5700052,-2804948
30026,2021-08-15,1886,Distribution,300227,-8505000,6000279,-2504721
30026,2021-09-30,1886,Value,6879690,-8505000,6000279,-2504721
30029,2020-03-31,114,Value,5878740,-11604416,8749184,-2855232
30029,2020-05-16,114,Capital Call,-211610,-11816026,8749184,-3066842
30029,2020-05-16,114,Distribution,55475,-11816026,8804659,-3011367
30029,2020-06-30,114,Value,5561270,-11816026,8804659,-3011367
30029,2020-09-30,114,Value,5324060,-11816026,8804659,-3011367
30029,2020-11-15,114,Capital Call,-73362,-11889388,8804659,-3084729
30029,2020-11-15,114,Distribution,1117859,-11889388,9922518,-1966870
30029,2020-12-31,114,Value,4355810,-11889388,9922518,-1966870
30029,2021-03-31,114,Value,5338690,-11889388,9922518,-1966870
30029,2021-06-30,114,Value,6354270,-11889388,9922518,-1966870
30091,2020-02-15,14411,Capital Call,0,-9349137,14589579,5240442
30091,2020-02-15,14411,Distribution,0,-9349137,14589579,5240442
30091,2020-03-31,14411,Value,2553100,-9349137,14589579,5240442
30091,2020-05-16,14411,Capital Call,-4610,-9353747,14589579,5235832
30091,2020-05-16,14411,Distribution,151647,-9353747,14741226,5387479
30091,2020-06-30,14411,Value,2472390,-9353747,14741226,5387479
30091,2020-08-15,14411,Capital Call,-1139,-9354886,14741226,5386340
30091,2020-08-15,14411,Distribution,266316,-9354886,15007542,5652656
30091,2020-09-30,14411,Value,2196490,-9354886,15007542,5652656
30091,2020-11-15,14411,Capital Call,-11663,-9366549,15007542,5640993
30091,2020-11-15,14411,Distribution,100631,-9366549,15108173,5741624
30091,2020-12-31,14411,Value,2104020,-9366549,15108173,5741624
30091,2021-03-31,14411,Value,2133550,-9366549,15108173,5741624
30095,2020-02-15,14411,Capital Call,-78000,-8298000,8162000,-136000
30095,2020-02-15,14411,Distribution,256000,-8298000,8418000,120000
30095,2020-03-31,14411,Value,4604000,-8298000,8418000,120000
30095,2020-06-30,14411,Value,4394000,-8298000,8418000,120000
30095,2020-08-15,14411,Capital Call,-112000,-8410000,8418000,8000
30095,2020-08-15,14411,Distribution,296000,-8410000,8714000,304000
30095,2020-09-30,14411,Value,4158000,-8410000,8714000,304000
30095,2020-11-15,14411,Capital Call,-56000,-8466000,8714000,248000
30095,2020-11-15,14411,Distribution,326000,-8466000,9040000,574000
30095,2020-12-31,14411,Value,4060000,-8466000,9040000,574000
30101,2020-03-31,140,Value,9463610,-10355394,4559890,-5795504
30101,2020-05-16,140,Capital Call,-16581,-10371975,4559890,-5812085
30101,2020-05-16,140,Distribution,422893,-10371975,4982783,-5389192
30101,2020-06-30,140,Value,10959830,-10371975,4982783,-5389192
30101,2020-08-15,140,Capital Call,-94616,-10466591,4982783,-5483808
30101,2020-08-15,140,Distribution,418712,-10466591,5401495,-5065096
30101,2020-09-30,140,Value,10635730,-10466591,5401495,-5065096
30101,2020-11-15,140,Distribution,721179,-10466591,6122674,-4343917
30101,2020-12-31,140,Value,10310060,-10466591,6122674,-4343917
30101,2021-02-14,140,Distribution,495771,-10466591,6618445,-3848146
30101,2021-03-31,140,Value,11300040,-10466591,6618445,-3848146
30165,2020-01-15,139996,Capital Call,0,-10000000,0,-10000000
30165,2020-02-29,139996,Value,12355180,-10000000,0,-10000000
30165,2020-04-15,139996,Capital Call,0,-10000000,0,-10000000
30165,2020-05-31,139996,Value,13434480,-10000000,0,-10000000
30165,2020-08-31,139996,Value,13433420,-10000000,0,-10000000
30165,2020-11-30,139996,Value,13377340,-10000000,0,-10000000
30165,2021-02-28,139996,Value,13377340,-10000000,0,-10000000
30165,2021-05-31,139996,Value,14173560,-10000000,0,-10000000
30165,2021-07-16,139996,Capital Call,-5730,-10005730,0,-10005730
30165,2021-07-16,139996,Distribution,835215,-10005730,835215,-9170515
30165,2021-08-31,139996,Value,13282110,-10005730,835215,-9170515
30165,2021-10-16,139996,Capital Call,-2822,-10008552,835215,-9173337
30165,2021-10-16,139996,Distribution,263341,-10008552,1098556,-8909996
30165,2021-11-30,139996,Value,13855740,-10008552,1098556,-8909996
30192,2020-02-15,23,Distribution,359375,-10025005,10132816,107811
30192,2020-03-31,23,Value,5924990,-10025005,10132816,107811
30192,2020-05-16,23,Distribution,250000,-10025005,10382816,357811
30192,2020-06-30,23,Value,7214060,-10025005,10382816,357811
30192,2020-08-15,23,Distribution,215625,-10025005,10598441,573436
30192,2020-09-30,23,Value,7323430,-10025005,10598441,573436
30192,2020-11-15,23,Distribution,870313,-10025005,11468754,1443749
30192,2020-12-31,23,Value,7071870,-10025005,11468754,1443749
30192,2021-02-14,23,Distribution,431250,-10025005,11900004,1874999
30192,2021-03-31,23,Value,6698430,-10025005,11900004,1874999
30192,2021-05-16,23,Distribution,293750,-10025005,12193754,2168749
30192,2021-06-30,23,Value,7679680,-10025005,12193754,2168749
30192,2021-08-15,23,Capital Call,-156,-10025161,12193754,2168593
30192,2021-08-15,23,Distribution,1335781,-10025161,13529535,3504374
30192,2021-09-30,23,Value,5579370,-10025161,13529535,3504374
30204,2020-03-31,52659,Value,5529000,-9700000,8439000,-1261000
30204,2020-06-30,52659,Value,6305000,-9700000,8439000,-1261000
30204,2020-09-30,52659,Value,6499000,-9700000,8439000,-1261000
30204,2020-11-15,52659,Distribution,291000,-9700000,8730000,-970000
30204,2020-12-31,52659,Value,6790000,-9700000,8730000,-970000
30204,2021-03-31,52659,Value,6208000,-9700000,8730000,-970000
30204,2021-05-16,52659,Capital Call,-100000,-9800000,8730000,-1070000
30204,2021-05-16,52659,Distribution,90000,-9800000,8820000,-980000
30204,2021-06-30,52659,Value,6370000,-9800000,8820000,-980000
30204,2021-08-15,52659,Capital Call,-180000,-9980000,8820000,-1160000
30204,2021-08-15,52659,Distribution,162000,-9980000,8982000,-998000
30204,2021-09-30,52659,Value,6986000,-9980000,8982000,-998000
30204,2021-12-31,52659,Value,6986000,-9980000,8982000,-998000
30214,2020-02-15,24353,Distribution,100000,-9488462,2680769,-6807693
30214,2020-03-31,24353,Value,11576920,-9488462,2680769,-6807693
30214,2020-05-16,24353,Distribution,30769,-9488462,2711538,-6776924
30214,2020-06-30,24353,Value,11719230,-9488462,2711538,-6776924
30214,2020-08-15,24353,Distribution,26923,-9488462,2738461,-6750001
30214,2020-09-30,24353,Value,11503840,-9488462,2738461,-6750001
30214,2020-11-15,24353,Distribution,73077,-9488462,2811538,-6676924
30214,2020-12-31,24353,Value,11276920,-9488462,2811538,-6676924
30214,2021-03-31,24353,Value,9996150,-9488462,2811538,-6676924
30214,2021-06-30,24353,Value,10726920,-9488462,2811538,-6676924
30214,2021-08-15,24353,Distribution,1638462,-9488462,4450000,-5038462
30214,2021-09-30,24353,Value,9157720,-9488462,4450000,-5038462
30224,2020-02-15,13569,Distribution,23250,-7750000,6262000,-1488000
30224,2020-03-31,13569,Value,3603750,-7750000,6262000,-1488000
30224,2020-05-16,13569,Distribution,23250,-7750000,6285250,-1464750
30224,2020-06-30,13569,Value,3635520,-7750000,6285250,-1464750
30224,2020-08-15,13569,Capital Call,-501000,-8251000,6285250,-1965750
30224,2020-08-15,13569,Distribution,526776,-8251000,6812026,-1438974
30224,2020-09-30,13569,Value,4042160,-8251000,6812026,-1438974
30224,2020-11-15,13569,Capital Call,-26000,-8277000,6812026,-1464974
30224,2020-11-15,13569,Distribution,964216,-8277000,7776242,-500758
30224,2020-12-31,13569,Value,3341420,-8277000,7776242,-500758
30224,2021-02-14,13569,Distribution,139054,-8277000,7915296,-361704
30224,2021-03-31,13569,Value,3375360,-8277000,7915296,-361704
30224,2021-05-16,13569,Capital Call,-51000,-8328000,7915296,-412704
30224,2021-05-16,13569,Distribution,1528657,-8328000,9443953,1115953
30224,2021-06-30,13569,Value,2317680,-8328000,9443953,1115953
30224,2021-08-15,13569,Distribution,61627,-8328000,9505580,1177580
30224,2021-09-30,13569,Value,2281870,-8328000,9505580,1177580
30224,2021-11-15,13569,Capital Call,-24000,-8352000,9505580,1153580
30224,2021-11-15,13569,Distribution,387365,-8352000,9892945,1540945
30224,2021-12-31,13569,Value,2005310,-8352000,9892945,1540945
30255,2020-03-31,469,Value,0,-7427370,9079145,1651775
30255,2020-06-30,469,Value,0,-7427370,9079145,1651775
30255,2020-09-30,469,Value,0,-7427370,9079145,1651775
30255,2020-12-31,469,Value,0,-7427370,9079145,1651775
30255,2021-03-31,469,Value,0,-7427370,9079145,1651775
30255,2021-06-30,469,Value,0,-7427370,9079145,1651775
30255,2021-09-30,469,Value,0,-7427370,9079145,1651775
30255,2021-12-31,469,Value,0,-7427370,9079145,1651775
30268,2020-02-15,1759,Capital Call,-65000,-10365001,7519002,-2845999
30268,2020-02-15,1759,Distribution,274444,-10365001,7793446,-2571555
30268,2020-03-31,1759,Value,8499300,-10365001,7793446,-2571555
30268,2020-06-30,1759,Value,8499300,-10365001,7793446,-2571555
30268,2020-08-15,1759,Capital Call,-449000,-10814001,7793446,-3020555
30268,2020-08-15,1759,Distribution,447906,-10814001,8241352,-2572649
30268,2020-09-30,1759,Value,10057020,-10814001,8241352,-2572649
30268,2020-11-15,1759,Capital Call,-94524,-10908525,8241352,-2667173
30268,2020-11-15,1759,Distribution,993807,-10908525,9235159,-1673366
30268,2020-12-31,1759,Value,10363090,-10908525,9235159,-1673366
30268,2021-02-14,1759,Capital Call,-60157,-10968682,9235159,-1733523
30268,2021-02-14,1759,Distribution,1755462,-10968682,10990621,21939
30268,2021-03-31,1759,Value,9323370,-10968682,10990621,21939
30268,2021-05-16,1759,Capital Call,-60318,-11029000,10990621,-38379
30268,2021-05-16,1759,Distribution,1141281,-11029000,12131902,1102902
30268,2021-06-30,1759,Value,9926100,-11029000,12131902,1102902
30268,2021-08-15,1759,Capital Call,-171000,-11200000,12131902,931902
30268,2021-08-15,1759,Distribution,916100,-11200000,13048002,1848002
30268,2021-09-30,1759,Value,11088000,-11200000,13048002,1848002
30273,2021-12-31,5020,Value,0,-9240000,0,-9240000
30312,2020-11-15,12679,Capital Call,-10000,-9169999,12558360,3388361
30312,2020-11-15,12679,Distribution,7615640,-9169999,20174000,11004001
30312,2021-09-30,12679,Value,3668000,-9169999,20174000,11004001
30315,2020-03-31,43451,Value,1886420,-10000000,70861,-9929139
30315,2020-06-30,43451,Value,511860,-10000000,70861,-9929139
30315,2020-09-30,43451,Value,511860,-10000000,70861,-9929139
30315,2020-11-15,43451,Capital Call,-20417,-10020417,70861,-9949556
30315,2020-12-31,43451,Value,511860,-10020417,70861,-9949556
30315,2021-03-31,43451,Value,511860,-10020417,70861,-9949556
30468,2020-03-31,475912,Capital Call,-89786,-9024924,6480320,-2544604
30468,2020-03-31,475912,Distribution,1581110,-9024924,8061430,-963494
30468,2020-06-30,475912,Value,7415810,-9024924,8061430,-963494
30468,2020-08-15,475912,Capital Call,-2871,-9027795,8061430,-966365
30468,2020-08-15,475912,Distribution,40834,-9027795,8102264,-925531
30468,2020-09-30,475912,Value,8299940,-9027795,8102264,-925531
30468,2020-11-15,475912,Capital Call,286318,-8741477,8102264,-639213
30468,2020-11-15,475912,Distribution,1823,-8741477,8104087,-637390
30468,2020-12-31,475912,Value,8032900,-8741477,8104087,-637390
30468,2021-02-14,475912,Capital Call,538247,-8203230,8104087,-99143
30468,2021-02-14,475912,Distribution,1823,-8203230,8105910,-97320
30468,2021-03-31,475912,Value,8895480,-8203230,8105910,-97320
30475,2020-02-15,9407,Distribution,180550,-6860208,2651313,-4208895
30475,2020-03-31,9407,Value,14690350,-6860208,2651313,-4208895
30475,2020-05-16,9407,Distribution,405548,-6860208,3056861,-3803347
30475,2020-06-30,9407,Value,14769850,-6860208,3056861,-3803347
30475,2020-08-15,9407,Distribution,773786,-6860208,3830647,-3029561
30475,2020-09-30,9407,Value,18825210,-6860208,3830647,-3029561
30475,2020-12-30,9407,Distribution,2254490,-6860208,6085137,-775071
30475,2021-03-31,9407,Value,24963020,-6860208,6085137,-775071
30475,2021-05-16,9407,Distribution,583658,-6860208,6668795,-191413
30475,2021-06-30,9407,Value,29983300,-6860208,6668795,-191413
30573,2020-03-31,395,Value,8800400,-10000000,5879200,-4120800
30573,2020-05-16,395,Distribution,183800,-10000000,6063000,-3937000
30573,2020-06-30,395,Value,9110000,-10000000,6063000,-3937000
30573,2020-09-30,395,Value,9557800,-10000000,6063000,-3937000
30573,2020-11-15,395,Distribution,628600,-10000000,6691600,-3308400
30573,2020-12-31,395,Value,9697600,-10000000,6691600,-3308400
30573,2021-03-31,395,Value,12243600,-10000000,6691600,-3308400
30573,2021-06-30,395,Value,14116400,-10000000,6691600,-3308400
30649,2020-02-15,2154,Capital Call,-510000,-6810000,8700000,1890000
30649,2020-03-31,2154,Value,9690000,-6810000,8700000,1890000
30649,2020-06-30,2154,Value,9600000,-6810000,8700000,1890000
30649,2020-09-30,2154,Value,9849990,-6810000,8700000,1890000
30649,2020-12-31,2154,Value,10390000,-6810000,8700000,1890000
30649,2021-03-31,2154,Value,10580000,-6810000,8700000,1890000
30649,2021-06-30,2154,Value,10830000,-6810000,8700000,1890000
30649,2021-09-30,2154,Value,15770000,-6810000,8700000,1890000
30822,2020-03-31,916,Value,7835070,-7532999,2641825,-4891174
30822,2020-05-16,916,Capital Call,-106000,-7638999,2641825,-4997174
30822,2020-05-16,916,Distribution,223566,-7638999,2865391,-4773608
30822,2020-06-30,916,Value,8240180,-7638999,2865391,-4773608
30822,2020-08-15,916,Capital Call,-183000,-7821999,2865391,-4956608
30822,2020-08-15,916,Distribution,483992,-7821999,3349383,-4472616
30822,2020-09-30,916,Value,9395780,-7821999,3349383,-4472616
30864,2020-03-31,537,Value,11236400,-9550000,8951601,-598399
30864,2020-05-16,537,Distribution,136000,-9550000,9087601,-462399
30864,2020-06-30,537,Value,11834000,-9550000,9087601,-462399
30864,2020-08-15,537,Distribution,301800,-9550000,9389401,-160599
30864,2020-09-30,537,Value,12009800,-9550000,9389401,-160599
30864,2020-11-15,537,Capital Call,-100000,-9650000,9389401,-260599
30864,2020-11-15,537,Distribution,534400,-9650000,9923801,273801
30864,2020-12-31,537,Value,14157600,-9650000,9923801,273801
30864,2021-03-31,537,Value,23485400,-9650000,9923801,273801
30864,2021-06-30,537,Value,26245000,-9650000,9923801,273801
30939,2020-02-15,8596,Distribution,3184000,-9260000,9652000,392000
30939,2020-03-31,8596,Value,8148000,-9260000,9652000,392000
30939,2020-05-16,8596,Capital Call,-68000,-9328000,9652000,324000
30939,2020-05-16,8596,Distribution,614000,-9328000,10266000,938000
30939,2020-06-30,8596,Value,7008000,-9328000,10266000,938000
30939,2020-08-15,8596,Distribution,58000,-9328000,10324000,996000
30939,2020-09-30,8596,Value,8388000,-9328000,10324000,996000
30939,2020-11-15,8596,Distribution,2052000,-9328000,12376000,3048000
30939,2020-12-31,8596,Value,9802000,-9328000,12376000,3048000
31151,2020-02-15,58794,Capital Call,-266667,-11359999,9813334,-1546665
31151,2020-02-15,58794,Distribution,466667,-11359999,10280001,-1079998
31151,2020-03-31,58794,Value,3000000,-11359999,10280001,-1079998
31151,2020-05-16,58794,Distribution,66667,-11359999,10346668,-1013331
31151,2020-06-30,58794,Value,3573330,-11359999,10346668,-1013331
31151,2020-08-15,58794,Capital Call,40000,-11319999,10346668,-973331
31151,2020-08-15,58794,Distribution,546667,-11319999,10893335,-426664
31151,2020-09-30,58794,Value,3613330,-11319999,10893335,-426664
31151,2020-11-15,58794,Distribution,253333,-11319999,11146668,-173331
31151,2020-12-31,58794,Value,4013330,-11319999,11146668,-173331
31151,2021-02-14,58794,Capital Call,-13333,-11333332,11146668,-186664
31151,2021-02-14,58794,Distribution,80000,-11333332,11226668,-106664
31151,2021-03-31,58794,Value,4426660,-11333332,11226668,-106664
31151,2021-05-16,58794,Distribution,106667,-11333332,11333335,3
31151,2021-06-30,58794,Value,4066660,-11333332,11333335,3
31151,2021-08-15,58794,Distribution,986667,-11333332,12320002,986670
31151,2021-09-30,58794,Value,3786660,-11333332,12320002,986670
31152,2020-02-15,2102,Capital Call,-370000,-10875000,4310000,-6565000
31152,2020-02-15,2102,Distribution,505000,-10875000,4815000,-6060000
31152,2020-03-31,2102,Value,10704990,-10875000,4815000,-6060000
31152,2020-05-16,2102,Distribution,105000,-10875000,4920000,-5955000
31152,2020-06-30,2102,Value,10620000,-10875000,4920000,-5955000
31152,2020-08-15,2102,Capital Call,-75000,-10950000,4920000,-6030000
31152,2020-08-15,2102,Distribution,195000,-10950000,5115000,-5835000
31152,2020-09-30,2102,Value,11689990,-10950000,5115000,-5835000
31152,2020-11-15,2102,Distribution,235000,-10950000,5350000,-5600000
31152,2020-12-31,2102,Value,12129990,-10950000,5350000,-5600000
31152,2021-02-14,2102,Capital Call,-70000,-11020000,5350000,-5670000
31152,2021-02-14,2102,Distribution,950000,-11020000,6300000,-4720000
31152,2021-03-31,2102,Value,12134990,-11020000,6300000,-4720000
31152,2021-05-16,2102,Capital Call,-10000,-11030000,6300000,-4730000
31152,2021-05-16,2102,Distribution,300000,-11030000,6600000,-4430000
31152,2021-06-30,2102,Value,12390000,-11030000,6600000,-4430000
31152,2021-08-15,2102,Capital Call,-54500,-11084500,6600000,-4484500
31152,2021-08-15,2102,Distribution,1680500,-11084500,8280500,-2804000
31152,2021-09-30,2102,Value,9694500,-11084500,8280500,-2804000
31187,2020-03-31,6468,Value,6113970,-10139874,1217130,-8922744
31187,2020-05-16,6468,Distribution,300000,-10139874,1517130,-8622744
31187,2020-06-30,6468,Value,6878510,-10139874,1517130,-8622744
31187,2020-08-15,6468,Distribution,2700000,-10139874,4217130,-5922744
31187,2020-09-30,6468,Value,4094680,-10139874,4217130,-5922744
31187,2020-11-15,6468,Distribution,300000,-10139874,4517130,-5622744
31187,2020-12-31,6468,Value,3790630,-10139874,4517130,-5622744
31187,2021-03-31,6468,Value,3893870,-10139874,4517130,-5622744
31252,2020-02-15,80,Capital Call,-100000,-10546868,9381996,-1164872
31252,2020-02-15,80,Distribution,923027,-10546868,10305023,-241845
31252,2020-03-31,80,Value,10214260,-10546868,10305023,-241845
31252,2020-05-16,80,Capital Call,-50000,-10596868,10305023,-291845
31252,2020-05-16,80,Distribution,348047,-10596868,10653070,56202
31252,2020-06-30,80,Value,7707440,-10596868,10653070,56202
31252,2020-08-15,80,Capital Call,-175000,-10771868,10653070,-118798
31252,2020-08-15,80,Distribution,1673114,-10771868,12326184,1554316
31252,2020-09-30,80,Value,7613310,-10771868,12326184,1554316
31252,2020-11-15,80,Distribution,815176,-10771868,13141360,2369492
31252,2020-12-31,80,Value,8255990,-10771868,13141360,2369492
31252,2021-02-14,80,Distribution,365260,-10771868,13506620,2734752
31252,2021-03-31,80,Value,9460550,-10771868,13506620,2734752
31323,2020-03-31,68285,Value,19819660,-11219559,5571878,-5647681
31323,2020-06-30,68285,Value,27288750,-11219559,5571878,-5647681
31323,2020-08-15,68285,Capital Call,-109023,-11328582,5571878,-5756704
31323,2020-08-15,68285,Distribution,1543209,-11328582,7115087,-4213495
31323,2020-09-30,68285,Value,32376020,-11328582,7115087,-4213495
31323,2020-11-15,68285,Capital Call,-32409,-11360991,7115087,-4245904
31323,2020-11-15,68285,Distribution,1884811,-11360991,8999898,-2361093
31323,2020-12-31,68285,Value,34839490,-11360991,8999898,-2361093
31323,2021-02-14,68285,Distribution,1351933,-11360991,10351831,-1009160
31323,2021-03-31,68285,Value,34742590,-11360991,10351831,-1009160
31323,2021-06-30,68285,Value,36217760,-11360991,10351831,-1009160
31345,2020-02-15,47993,Distribution,186507,-9417787,14823024,5405237
31345,2020-03-31,47993,Value,6611580,-9417787,14823024,5405237
31345,2020-06-30,47993,Value,6524210,-9417787,14823024,5405237
31345,2020-09-30,47993,Capital Call,-529305,-9947092,14823024,4875932
31345,2020-09-30,47993,Distribution,529305,-9947092,15352329,5405237
31345,2020-12-31,47993,Value,6902460,-9947092,15352329,5405237
31345,2021-02-14,47993,Capital Call,-113595,-10060687,15352329,5291642
31345,2021-03-31,47993,Value,7618030,-10060687,15352329,5291642
31345,2021-06-30,47993,Value,6638140,-10060687,15352329,5291642
31349,2020-02-15,47993,Distribution,266101,-9686101,19137378,9451277
31349,2020-03-31,47993,Value,1725150,-9686101,19137378,9451277
31349,2020-06-30,47993,Value,1725150,-9686101,19137378,9451277
31349,2020-09-30,47993,Value,1808880,-9686101,19137378,9451277
31349,2020-12-31,47993,Value,1809800,-9686101,19137378,9451277
31349,2021-02-14,47993,Distribution,58725,-9686101,19196103,9510002
31349,2021-03-31,47993,Value,1775200,-9686101,19196103,9510002
31431,2020-03-31,15730,Value,4973680,-10765404,11687573,922169
31431,2020-06-30,15730,Value,4986150,-10765404,11687573,922169
31431,2020-08-15,15730,Capital Call,-76812,-10842216,11687573,845357
31431,2020-08-15,15730,Distribution,1304338,-10842216,12991911,2149695
31431,2020-09-30,15730,Value,3702690,-10842216,12991911,2149695
31431,2020-12-31,15730,Value,3994410,-10842216,12991911,2149695
31431,2021-03-31,15730,Value,4212000,-10842216,12991911,2149695
31510,2020-02-15,718,Capital Call,-594608,-10378573,12551145,2172572
31510,2020-02-15,718,Distribution,1446298,-10378573,13997443,3618870
31510,2020-03-31,718,Value,13095860,-10378573,13997443,3618870
31510,2020-05-16,718,Capital Call,132342,-10246231,13997443,3751212
31510,2020-05-16,718,Distribution,1137998,-10246231,15135441,4889210
31510,2020-06-30,718,Value,19643780,-10246231,15135441,4889210
31510,2020-08-15,718,Capital Call,346229,-9900002,15135441,5235439
31510,2020-08-15,718,Distribution,1616561,-9900002,16752002,6852000
31510,2020-09-30,718,Value,19068000,-9900002,16752002,6852000
31510,2020-11-15,718,Distribution,3524190,-9900002,20276192,10376190
31510,2020-12-31,718,Value,18980270,-9900002,20276192,10376190
31633,2020-03-31,434,Value,17866810,-9824680,649018,-9175662
31633,2020-06-30,434,Value,19994340,-9824680,649018,-9175662
31633,2020-08-15,434,Distribution,310974,-9824680,959992,-8864688
31633,2020-09-30,434,Value,22827280,-9824680,959992,-8864688
31633,2020-12-30,434,Distribution,2654931,-9824680,3614923,-6209757
31633,2021-03-31,434,Value,28829580,-9824680,3614923,-6209757
31727,2020-03-31,487,Value,30440000,-9720000,920000,-8800000
31727,2020-05-16,487,Distribution,1360000,-9720000,2280000,-7440000
31727,2020-06-30,487,Value,29960000,-9720000,2280000,-7440000
31727,2020-09-30,487,Value,30840000,-9720000,2280000,-7440000
31727,2020-11-15,487,Distribution,3920000,-9720000,6200000,-3520000
31727,2020-12-31,487,Value,27120000,-9720000,6200000,-3520000
31727,2021-03-31,487,Value,37120000,-9720000,6200000,-3520000
31727,2021-06-30,487,Value,44160000,-9720000,6200000,-3520000
31727,2021-09-30,487,Value,55840000,-9720000,6200000,-3520000
31753,2020-03-31,350,Distribution,136400,-7865535,7283810,-581725
31753,2020-06-30,350,Value,2716460,-7865535,7283810,-581725
31753,2020-08-15,350,Distribution,145872,-7865535,7429682,-435853
31753,2020-09-30,350,Value,2601090,-7865535,7429682,-435853
31753,2020-12-31,350,Value,2601090,-7865535,7429682,-435853
31753,2021-02-14,350,Distribution,580696,-7865535,8010378,144843
31753,2021-03-31,350,Value,2572690,-7865535,8010378,144843
31753,2021-05-16,350,Distribution,390221,-7865535,8400599,535064
31753,2021-06-30,350,Value,2150430,-7865535,8400599,535064
31753,2021-08-15,350,Distribution,159425,-7865535,8560024,694489
31753,2021-09-30,350,Value,1894050,-7865535,8560024,694489
31755,2020-02-15,350,Distribution,257540,-7377038,2504532,-4872506
31755,2020-03-31,350,Value,7171690,-7377038,2504532,-4872506
31755,2020-06-30,350,Value,6405610,-7377038,2504532,-4872506
31755,2020-08-15,350,Distribution,36041,-7377038,2540573,-4836465
31755,2020-09-30,350,Value,6487140,-7377038,2540573,-4836465
31778,2020-02-15,715,Capital Call,-240393,-10689133,3360053,-7329080
31778,2020-02-15,715,Distribution,2643623,-10689133,6003676,-4685457
31778,2020-03-31,715,Value,6235670,-10689133,6003676,-4685457
31778,2020-05-16,715,Capital Call,-142857,-10831990,6003676,-4828314
31778,2020-06-30,715,Value,6265150,-10831990,6003676,-4828314
31778,2020-08-15,715,Distribution,324016,-10831990,6327692,-4504298
31778,2020-09-30,715,Value,7106150,-10831990,6327692,-4504298
31778,2020-12-31,715,Value,7562300,-10831990,6327692,-4504298
31778,2021-02-14,715,Capital Call,-16528,-10848518,6327692,-4520826
31778,2021-02-14,715,Distribution,1912049,-10848518,8239741,-2608777
31778,2021-03-31,715,Value,6150480,-10848518,8239741,-2608777
31778,2021-05-16,715,Capital Call,1252656,-9595862,8239741,-1356121
31778,2021-06-30,715,Value,6359070,-9595862,8239741,-1356121
31804,2020-03-31,162,Value,5551300,-5214639,1540837,-3673802
31804,2020-06-30,162,Value,5804650,-5214639,1540837,-3673802
31804,2020-08-15,162,Capital Call,-1230710,-6445349,1540837,-4904512
31804,2020-09-30,162,Value,7409670,-6445349,1540837,-4904512
31804,2020-11-15,162,Capital Call,102559,-6342790,1540837,-4801953
31804,2020-11-15,162,Distribution,-24276,-6342790,1516561,-4826229
31804,2020-12-31,162,Value,8520900,-6342790,1516561,-4826229
31804,2021-02-14,162,Capital Call,-380982,-6723772,1516561,-5207211
31804,2021-02-14,162,Distribution,24276,-6723772,1540837,-5182935
31804,2021-03-31,162,Value,9118250,-6723772,1540837,-5182935
31804,2021-05-16,162,Capital Call,-132900,-6856672,1540837,-5315835
31804,2021-05-16,162,Distribution,607895,-6856672,2148732,-4707940
31804,2021-06-30,162,Value,9488190,-6856672,2148732,-4707940
31838,2020-03-31,1368,Capital Call,-4847669,-9533001,2699203,-6833798
31838,2020-03-31,1368,Distribution,2792758,-9533001,5491961,-4041040
31838,2020-03-31,1368,Value,3528190,-9533001,5491961,-4041040
31838,2020-06-30,1368,Value,6725530,-9533001,5491961,-4041040
31838,2020-08-15,1368,Capital Call,3000,-9530001,5491961,-4038040
31838,2020-08-15,1368,Distribution,-1728,-9530001,5490233,-4039768
31838,2020-09-30,1368,Value,8121460,-9530001,5490233,-4039768
31917,2020-02-15,7,Distribution,249600,-9750000,5499976,-4250024
31917,2020-03-31,7,Value,9109420,-9750000,5499976,-4250024
31917,2020-06-30,7,Value,10143900,-9750000,5499976,-4250024
31917,2020-08-15,7,Capital Call,-100000,-9850000,5499976,-4350024
31917,2020-08-15,7,Distribution,600130,-9850000,6100106,-3749894
31917,2020-09-30,7,Value,11391520,-9850000,6100106,-3749894
32275,2020-01-15,14497,Capital Call,-100000,-10000000,0,-10000000
32275,2020-02-29,14497,Value,13798100,-10000000,0,-10000000
32275,2020-04-15,14497,Capital Call,0,-10000000,0,-10000000
32275,2020-05-31,14497,Value,14579660,-10000000,0,-10000000
32275,2020-08-31,14497,Value,13394050,-10000000,0,-10000000
32275,2020-11-30,14497,Value,14474290,-10000000,0,-10000000
32275,2021-02-28,14497,Value,16030650,-10000000,0,-10000000
32275,2021-04-15,14497,Capital Call,-582941,-10582941,0,-10582941
32275,2021-04-15,14497,Distribution,798497,-10582941,798497,-9784444
32275,2021-05-31,14497,Value,17136620,-10582941,798497,-9784444
32275,2021-08-31,14497,Value,17225790,-10582941,798497,-9784444
32275,2021-10-16,14497,Capital Call,0,-10582941,798497,-9784444
32275,2021-10-16,14497,Distribution,0,-10582941,798497,-9784444
32275,2021-11-30,14497,Value,19342580,-10582941,798497,-9784444
32411,2020-02-15,9004,Distribution,600000,-9970000,5427333,-4542667
32411,2020-03-31,9004,Value,19427330,-9970000,5427333,-4542667
32411,2020-06-30,9004,Value,21942660,-9970000,5427333,-4542667
32411,2020-09-30,9004,Value,21935330,-9970000,5427333,-4542667
32411,2020-12-31,9004,Value,30701330,-9970000,5427333,-4542667
32411,2021-02-14,9004,Distribution,7643333,-9970000,13070666,3100666
32411,2021-03-31,9004,Value,43513330,-9970000,13070666,3100666
32411,2021-05-16,9004,Distribution,5800000,-9970000,18870666,8900666
32411,2021-06-30,9004,Value,38384000,-9970000,18870666,8900666
32461,2020-02-15,7234,Capital Call,-30000,-9980001,4843335,-5136666
32461,2020-02-15,7234,Distribution,93333,-9980001,4936668,-5043333
32461,2020-03-31,7234,Value,9579990,-9980001,4936668,-5043333
32461,2020-05-16,7234,Capital Call,-43333,-10023334,4936668,-5086666
32461,2020-06-30,7234,Value,10059990,-10023334,4936668,-5086666
32461,2020-08-15,7234,Distribution,1123333,-10023334,6060001,-3963333
32461,2020-09-30,7234,Value,14029990,-10023334,6060001,-3963333
32461,2020-12-31,7234,Value,15566660,-10023334,6060001,-3963333
32461,2021-02-14,7234,Capital Call,-33333,-10056667,6060001,-3996666
32461,2021-02-14,7234,Distribution,63333,-10056667,6123334,-3933333
32461,2021-03-31,7234,Value,16723330,-10056667,6123334,-3933333
32461,2021-05-16,7234,Distribution,2570000,-10056667,8693334,-1363333
32461,2021-06-30,7234,Value,15663330,-10056667,8693334,-1363333
32461,2021-08-15,7234,Capital Call,1000,-10055667,8693334,-1362333
32461,2021-08-15,7234,Distribution,667,-10055667,8694001,-1361666
32461,2021-09-30,7234,Value,9297330,-10055667,8694001,-1361666
32540,2020-03-31,6360,Value,2002110,-10005938,8390983,-1614955
32540,2020-06-30,6360,Value,1899570,-10005938,8390983,-1614955
32540,2020-09-30,6360,Value,1908820,-10005938,8390983,-1614955
32540,2020-11-15,6360,Capital Call,-54308,-10060246,8390983,-1669263
32540,2020-12-31,6360,Value,1913350,-10060246,8390983,-1669263
32540,2021-03-31,6360,Value,2477420,-10060246,8390983,-1669263
32540,2021-06-30,6360,Value,2396560,-10060246,8390983,-1669263
32540,2021-09-30,6360,Value,2413050,-10060246,8390983,-1669263
32548,2020-02-15,355,Capital Call,-358343,-7575056,1661729,-5913327
32548,2020-02-15,355,Distribution,181915,-7575056,1843644,-5731412
32548,2020-03-31,355,Value,8220390,-7575056,1843644,-5731412
32548,2020-05-16,355,Capital Call,-316944,-7892000,1843644,-6048356
32548,2020-05-16,355,Distribution,-72,-7892000,1843572,-6048428
32548,2020-06-30,355,Value,9433300,-7892000,1843572,-6048428
32548,2020-09-30,355,Capital Call,-300000,-8192000,1843572,-6348428
32548,2020-09-30,355,Distribution,531290,-8192000,2374862,-5817138
32548,2020-12-31,355,Value,12310930,-8192000,2374862,-5817138
32548,2021-02-14,355,Capital Call,-66000,-8258000,2374862,-5883138
32548,2021-02-14,355,Distribution,512962,-8258000,2887824,-5370176
32548,2021-03-31,355,Value,13327580,-8258000,2887824,-5370176
32548,2021-05-16,355,Capital Call,-92000,-8350000,2887824,-5462176
32548,2021-05-16,355,Distribution,765302,-8350000,3653126,-4696874
32548,2021-06-30,355,Value,14003780,-8350000,3653126,-4696874
32563,2020-02-15,743,Capital Call,-25611,-9842878,3060800,-6782078
32563,2020-03-31,743,Value,10834940,-9842878,3060800,-6782078
32563,2020-05-16,743,Capital Call,-14799,-9857677,3060800,-6796877
32563,2020-05-16,743,Distribution,1511761,-9857677,4572561,-5285116
32563,2020-06-30,743,Value,9686650,-9857677,4572561,-5285116
32563,2020-08-15,743,Capital Call,-26933,-9884610,4572561,-5312049
32563,2020-08-15,743,Distribution,191439,-9884610,4764000,-5120610
32563,2020-09-30,743,Value,11369460,-9884610,4764000,-5120610
32563,2020-11-15,743,Capital Call,-14799,-9899409,4764000,-5135409
32563,2020-11-15,743,Distribution,5249975,-9899409,10013975,114566
32563,2020-12-31,743,Value,10158320,-9899409,10013975,114566
32563,2021-02-14,743,Capital Call,-4935,-9904344,10013975,109631
32563,2021-02-14,743,Distribution,2208234,-9904344,12222209,2317865
32563,2021-03-31,743,Value,8950060,-9904344,12222209,2317865
32563,2021-05-16,743,Capital Call,-4736,-9909080,12222209,2313129
32563,2021-05-16,743,Distribution,682902,-9909080,12905111,2996031
32563,2021-06-30,743,Value,5874300,-9909080,12905111,2996031
32563,2021-08-15,743,Capital Call,-12304,-9921384,12905111,2983727
32563,2021-08-15,743,Distribution,344420,-9921384,13249531,3328147
32563,2021-09-30,743,Value,5153050,-9921384,13249531,3328147
32636,2020-03-31,9740,Value,8448400,-10581200,11536800,955600
32636,2020-06-30,9740,Value,9018000,-10581200,11536800,955600
32720,2020-03-31,74375,Value,14875000,-8500000,0,-8500000
32728,2020-03-31,466,Value,7965150,-9200000,10429162,1229162
32728,2020-05-16,466,Distribution,1075758,-9200000,11504920,2304920
32728,2020-06-30,466,Value,7562070,-9200000,11504920,2304920
32728,2020-08-15,466,Distribution,474259,-9200000,11979179,2779179
32728,2020-09-30,466,Value,7566860,-9200000,11979179,2779179
32728,2020-11-15,466,Distribution,1863418,-9200000,13842597,4642597
32728,2020-12-31,466,Value,6227460,-9200000,13842597,4642597
32728,2021-02-14,466,Distribution,1056400,-9200000,14898997,5698997
32728,2021-03-31,466,Value,6165610,-9200000,14898997,5698997
32819,2020-01-15,9112,Capital Call,-400000,-10406652,1644506,-8762146
32819,2020-01-15,9112,Distribution,604334,-10406652,2248840,-8157812
32819,2020-02-29,9112,Value,18014870,-10406652,2248840,-8157812
32819,2020-04-15,9112,Capital Call,-100000,-10506652,2248840,-8257812
32819,2020-05-31,9112,Value,18410230,-10506652,2248840,-8257812
32819,2020-07-16,9112,Capital Call,-200000,-10706652,2248840,-8457812
32819,2020-07-16,9112,Distribution,131126,-10706652,2379966,-8326686
32819,2020-08-31,9112,Value,17908880,-10706652,2379966,-8326686
32819,2020-10-16,9112,Distribution,1186143,-10706652,3566109,-7140543
32819,2020-11-30,9112,Value,23118690,-10706652,3566109,-7140543
32819,2021-02-28,9112,Value,23154560,-10706652,3566109,-7140543
32819,2021-04-15,9112,Capital Call,-300000,-11006652,3566109,-7440543
32819,2021-04-15,9112,Distribution,1827806,-11006652,5393915,-5612737
32819,2021-05-31,9112,Value,33906270,-11006652,5393915,-5612737
32819,2021-07-16,9112,Capital Call,-100000,-11106652,5393915,-5712737
32819,2021-07-16,9112,Distribution,841287,-11106652,6235202,-4871450
32819,2021-08-31,9112,Value,30690910,-11106652,6235202,-4871450
32819,2021-10-16,9112,Capital Call,-150000,-11256652,6235202,-5021450
32819,2021-10-16,9112,Distribution,1348708,-11256652,7583910,-3672742
32819,2021-11-30,9112,Value,31167430,-11256652,7583910,-3672742
32975,2020-09-30,607,Value,11800000,-10000000,2000000,-8000000
32975,2020-11-15,607,Capital Call,-300000,-10300000,2000000,-8300000
32975,2020-11-15,607,Distribution,1502000,-10300000,3502000,-6798000
32975,2020-12-31,607,Value,14420000,-10300000,3502000,-6798000
32975,2021-02-14,607,Distribution,927000,-10300000,4429000,-5871000
32975,2021-03-31,607,Value,19364000,-10300000,4429000,-5871000
33067,2020-03-31,2198,Value,4451790,-4930000,0,-4930000
33067,2020-05-16,2198,Capital Call,-470000,-5400000,0,-5400000
33067,2020-05-16,2198,Distribution,793800,-5400000,793800,-4606200
33067,2020-06-30,2198,Value,4703400,-5400000,793800,-4606200
33067,2020-08-15,2198,Capital Call,-1260000,-6660000,793800,-5866200
33067,2020-08-15,2198,Distribution,-1260,-6660000,792540,-5867460
33067,2020-09-30,2198,Value,6040620,-6660000,792540,-5867460
33067,2020-11-15,2198,Capital Call,-916847,-7576847,792540,-6784307
33067,2020-11-15,2198,Distribution,5420475,-7576847,6213015,-1363832
33067,2020-12-31,2198,Value,7987060,-7576847,6213015,-1363832
33067,2021-02-14,2198,Capital Call,-723153,-8300000,6213015,-2086985
33067,2021-02-14,2198,Distribution,16135,-8300000,6229150,-2070850
33067,2021-03-31,2198,Value,11628300,-8300000,6229150,-2070850
33067,2021-05-16,2198,Capital Call,-365271,-8665271,6229150,-2436121
33067,2021-05-16,2198,Distribution,-16135,-8665271,6213015,-2452256
33067,2021-06-30,2198,Value,18085880,-8665271,6213015,-2452256
33067,2021-08-15,2198,Capital Call,-1103729,-9769000,6213015,-3555985
33067,2021-08-15,2198,Distribution,791358,-9769000,7004373,-2764627
33067,2021-09-30,2198,Value,8770600,-9769000,7004373,-2764627
33075,2020-03-31,355,Value,6426660,-9973334,12026664,2053330
33075,2020-07-01,355,Distribution,373333,-9973334,12399997,2426663
33075,2020-09-30,355,Value,6746660,-9973334,12399997,2426663
33075,2020-11-15,355,Distribution,1120000,-9973334,13519997,3546663
33075,2020-12-31,355,Value,4079990,-9973334,13519997,3546663
33075,2021-02-14,355,Distribution,4066667,-9973334,17586664,7613330
33075,2021-03-31,355,Value,0,-9973334,17586664,7613330
33075,2021-06-30,355,Value,0,-9973334,17586664,7613330
33075,2021-09-30,355,Value,0,-9973334,17586664,7613330
33205,2020-02-15,741,Capital Call,4484,-10049947,8148008,-1901939
33205,2020-02-15,741,Distribution,-7551,-10049947,8140457,-1909490
33205,2020-03-31,741,Value,5014920,-10049947,8140457,-1909490
33205,2020-06-30,741,Value,5366670,-10049947,8140457,-1909490
33205,2020-09-30,741,Value,5949560,-10049947,8140457,-1909490
33205,2020-11-15,741,Capital Call,-219603,-10269550,8140457,-2129093
33205,2020-11-15,741,Distribution,1535401,-10269550,9675858,-593692
33205,2020-12-31,741,Value,5110710,-10269550,9675858,-593692
33205,2021-02-14,741,Capital Call,-449,-10269999,9675858,-594141
33205,2021-02-14,741,Distribution,535,-10269999,9676393,-593606
33205,2021-03-31,741,Value,5387640,-10269999,9676393,-593606
33205,2021-05-16,741,Capital Call,-24000,-10293999,9676393,-617606
33205,2021-05-16,741,Distribution,114229,-10293999,9790622,-503377
33205,2021-06-30,741,Value,5579340,-10293999,9790622,-503377
33205,2021-08-15,741,Capital Call,-96000,-10389999,9790622,-599377
33205,2021-08-15,741,Distribution,1981247,-10389999,11771869,1381870
33205,2021-09-30,741,Value,3740400,-10389999,11771869,1381870
33213,2020-03-31,3795,Capital Call,-300000,-8900000,285520,-8614480
33213,2020-03-31,3795,Distribution,1060,-8900000,286580,-8613420
33213,2020-06-30,3795,Value,14199060,-8900000,286580,-8613420
33213,2020-08-15,3795,Distribution,-1780,-8900000,284800,-8615200
33213,2020-09-30,3795,Value,13824370,-8900000,284800,-8615200
33213,2020-12-31,3795,Value,17692310,-8900000,284800,-8615200
33213,2021-02-14,3795,Capital Call,-100000,-9000000,284800,-8715200
33213,2021-02-14,3795,Distribution,3200,-9000000,288000,-8712000
33213,2021-03-31,3795,Value,18351000,-9000000,288000,-8712000
33213,2021-05-16,3795,Distribution,522000,-9000000,810000,-8190000
33213,2021-06-30,3795,Value,18450000,-9000000,810000,-8190000
33213,2021-08-15,3795,Capital Call,-100000,-9100000,810000,-8290000
33213,2021-08-15,3795,Distribution,9000,-9100000,819000,-8281000
33213,2021-09-30,3795,Value,18441150,-9100000,819000,-8281000
33213,2021-12-31,3795,Value,18526690,-9100000,819000,-8281000
33239,2020-02-15,725,Distribution,0,-8481137,1309139,-7171998
33239,2020-03-31,725,Value,12869760,-8481137,1309139,-7171998
33239,2020-05-16,725,Capital Call,-236365,-8717502,1309139,-7408363
33239,2020-06-30,725,Value,17053680,-8717502,1309139,-7408363
33239,2020-09-30,725,Value,17752670,-8717502,1309139,-7408363
33239,2020-11-15,725,Distribution,0,-8717502,1309139,-7408363
33239,2020-12-31,725,Value,21772000,-8717502,1309139,-7408363
33352,2020-02-15,238,Capital Call,-247810,-10222485,361580,-9860905
33352,2020-03-31,238,Value,7892960,-10222485,361580,-9860905
33352,2020-06-30,238,Value,7864820,-10222485,361580,-9860905
33352,2020-12-31,238,Value,8223670,-10222485,361580,-9860905
33352,2021-03-31,238,Value,11518410,-10222485,361580,-9860905
33355,2020-02-15,1314,Capital Call,-46000,-9420000,4123624,-5296376
33355,2020-02-15,1314,Distribution,385731,-9420000,4509355,-4910645
33355,2020-03-31,1314,Value,15460100,-9420000,4509355,-4910645
33355,2020-05-16,1314,Capital Call,-29000,-9449000,4509355,-4939645
33355,2020-05-16,1314,Distribution,269950,-9449000,4779305,-4669695
33355,2020-06-30,1314,Value,16703940,-9449000,4779305,-4669695
33355,2020-08-15,1314,Capital Call,-75000,-9524000,4779305,-4744695
33355,2020-08-15,1314,Distribution,548421,-9524000,5327726,-4196274
33355,2020-09-30,1314,Value,19290860,-9524000,5327726,-4196274
33355,2020-11-15,1314,Capital Call,-25000,-9549000,5327726,-4221274
33355,2020-11-15,1314,Distribution,648994,-9549000,5976720,-3572280
33355,2020-12-31,1314,Value,23987080,-9549000,5976720,-3572280
33355,2021-02-14,1314,Distribution,2110329,-9549000,8087049,-1461951
33355,2021-03-31,1314,Value,24450210,-9549000,8087049,-1461951
33355,2021-05-16,1314,Distribution,1163068,-9549000,9250117,-298883
33355,2021-06-30,1314,Value,26195770,-9549000,9250117,-298883
33355,2021-08-15,1314,Distribution,342809,-9549000,9592926,43926
33355,2021-09-30,1314,Value,27354060,-9549000,9592926,43926
33701,2020-02-15,57823,Capital Call,-90000,-9410000,14846760,5436760
33701,2020-02-15,57823,Distribution,-16600,-9410000,14830160,5420160
33701,2020-03-31,57823,Value,5740100,-9410000,14830160,5420160
33701,2020-06-30,57823,Value,6323520,-9410000,14830160,5420160
33835,2020-03-31,533,Value,4486730,-9458659,13742100,4283441
33835,2020-05-16,533,Capital Call,-34735,-9493394,13742100,4248706
33835,2020-05-16,533,Distribution,3205868,-9493394,16947968,7454574
33835,2020-06-30,533,Value,2462260,-9493394,16947968,7454574
33835,2020-09-30,533,Value,2561190,-9493394,16947968,7454574
33835,2020-11-15,533,Capital Call,-3219,-9496613,16947968,7451355
33835,2020-11-15,533,Distribution,145491,-9496613,17093459,7596846
33835,2020-12-31,533,Value,2418920,-9496613,17093459,7596846
33835,2021-03-31,533,Value,3068110,-9496613,17093459,7596846
33835,2021-06-30,533,Value,3762280,-9496613,17093459,7596846
33836,2020-02-15,2317,Capital Call,190000,-9600000,13911590,4311590
33836,2020-02-15,2317,Distribution,-183590,-9600000,13728000,4128000
33836,2020-03-31,2317,Value,4252800,-9600000,13728000,4128000
33836,2020-05-16,2317,Capital Call,-260000,-9860000,13728000,3868000
33836,2020-05-16,2317,Distribution,756340,-9860000,14484340,4624340
33836,2020-06-30,2317,Value,3815820,-9860000,14484340,4624340
33836,2020-08-15,2317,Capital Call,-30000,-9890000,14484340,4594340
33836,2020-08-15,2317,Distribution,4510,-9890000,14488850,4598850
33836,2020-09-30,2317,Value,3639520,-9890000,14488850,4598850
33836,2020-12-31,2317,Value,3669190,-9890000,14488850,4598850
33836,2021-02-14,2317,Distribution,1038450,-9890000,15527300,5637300
33836,2021-03-31,2317,Value,4223030,-9890000,15527300,5637300
33865,2020-02-15,10595,Capital Call,-350000,-12050000,3679999,-8370001
33865,2020-02-15,10595,Distribution,30000,-12050000,3709999,-8340001
33865,2020-03-31,10595,Value,8039990,-12050000,3709999,-8340001
33865,2020-06-30,10595,Value,8479990,-12050000,3709999,-8340001
33865,2020-08-15,10595,Capital Call,-160000,-12210000,3709999,-8500001
33865,2020-08-15,10595,Distribution,370000,-12210000,4079999,-8130001
33865,2020-09-30,10595,Value,9190000,-12210000,4079999,-8130001
33865,2020-11-15,10595,Capital Call,-280000,-12490000,4079999,-8410001
33865,2020-11-15,10595,Distribution,4680000,-12490000,8759999,-3730001
33865,2020-12-31,10595,Value,0,-12490000,8759999,-3730001
33865,2021-03-31,10595,Value,0,-12490000,8759999,-3730001
33865,2021-06-30,10595,Value,0,-12490000,8759999,-3730001
33865,2021-09-30,10595,Value,0,-12490000,8759999,-3730001
33882,2020-02-15,6733,Capital Call,-41488,-10001287,4985849,-5015438
33882,2020-02-15,6733,Distribution,221152,-10001287,5207001,-4794286
33882,2020-03-31,6733,Value,8371410,-10001287,5207001,-4794286
33882,2020-05-16,6733,Capital Call,-277747,-10279034,5207001,-5072033
33882,2020-05-16,6733,Distribution,333112,-10279034,5540113,-4738921
33882,2020-06-30,6733,Value,6730650,-10279034,5540113,-4738921
33882,2020-08-15,6733,Capital Call,-12981,-10292015,5540113,-4751902
33882,2020-08-15,6733,Distribution,313019,-10292015,5853132,-4438883
33882,2020-09-30,6733,Value,7106690,-10292015,5853132,-4438883
33947,2020-03-31,431,Value,3213080,-9233000,14182813,4949813
33947,2020-06-30,431,Value,3541770,-9233000,14182813,4949813
33947,2020-09-30,431,Value,3723660,-9233000,14182813,4949813
33947,2020-12-31,431,Value,4132690,-9233000,14182813,4949813
33947,2021-02-14,431,Capital Call,-37000,-9270000,14182813,4912813
33947,2021-02-14,431,Distribution,1225783,-9270000,15408596,6138596
33947,2021-03-31,431,Value,3673700,-9270000,15408596,6138596
33947,2021-06-30,431,Value,3974040,-9270000,15408596,6138596
33947,2021-08-15,431,Capital Call,-5000,-9275000,15408596,6133596
33947,2021-08-15,431,Distribution,1364316,-9275000,16772912,7497912
33947,2021-09-30,431,Value,3277780,-9275000,16772912,7497912
33947,2021-11-15,431,Capital Call,-32000,-9307000,16772912,7465912
33947,2021-11-15,431,Distribution,4069186,-9307000,20842098,11535098
33947,2021-12-31,431,Value,34430,-9307000,20842098,11535098
33970,2020-02-15,95195,Capital Call,-100000,-9940000,5559600,-4380400
33970,2020-02-15,95195,Distribution,-3140,-9940000,5556460,-4383540
33970,2020-03-31,95195,Value,5039580,-9940000,5556460,-4383540
33970,2020-06-30,95195,Value,5407360,-9940000,5556460,-4383540
33970,2020-09-30,95195,Value,6616060,-9940000,5556460,-4383540
33970,2020-12-31,95195,Value,7455000,-9940000,5556460,-4383540
33970,2021-02-14,95195,Capital Call,40000,-9900000,5556460,-4343540
33970,2021-02-14,95195,Distribution,-12460,-9900000,5544000,-4356000
33970,2021-03-31,95195,Value,7128000,-9900000,5544000,-4356000
33970,2021-06-30,95195,Value,7326000,-9900000,5544000,-4356000
33970,2021-09-30,95195,Value,7326000,-9900000,5544000,-4356000
34382,2020-02-15,95960,Capital Call,-32000,-11048000,9496000,-1552000
34382,2020-02-15,95960,Distribution,1368000,-11048000,10864000,-184000
34382,2020-03-31,95960,Value,5071990,-11048000,10864000,-184000
34382,2020-06-30,95960,Value,5568000,-11048000,10864000,-184000
34382,2020-09-30,95960,Value,5328000,-11048000,10864000,-184000
34382,2020-12-31,95960,Value,6103990,-11048000,10864000,-184000
34382,2021-02-14,95960,Capital Call,-8000,-11056000,10864000,-192000
34382,2021-02-14,95960,Distribution,160000,-11056000,11024000,-32000
34382,2021-03-31,95960,Value,6847990,-11056000,11024000,-32000
34382,2021-05-16,95960,Distribution,304000,-11056000,11328000,272000
34382,2021-06-30,95960,Value,6824000,-11056000,11328000,272000
34382,2021-08-15,95960,Capital Call,3200,-11052800,11328000,275200
34382,2021-08-15,95960,Distribution,2400,-11052800,11330400,277600
34382,2021-09-30,95960,Value,6980800,-11052800,11330400,277600
34493,2020-02-15,11706,Capital Call,-300000,-8499999,3608000,-4891999
34493,2020-02-15,11706,Distribution,47000,-8499999,3655000,-4844999
34493,2020-03-31,11706,Value,9775000,-8499999,3655000,-4844999
34493,2020-05-16,11706,Capital Call,-200000,-8699999,3655000,-5044999
34493,2020-05-16,11706,Distribution,-1000,-8699999,3654000,-5045999
34493,2020-06-30,11706,Value,15747000,-8699999,3654000,-5045999
34493,2020-08-15,11706,Capital Call,-300000,-8999999,3654000,-5345999
34493,2020-08-15,11706,Distribution,3996000,-8999999,7650000,-1349999
34493,2020-09-30,11706,Value,15120000,-8999999,7650000,-1349999
34493,2020-11-15,11706,Capital Call,-100000,-9099999,7650000,-1449999
34493,2020-11-15,11706,Distribution,449000,-9099999,8099000,-1000999
34493,2020-12-31,11706,Value,17472000,-9099999,8099000,-1000999
34493,2021-03-31,11706,Value,17472000,-9099999,8099000,-1000999
34493,2021-05-16,11706,Capital Call,-500000,-9599999,8099000,-1500999
34493,2021-05-16,11706,Distribution,61000,-9599999,8160000,-1439999
34493,2021-06-30,11706,Value,18912000,-9599999,8160000,-1439999
34493,2021-08-15,11706,Capital Call,-300000,-9899999,8160000,-1739999
34493,2021-08-15,11706,Distribution,57000,-9899999,8217000,-1682999
34493,2021-09-30,11706,Value,17523000,-9899999,8217000,-1682999
34604,2020-02-15,375,Distribution,224462,-9222279,830189,-8392090
34604,2020-03-31,375,Value,12565690,-9222279,830189,-8392090
34604,2020-06-30,375,Value,12848880,-9222279,830189,-8392090
34604,2020-08-15,375,Distribution,274919,-9222279,1105108,-8117171
34604,2020-09-30,375,Value,13409060,-9222279,1105108,-8117171
34604,2020-11-15,375,Capital Call,-80000,-9302279,1105108,-8197171
34604,2020-11-15,375,Distribution,343314,-9302279,1448422,-7853857
34604,2020-12-31,375,Value,17348640,-9302279,1448422,-7853857
34604,2021-02-14,375,Capital Call,-161000,-9463279,1448422,-8014857
34604,2021-02-14,375,Distribution,2641107,-9463279,4089529,-5373750
34604,2021-03-31,375,Value,14868530,-9463279,4089529,-5373750
34604,2021-05-16,375,Distribution,959855,-9463279,5049384,-4413895
34604,2021-06-30,375,Value,19976910,-9463279,5049384,-4413895
34882,2020-02-15,538,Capital Call,-50000,-9100000,8823752,-276248
34882,2020-02-15,538,Distribution,94250,-9100000,8918002,-181998
34882,2020-03-31,538,Value,7698600,-9100000,8918002,-181998
34882,2020-05-16,538,Distribution,81900,-9100000,8999902,-100098
34882,2020-06-30,538,Value,8171800,-9100000,8999902,-100098
34882,2020-08-15,538,Capital Call,-90000,-9190000,8999902,-190098
34882,2020-08-15,538,Distribution,-2890,-9190000,8997012,-192988
34882,2020-09-30,538,Value,9640310,-9190000,8997012,-192988
34882,2020-11-15,538,Distribution,468690,-9190000,9465702,275702
34882,2020-12-31,538,Value,9888440,-9190000,9465702,275702
34882,2021-02-14,538,Capital Call,-80000,-9270000,9465702,195702
34882,2021-02-14,538,Distribution,2270120,-9270000,11735822,2465822
34882,2021-03-31,538,Value,7907310,-9270000,11735822,2465822
34882,2021-06-30,538,Value,8954820,-9270000,11735822,2465822
34882,2021-08-15,538,Capital Call,-30000,-9300000,11735822,2435822
34882,2021-08-15,538,Distribution,1349280,-9300000,13085102,3785102
34882,2021-09-30,538,Value,6630900,-9300000,13085102,3785102
34884,2020-03-31,920,Value,7124680,-7048346,508906,-6539440
34884,2020-07-01,920,Capital Call,-1399491,-8447837,508906,-7938931
34884,2020-09-30,920,Value,8625950,-8447837,508906,-7938931
34890,2020-02-15,15278,Capital Call,-33333,-10713332,1726667,-8986665
34890,2020-02-15,15278,Distribution,106667,-10713332,1833334,-8879998
34890,2020-03-31,15278,Value,10300000,-10713332,1833334,-8879998
34890,2020-05-16,15278,Capital Call,-20000,-10733332,1833334,-8899998
34890,2020-05-16,15278,Distribution,53333,-10733332,1886667,-8846665
34890,2020-06-30,15278,Value,10366660,-10733332,1886667,-8846665
34890,2020-08-15,15278,Capital Call,-33333,-10766665,1886667,-8879998
34890,2020-08-15,15278,Distribution,100000,-10766665,1986667,-8779998
34890,2020-09-30,15278,Value,10459990,-10766665,1986667,-8779998
34890,2020-12-31,15278,Value,10459990,-10766665,1986667,-8779998
34890,2021-02-14,15278,Capital Call,-13333,-10779998,1986667,-8793331
34890,2021-02-14,15278,Distribution,1180000,-10779998,3166667,-7613331
34890,2021-03-31,15278,Value,8780000,-10779998,3166667,-7613331
34890,2021-06-30,15278,Value,8626660,-10779998,3166667,-7613331
34890,2021-08-15,15278,Capital Call,-2000,-10781998,3166667,-7615331
34890,2021-08-15,15278,Distribution,149333,-10781998,3316000,-7465998
34890,2021-09-30,15278,Value,8121330,-10781998,3316000,-7465998
34983,2020-02-15,910,Capital Call,-146976,-10477717,2237924,-8239793
34983,2020-02-15,910,Distribution,615275,-10477717,2853199,-7624518
34983,2020-03-31,910,Value,15243620,-10477717,2853199,-7624518
34983,2020-05-16,910,Capital Call,-27081,-10504798,2853199,-7651599
34983,2020-05-16,910,Distribution,330250,-10504798,3183449,-7321349
34983,2020-06-30,910,Value,17040090,-10504798,3183449,-7321349
34983,2020-08-15,910,Capital Call,-29598,-10534396,3183449,-7350947
34983,2020-08-15,910,Distribution,658013,-10534396,3841462,-6692934
34983,2020-09-30,910,Value,21198270,-10534396,3841462,-6692934
34983,2020-11-15,910,Capital Call,-70890,-10605286,3841462,-6763824
34983,2020-11-15,910,Distribution,828836,-10605286,4670298,-5934988
34983,2020-12-31,910,Value,23552740,-10605286,4670298,-5934988
34983,2021-02-14,910,Capital Call,-17262,-10622548,4670298,-5952250
34983,2021-02-14,910,Distribution,3132038,-10622548,7802336,-2820212
34983,2021-03-31,910,Value,31417440,-10622548,7802336,-2820212
35334,2020-02-15,444,Capital Call,-153515,-7566959,5423652,-2143307
35334,2020-02-15,444,Distribution,282739,-7566959,5706391,-1860568
35334,2020-03-31,444,Value,3812200,-7566959,5706391,-1860568
35334,2020-05-16,444,Capital Call,-56689,-7623648,5706391,-1917257
35334,2020-06-30,444,Value,4157190,-7623648,5706391,-1917257
35334,2020-08-15,444,Capital Call,-403684,-8027332,5706391,-2320941
35334,2020-08-15,444,Distribution,208756,-8027332,5915147,-2112185
35334,2020-09-30,444,Value,3718990,-8027332,5915147,-2112185
35334,2020-11-15,444,Distribution,63886,-8027332,5979033,-2048299
35334,2020-12-31,444,Value,4329250,-8027332,5979033,-2048299
35334,2021-02-14,444,Distribution,175300,-8027332,6154333,-1872999
35334,2021-03-31,444,Value,4153950,-8027332,6154333,-1872999
35334,2021-05-16,444,Distribution,268197,-8027332,6422530,-1604802
35334,2021-06-30,444,Value,4718550,-8027332,6422530,-1604802
35386,2020-02-15,50947,Capital Call,-400000,-5893167,1036865,-4856302
35386,2020-03-31,50947,Value,5138550,-5893167,1036865,-4856302
35386,2020-06-30,50947,Value,4156960,-5893167,1036865,-4856302
35386,2020-08-15,50947,Capital Call,-533513,-6426680,1036865,-5389815
35386,2020-08-15,50947,Distribution,171990,-6426680,1208855,-5217825
35386,2020-09-30,50947,Value,5039800,-6426680,1208855,-5217825
35386,2020-11-15,50947,Capital Call,-1337285,-7763965,1208855,-6555110
35386,2020-11-15,50947,Distribution,813832,-7763965,2022687,-5741278
35386,2020-12-31,50947,Value,6323860,-7763965,2022687,-5741278
35386,2021-02-14,50947,Capital Call,-445000,-8208965,2022687,-6186278
35386,2021-03-31,50947,Value,6768860,-8208965,2022687,-6186278
35386,2021-05-16,50947,Capital Call,-300000,-8508965,2022687,-6486278
35386,2021-06-30,50947,Value,9825720,-8508965,2022687,-6486278
35386,2021-08-15,50947,Capital Call,-217634,-8726599,2022687,-6703912
35386,2021-08-15,50947,Distribution,360731,-8726599,2383418,-6343181
35386,2021-09-30,50947,Value,10616370,-8726599,2383418,-6343181
35418,2020-02-15,18,Capital Call,0,-8930073,1065607,-7864466
35418,2020-02-15,18,Distribution,285178,-8930073,1350785,-7579288
35418,2020-03-31,18,Value,14858720,-8930073,1350785,-7579288
35418,2020-06-30,18,Value,17660330,-8930073,1350785,-7579288
35418,2020-08-15,18,Distribution,578908,-8930073,1929693,-7000380
35418,2020-09-30,18,Value,17675180,-8930073,1929693,-7000380
35418,2020-11-15,18,Distribution,587298,-8930073,2516991,-6413082
35418,2020-12-31,18,Value,23030960,-8930073,2516991,-6413082
35418,2021-02-14,18,Distribution,536958,-8930073,3053949,-5876124
35418,2021-03-31,18,Value,22398860,-8930073,3053949,-5876124
35418,2021-05-16,18,Capital Call,-349929,-9280002,3053949,-6226053
35418,2021-05-16,18,Distribution,1182952,-9280002,4236901,-5043101
35418,2021-06-30,18,Value,22826610,-9280002,4236901,-5043101
35418,2021-08-15,18,Distribution,545343,-9280002,4782244,-4497758
35418,2021-09-30,18,Value,20182450,-9280002,4782244,-4497758
35419,2020-02-15,18,Capital Call,145,-8420001,2267418,-6152583
35419,2020-02-15,18,Distribution,-39,-8420001,2267379,-6152622
35419,2020-03-31,18,Value,9900240,-8420001,2267379,-6152622
35419,2020-05-16,18,Distribution,519555,-8420001,2786934,-5633067
35419,2020-06-30,18,Value,10120380,-8420001,2786934,-5633067
35419,2020-08-15,18,Distribution,272388,-8420001,3059322,-5360679
35419,2020-09-30,18,Value,10757270,-8420001,3059322,-5360679
35419,2020-12-31,18,Value,13154770,-8420001,3059322,-5360679
35419,2021-02-14,18,Capital Call,-500000,-8920001,3059322,-5860679
35419,2021-02-14,18,Distribution,978579,-8920001,4037901,-4882100
35419,2021-03-31,18,Value,14295250,-8920001,4037901,-4882100
35419,2021-05-16,18,Capital Call,-99928,-9019929,4037901,-4982028
35419,2021-05-16,18,Distribution,582571,-9019929,4620472,-4399457
35419,2021-06-30,18,Value,15677470,-9019929,4620472,-4399457
35419,2021-08-15,18,Capital Call,-79999,-9099928,4620472,-4479456
35419,2021-08-15,18,Distribution,891559,-9099928,5512031,-3587897
35419,2021-09-30,18,Value,16927840,-9099928,5512031,-3587897
35422,2020-02-15,18,Capital Call,-53,-7695002,3449649,-4245353
35422,2020-02-15,18,Distribution,24,-7695002,3449673,-4245329
35422,2020-03-31,18,Value,7335590,-7695002,3449673,-4245329
35422,2020-05-16,18,Distribution,303554,-7695002,3753227,-3941775
35422,2020-06-30,18,Value,7636420,-7695002,3753227,-3941775
35422,2020-08-15,18,Distribution,342582,-7695002,4095809,-3599193
35422,2020-09-30,18,Value,8343850,-7695002,4095809,-3599193
35422,2020-11-15,18,Distribution,477013,-7695002,4572822,-3122180
35422,2020-12-31,18,Value,10054560,-7695002,4572822,-3122180
35422,2021-02-14,18,Distribution,676491,-7695002,5249313,-2445689
35422,2021-03-31,18,Value,10702090,-7695002,5249313,-2445689
35422,2021-05-16,18,Capital Call,-419945,-8114947,5249313,-2865634
35422,2021-05-16,18,Distribution,1201162,-8114947,6450475,-1664472
35422,2021-06-30,18,Value,11619170,-8114947,6450475,-1664472
35422,2021-08-15,18,Distribution,919328,-8114947,7369803,-745144
35422,2021-09-30,18,Value,12310520,-8114947,7369803,-745144
35432,2020-03-31,451,Capital Call,-23225,-9811778,16164525,6352747
35432,2020-03-31,451,Distribution,195000,-9811778,16359525,6547747
35432,2020-06-30,451,Value,6017860,-9811778,16359525,6547747
35432,2020-09-30,451,Value,6017860,-9811778,16359525,6547747
35432,2020-11-15,451,Distribution,1181250,-9811778,17540775,7728997
35432,2020-12-31,451,Value,4574080,-9811778,17540775,7728997
35432,2021-03-31,451,Value,4574080,-9811778,17540775,7728997
35503,2020-02-15,9343,Distribution,266667,-9213330,4573332,-4639998
35503,2020-03-31,9343,Value,7733330,-9213330,4573332,-4639998
35503,2020-06-30,9343,Value,8040000,-9213330,4573332,-4639998
35503,2020-09-30,9343,Value,8480000,-9213330,4573332,-4639998
35503,2020-11-15,9343,Capital Call,-13333,-9226663,4573332,-4653331
35503,2020-11-15,9343,Distribution,253333,-9226663,4826665,-4399998
35503,2020-12-31,9343,Value,9773330,-9226663,4826665,-4399998
35503,2021-03-31,9343,Value,10213330,-9226663,4826665,-4399998
35503,2021-05-16,9343,Distribution,386667,-9226663,5213332,-4013331
35503,2021-06-30,9343,Value,10053330,-9226663,5213332,-4013331
35503,2021-08-15,9343,Distribution,680000,-9226663,5893332,-3333331
35503,2021-09-30,9343,Value,9720000,-9226663,5893332,-3333331
35552,2020-02-15,212,Capital Call,-7692,-9265382,3430770,-5834612
35552,2020-02-15,212,Distribution,73077,-9265382,3503847,-5761535
35552,2020-03-31,212,Value,8503840,-9265382,3503847,-5761535
35552,2020-05-16,212,Capital Call,-3846,-9269228,3503847,-5765381
35552,2020-05-16,212,Distribution,915385,-9269228,4419232,-4849996
35552,2020-06-30,212,Value,7823070,-9269228,4419232,-4849996
35552,2020-09-30,212,Value,8076920,-9269228,4419232,-4849996
35552,2020-11-15,212,Capital Call,-111538,-9380766,4419232,-4961534
35552,2020-11-15,212,Distribution,1284615,-9380766,5703847,-3676919
35552,2020-12-31,212,Value,7526920,-9380766,5703847,-3676919
35552,2021-02-14,212,Distribution,53846,-9380766,5757693,-3623073
35552,2021-03-31,212,Value,7407690,-9380766,5757693,-3623073
35552,2021-05-16,212,Distribution,934615,-9380766,6692308,-2688458
35552,2021-06-30,212,Value,8361530,-9380766,6692308,-2688458
35552,2021-08-15,212,Capital Call,-385,-9381151,6692308,-2688843
35552,2021-08-15,212,Distribution,161923,-9381151,6854231,-2526920
35552,2021-09-30,212,Value,7930380,-9381151,6854231,-2526920
35584,2020-02-15,5660,Capital Call,-52749,-10440886,7942058,-2498828
35584,2020-03-31,5660,Value,7902610,-10440886,7942058,-2498828
35584,2020-06-30,5660,Value,8360000,-10440886,7942058,-2498828
35584,2020-08-15,5660,Capital Call,-65721,-10506607,7942058,-2564549
35584,2020-08-15,5660,Distribution,371832,-10506607,8313890,-2192717
35584,2020-09-30,5660,Value,8709150,-10506607,8313890,-2192717
35614,2020-02-15,741,Capital Call,97,-10061997,7322847,-2739150
35614,2020-02-15,741,Distribution,22412,-10061997,7345259,-2716738
35614,2020-03-31,741,Value,6932710,-10061997,7345259,-2716738
35614,2020-06-30,741,Value,8291080,-10061997,7345259,-2716738
35614,2020-09-30,741,Value,8955180,-10061997,7345259,-2716738
35614,2020-11-15,741,Distribution,5031,-10061997,7350290,-2711707
35614,2020-12-31,741,Value,9881890,-10061997,7350290,-2711707
35614,2021-03-31,741,Value,10950470,-10061997,7350290,-2711707
35614,2021-06-30,741,Value,11421370,-10061997,7350290,-2711707
35614,2021-09-30,741,Value,11329810,-10061997,7350290,-2711707
35617,2020-06-30,336,Value,0,-8092424,8786583,694159
35617,2020-09-30,336,Value,0,-8092424,8786583,694159
35617,2020-12-31,336,Value,0,-8092424,8786583,694159
35617,2021-03-31,336,Value,0,-8092424,8786583,694159
35617,2021-06-30,336,Value,0,-8092424,8786583,694159
35624,2020-02-15,5175,Capital Call,-170000,-10100000,7739442,-2360558
35624,2020-02-15,5175,Distribution,8268,-10100000,7747710,-2352290
35624,2020-03-31,5175,Value,4993440,-10100000,7747710,-2352290
35624,2020-05-16,5175,Capital Call,-250000,-10350000,7747710,-2602290
35624,2020-05-16,5175,Distribution,300,-10350000,7748010,-2601990
35624,2020-06-30,5175,Value,6541200,-10350000,7748010,-2601990
35624,2020-09-30,5175,Value,7586550,-10350000,7748010,-2601990
35624,2020-12-31,5175,Value,9387450,-10350000,7748010,-2601990
35624,2021-02-14,5175,Capital Call,100000,-10250000,7748010,-2501990
35624,2021-02-14,5175,Distribution,81965,-10250000,7829975,-2420025
35624,2021-03-31,5175,Value,10588250,-10250000,7829975,-2420025
35624,2021-06-30,5175,Value,10537000,-10250000,7829975,-2420025
35624,2021-09-30,5175,Value,11808000,-10250000,7829975,-2420025
35652,2020-02-15,380,Capital Call,-26127,-11046369,2748265,-8298104
35652,2020-03-31,380,Value,11229230,-11046369,2748265,-8298104
35652,2020-05-16,380,Capital Call,-100000,-11146369,2748265,-8398104
35652,2020-06-30,380,Value,11136210,-11146369,2748265,-8398104
35652,2020-08-15,380,Capital Call,-48820,-11195189,2748265,-8446924
35652,2020-09-30,380,Value,11370250,-11195189,2748265,-8446924
35652,2020-12-31,380,Value,11651670,-11195189,2748265,-8446924
35652,2021-03-31,380,Value,11883200,-11195189,2748265,-8446924
35652,2021-06-30,380,Value,12413630,-11195189,2748265,-8446924
35660,2020-03-31,939,Value,7346470,-10339087,5933379,-4405708
35660,2020-06-30,939,Value,9999640,-10339087,5933379,-4405708
35660,2020-08-15,939,Capital Call,-27183,-10366270,5933379,-4432891
35660,2020-08-15,939,Distribution,2649000,-10366270,8582379,-1783891
35660,2020-09-30,939,Value,9080500,-10366270,8582379,-1783891
35660,2020-11-15,939,Capital Call,-71530,-10437800,8582379,-1855421
35660,2020-11-15,939,Distribution,2215462,-10437800,10797841,360041
35660,2020-12-31,939,Value,8631480,-10437800,10797841,360041
35660,2021-02-14,939,Distribution,1433050,-10437800,12230891,1793091
35660,2021-03-31,939,Value,7715260,-10437800,12230891,1793091
35771,2020-02-15,557,Capital Call,-1086000,-9490000,3791044,-5698956
35771,2020-02-15,557,Distribution,1157042,-9490000,4948086,-4541914
35771,2020-03-31,557,Value,7035880,-9490000,4948086,-4541914
35771,2020-05-16,557,Distribution,36062,-9490000,4984148,-4505852
35771,2020-06-30,557,Value,7320580,-9490000,4984148,-4505852
35771,2020-08-15,557,Capital Call,-30000,-9520000,4984148,-4535852
35771,2020-08-15,557,Distribution,-428,-9520000,4983720,-4536280
35771,2020-09-30,557,Value,8217660,-9520000,4983720,-4536280
35771,2020-11-15,557,Distribution,1135736,-9520000,6119456,-3400544
35771,2020-12-31,557,Value,7376090,-9520000,6119456,-3400544
35771,2021-03-31,557,Value,8179580,-9520000,6119456,-3400544
35771,2021-05-16,557,Distribution,39984,-9520000,6159440,-3360560
35771,2021-06-30,557,Value,8681280,-9520000,6159440,-3360560
35771,2021-08-15,557,Capital Call,-610000,-10130000,6159440,-3970560
35771,2021-08-15,557,Distribution,1519100,-10130000,7678540,-2451460
35771,2021-09-30,557,Value,8053350,-10130000,7678540,-2451460
35771,2021-11-15,557,Distribution,20260,-10130000,7698800,-2431200
35771,2021-12-31,557,Value,8195170,-10130000,7698800,-2431200
35874,2020-03-31,576,Value,6413960,-9675000,2925002,-6749998
35874,2020-05-16,576,Distribution,150000,-9675000,3075002,-6599998
35874,2020-06-30,576,Value,4731830,-9675000,3075002,-6599998
35874,2020-08-15,576,Distribution,100000,-9675000,3175002,-6499998
35874,2020-09-30,576,Value,4574820,-9675000,3175002,-6499998
35874,2020-12-31,576,Value,4574820,-9675000,3175002,-6499998
35874,2021-02-14,576,Distribution,149996,-9675000,3324998,-6350002
35874,2021-03-31,576,Value,4620270,-9675000,3324998,-6350002
35874,2021-05-16,576,Capital Call,-100000,-9775000,3324998,-6450002
35874,2021-05-16,576,Distribution,150000,-9775000,3474998,-6300002
35874,2021-06-30,576,Value,5280320,-9775000,3474998,-6300002
35874,2021-08-15,576,Distribution,4,-9775000,3475002,-6299998
35874,2021-09-30,576,Value,5280320,-9775000,3475002,-6299998
35980,2020-02-15,66836,Capital Call,-113000,-10093000,11876200,1783200
35980,2020-02-15,66836,Distribution,235400,-10093000,12111600,2018600
35980,2020-03-31,66836,Value,6459520,-10093000,12111600,2018600
35980,2020-05-16,66836,Capital Call,-362000,-10455000,12111600,1656600
35980,2020-05-16,66836,Distribution,16200,-10455000,12127800,1672800
35980,2020-06-30,66836,Value,7213950,-10455000,12127800,1672800
35980,2020-08-15,66836,Capital Call,-34000,-10489000,12127800,1638800
35980,2020-08-15,66836,Distribution,39440,-10489000,12167240,1678240
35980,2020-09-30,66836,Value,7447190,-10489000,12167240,1678240
35980,2020-11-15,66836,Capital Call,-29000,-10518000,12167240,1649240
35980,2020-11-15,66836,Distribution,1926880,-10518000,14094120,3576120
35980,2020-12-31,66836,Value,6100440,-10518000,14094120,3576120
35980,2021-02-14,66836,Capital Call,-25000,-10543000,14094120,3551120
35980,2021-02-14,66836,Distribution,-71930,-10543000,14022190,3479190
35980,2021-03-31,66836,Value,6220370,-10543000,14022190,3479190
35988,2020-03-31,9110,Value,10987250,-12596086,9401623,-3194463
35988,2020-05-16,9110,Capital Call,88,-12595998,9401623,-3194375
35988,2020-05-16,9110,Distribution,-65,-12595998,9401558,-3194440
35988,2020-06-30,9110,Value,11952340,-12595998,9401558,-3194440
35988,2020-08-15,9110,Capital Call,-272000,-12867998,9401558,-3466440
35988,2020-08-15,9110,Distribution,841372,-12867998,10242930,-2625068
35988,2020-09-30,9110,Value,12493540,-12867998,10242930,-2625068
35988,2020-11-15,9110,Capital Call,-48000,-12915998,10242930,-2673068
35988,2020-11-15,9110,Distribution,549682,-12915998,10792612,-2123386
35988,2020-12-31,9110,Value,13537250,-12915998,10792612,-2123386
35988,2021-02-14,9110,Capital Call,-186000,-13101998,10792612,-2309386
35988,2021-02-14,9110,Distribution,851138,-13101998,11643750,-1458248
35988,2021-03-31,9110,Value,14412200,-13101998,11643750,-1458248
35988,2021-06-30,9110,Value,15456420,-13101998,11643750,-1458248
35988,2021-08-15,9110,Capital Call,-102000,-13203998,11643750,-1560248
35988,2021-08-15,9110,Distribution,1495553,-13203998,13139303,-64695
35988,2021-09-30,9110,Value,13913050,-13203998,13139303,-64695
36078,2020-02-15,2562,Distribution,638400,-8000000,8432000,432000
36078,2020-03-31,2562,Value,11666400,-8000000,8432000,432000
36078,2020-05-16,2562,Distribution,511200,-8000000,8943200,943200
36078,2020-06-30,2562,Value,10939200,-8000000,8943200,943200
36078,2020-08-15,2562,Distribution,640800,-8000000,9584000,1584000
36078,2020-09-30,2562,Value,10704000,-8000000,9584000,1584000
36078,2021-02-14,2562,Distribution,1232000,-8000000,10816000,2816000
36078,2021-06-30,2562,Value,11312000,-8000000,10816000,2816000
36078,2021-09-30,2562,Distribution,1504000,-8000000,12320000,4320000
36078,2021-12-31,2562,Value,11536000,-8000000,12320000,4320000
36124,2020-03-31,709,Value,3477840,-7235424,10115816,2880392
36125,2020-03-31,458,Value,5305590,-8077648,6186713,-1890935
36125,2020-05-16,458,Distribution,336446,-8077648,6523159,-1554489
36125,2020-06-30,458,Value,5002690,-8077648,6523159,-1554489
36125,2020-08-15,458,Distribution,336447,-8077648,6859606,-1218042
36125,2020-09-30,458,Value,5037670,-8077648,6859606,-1218042
36125,2020-11-15,458,Capital Call,-94628,-8172276,6859606,-1312670
36125,2020-11-15,458,Distribution,579817,-8172276,7439423,-732853
36125,2020-12-31,458,Value,5758220,-8172276,7439423,-732853
36125,2021-02-14,458,Distribution,354771,-8172276,7794194,-378082
36125,2021-03-31,458,Value,5385450,-8172276,7794194,-378082
36194,2020-03-31,70490,Value,9405000,-9900000,30987000,21087000
36194,2020-06-30,70490,Value,9504000,-9900000,30987000,21087000
36194,2020-08-15,70490,Distribution,5247000,-9900000,36234000,26334000
36194,2020-09-30,70490,Value,4356000,-9900000,36234000,26334000
36194,2020-12-31,70490,Value,4356000,-9900000,36234000,26334000
36194,2021-03-31,70490,Value,4356000,-9900000,36234000,26334000
36194,2021-06-30,70490,Value,4653000,-9900000,36234000,26334000
36194,2021-09-30,70490,Value,4653000,-9900000,36234000,26334000
36206,2020-02-15,451,Capital Call,-550000,-8263750,1876500,-6387250
36206,2020-02-15,451,Distribution,100000,-8263750,1976500,-6287250
36206,2020-03-31,451,Value,13185330,-8263750,1976500,-6287250
36206,2020-05-16,451,Capital Call,-350000,-8613750,1976500,-6637250
36206,2020-05-16,451,Distribution,299983,-8613750,2276483,-6337267
36206,2020-06-30,451,Value,13637580,-8613750,2276483,-6337267
36206,2020-08-15,451,Distribution,150000,-8613750,2426483,-6187267
36206,2020-09-30,451,Value,14613270,-8613750,2426483,-6187267
36206,2020-11-15,451,Distribution,1049983,-8613750,3476466,-5137284
36206,2020-12-31,451,Value,15641570,-8613750,3476466,-5137284
36206,2021-02-14,451,Distribution,925000,-8613750,4401466,-4212284
36206,2021-03-31,451,Value,15066530,-8613750,4401466,-4212284
36206,2021-05-16,451,Distribution,1750000,-8613750,6151466,-2462284
36206,2021-06-30,451,Value,21476710,-8613750,6151466,-2462284
36206,2021-08-15,451,Distribution,2325000,-8613750,8476466,-137284
36206,2021-09-30,451,Value,4528220,-8613750,8476466,-137284
36245,2020-03-31,3620,Value,10542000,-9712000,3896000,-5816000
36245,2020-05-16,3620,Capital Call,-14000,-9726000,3896000,-5830000
36245,2020-05-16,3620,Distribution,40000,-9726000,3936000,-5790000
36245,2020-06-30,3620,Value,8546000,-9726000,3936000,-5790000
36245,2020-09-30,3620,Value,8674000,-9726000,3936000,-5790000
36245,2020-11-15,3620,Capital Call,-34000,-9760000,3936000,-5824000
36245,2020-12-31,3620,Value,8916000,-9760000,3936000,-5824000
36298,2020-02-15,77,Distribution,89209,-9003138,10401585,1398447
36298,2020-03-31,77,Value,3611030,-9003138,10401585,1398447
36298,2020-05-16,77,Capital Call,-26282,-9029420,10401585,1372165
36298,2020-06-30,77,Value,3558590,-9029420,10401585,1372165
36298,2020-09-30,77,Value,3728380,-9029420,10401585,1372165
36298,2020-11-15,77,Capital Call,-79002,-9108422,10401585,1293163
36298,2020-11-15,77,Distribution,829890,-9108422,11231475,2123053
36298,2020-12-31,77,Value,2852470,-9108422,11231475,2123053
36298,2021-03-31,77,Value,3066150,-9108422,11231475,2123053
36363,2020-02-15,475912,Capital Call,-41431,-11217853,10188456,-1029397
36363,2020-02-15,475912,Distribution,1222299,-11217853,11410755,192902
36363,2020-03-31,475912,Value,5981010,-11217853,11410755,192902
36363,2020-06-30,475912,Value,6346530,-11217853,11410755,192902
36363,2020-08-15,475912,Capital Call,-83760,-11301613,11410755,109142
36363,2020-08-15,475912,Distribution,28518,-11301613,11439273,137660
36363,2020-09-30,475912,Value,7354000,-11301613,11439273,137660
36363,2020-11-15,475912,Capital Call,-18622,-11320235,11439273,119038
36363,2020-11-15,475912,Distribution,349666,-11320235,11788939,468704
36363,2020-12-31,475912,Value,7658100,-11320235,11788939,468704
36363,2021-02-14,475912,Capital Call,-51157,-11371392,11788939,417547
36363,2021-02-14,475912,Distribution,913521,-11371392,12702460,1331068
36363,2021-03-31,475912,Value,8305670,-11371392,12702460,1331068
36396,2020-02-15,355,Capital Call,-125000,-7975000,1772942,-6202058
36396,2020-02-15,355,Distribution,125000,-7975000,1897942,-6077058
36396,2020-03-31,355,Value,7559880,-7975000,1897942,-6077058
36396,2020-06-30,355,Value,7991460,-7975000,1897942,-6077058
36396,2020-09-30,355,Value,8323550,-7975000,1897942,-6077058
36396,2020-11-15,355,Capital Call,-475000,-8450000,1897942,-6552058
36396,2020-11-15,355,Distribution,772114,-8450000,2670056,-5779944
36396,2020-12-31,355,Value,9801720,-8450000,2670056,-5779944
36396,2021-03-31,355,Value,11892850,-8450000,2670056,-5779944
36503,2020-02-15,438,Capital Call,-141873,-8141053,2533551,-5607502
36503,2020-02-15,438,Distribution,2117,-8141053,2535668,-5605385
36503,2020-03-31,438,Value,6825900,-8141053,2535668,-5605385
36503,2020-05-16,438,Capital Call,-842418,-8983471,2535668,-6447803
36503,2020-06-30,438,Value,8022110,-8983471,2535668,-6447803
36616,2020-02-15,733,Capital Call,-232857,-9305713,2142857,-7162856
36616,2020-02-15,733,Distribution,25714,-9305713,2168571,-7137142
36616,2020-03-31,733,Value,9479990,-9305713,2168571,-7137142
36616,2020-05-16,733,Capital Call,-81429,-9387142,2168571,-7218571
36616,2020-05-16,733,Distribution,90000,-9387142,2258571,-7128571
36616,2020-06-30,733,Value,10227140,-9387142,2258571,-7128571
36616,2020-08-15,733,Capital Call,-94286,-9481428,2258571,-7222857
36616,2020-08-15,733,Distribution,1814286,-9481428,4072857,-5408571
36616,2020-09-30,733,Value,9588570,-9481428,4072857,-5408571
36616,2020-11-15,733,Capital Call,-1429,-9482857,4072857,-5410000
36616,2020-11-15,733,Distribution,1227143,-9482857,5300000,-4182857
36616,2020-12-31,733,Value,9734280,-9482857,5300000,-4182857
36616,2021-02-14,733,Capital Call,-52857,-9535714,5300000,-4235714
36616,2021-02-14,733,Distribution,70000,-9535714,5370000,-4165714
36616,2021-03-31,733,Value,11075710,-9535714,5370000,-4165714
36616,2021-05-16,733,Capital Call,-27143,-9562857,5370000,-4192857
36616,2021-05-16,733,Distribution,21429,-9562857,5391429,-4171428
36616,2021-06-30,733,Value,12455710,-9562857,5391429,-4171428
36616,2021-08-15,733,Capital Call,-11429,-9574286,5391429,-4182857
36616,2021-08-15,733,Distribution,4642857,-9574286,10034286,460000
36616,2021-09-30,733,Value,8489990,-9574286,10034286,460000
36701,2020-03-31,15307,Value,15889650,-9339410,2889176,-6450234
36701,2020-05-16,15307,Capital Call,-143572,-9482982,2889176,-6593806
36701,2020-06-30,15307,Value,15975150,-9482982,2889176,-6593806
36701,2020-09-30,15307,Value,16609930,-9482982,2889176,-6593806
36701,2020-12-31,15307,Value,18420710,-9482982,2889176,-6593806
36701,2021-02-14,15307,Capital Call,-69366,-9552348,2889176,-6663172
36701,2021-03-31,15307,Value,19282140,-9552348,2889176,-6663172
36701,2021-06-30,15307,Value,26644620,-9552348,2889176,-6663172
36733,2020-01-15,102023,Distribution,625558,-10000001,4217603,-5782398
36733,2020-02-29,102023,Value,10504440,-10000001,4217603,-5782398
36733,2020-05-31,102023,Value,9972420,-10000001,4217603,-5782398
36733,2020-08-31,102023,Value,10798320,-10000001,4217603,-5782398
36733,2020-10-16,102023,Distribution,222465,-10000001,4440068,-5559933
36733,2020-11-30,102023,Value,11537050,-10000001,4440068,-5559933
36733,2021-01-14,102023,Distribution,7714157,-10000001,12154225,2154224
36733,2021-02-28,102023,Value,6613840,-10000001,12154225,2154224
36733,2021-05-31,102023,Value,6368270,-10000001,12154225,2154224
36733,2021-08-31,102023,Value,6689870,-10000001,12154225,2154224
36733,2021-10-16,102023,Distribution,0,-10000001,12154225,2154224
36733,2021-11-30,102023,Value,6062960,-10000001,12154225,2154224
36770,2020-02-15,368,Capital Call,-550000,-10000000,2355500,-7644500
36770,2020-03-31,368,Value,14298750,-10000000,2355500,-7644500
36770,2020-05-16,368,Distribution,635250,-10000000,2990750,-7009250
36770,2020-06-30,368,Value,14277750,-10000000,2990750,-7009250
36770,2020-08-15,368,Distribution,424250,-10000000,3415000,-6585000
36770,2020-09-30,368,Value,16585000,-10000000,3415000,-6585000
36770,2020-11-15,368,Distribution,3432000,-10000000,6847000,-3153000
36770,2020-12-31,368,Value,13153000,-10000000,6847000,-3153000
36770,2021-03-31,368,Value,17158500,-10000000,6847000,-3153000
36770,2021-06-30,368,Value,19970500,-10000000,6847000,-3153000
36829,2020-03-31,93,Value,10086510,-9149768,4368371,-4781397
36829,2020-05-16,93,Distribution,224186,-9149768,4592557,-4557211
36829,2020-06-30,93,Value,9736740,-9149768,4592557,-4557211
36829,2020-08-15,93,Distribution,307907,-9149768,4900464,-4249304
36829,2020-09-30,93,Value,12517200,-9149768,4900464,-4249304
36829,2020-11-15,93,Distribution,787907,-9149768,5688371,-3461397
36829,2020-12-31,93,Value,10800930,-9149768,5688371,-3461397
36829,2021-03-31,93,Value,10564650,-9149768,5688371,-3461397
36829,2021-06-30,93,Value,14546040,-9149768,5688371,-3461397
36835,2020-02-15,4698,Distribution,-63200,-7900000,5616900,-2283100
36835,2020-03-31,4698,Value,4029000,-7900000,5616900,-2283100
36835,2020-05-16,4698,Capital Call,-100000,-8000000,5616900,-2383100
36835,2020-05-16,4698,Distribution,7100,-8000000,5624000,-2376000
36835,2020-06-30,4698,Value,4208000,-8000000,5624000,-2376000
36835,2020-08-15,4698,Distribution,48000,-8000000,5672000,-2328000
36835,2020-09-30,4698,Value,4856000,-8000000,5672000,-2328000
36835,2020-11-15,4698,Capital Call,-100000,-8100000,5672000,-2428000
36835,2020-11-15,4698,Distribution,-10100,-8100000,5661900,-2438100
36835,2020-12-31,4698,Value,5840100,-8100000,5661900,-2438100
36835,2021-03-31,4698,Value,6569100,-8100000,5661900,-2438100
36835,2021-07-01,4698,Capital Call,-300000,-8400000,5661900,-2738100
36835,2021-07-01,4698,Distribution,562500,-8400000,6224400,-2175600
36835,2021-09-30,4698,Value,8332800,-8400000,6224400,-2175600
36839,2020-07-01,336,Capital Call,-92000,-4732000,0,-4732000
36839,2020-07-01,336,Distribution,3778029,-4732000,3778029,-953971
36839,2020-12-31,336,Value,1089770,-4732000,3778029,-953971
36839,2021-03-31,336,Value,1082200,-4732000,3778029,-953971
36839,2021-06-30,336,Value,1075580,-4732000,3778029,-953971
36839,2021-08-15,336,Distribution,0,-4732000,3778029,-953971
36839,2021-09-30,336,Value,1066590,-4732000,3778029,-953971
36839,2021-12-31,336,Value,1281420,-4732000,3778029,-953971
37139,2020-03-31,7379,Value,2518040,-10580000,9913460,-666540
37139,2020-05-16,7379,Distribution,327980,-10580000,10241440,-338560
37139,2020-06-30,7379,Value,2782540,-10580000,10241440,-338560
37139,2020-08-15,7379,Capital Call,-30000,-10610000,10241440,-368560
37139,2020-08-15,7379,Distribution,-2790,-10610000,10238650,-371350
37139,2020-09-30,7379,Value,2970800,-10610000,10238650,-371350
37139,2020-11-15,7379,Capital Call,-40000,-10650000,10238650,-411350
37139,2020-11-15,7379,Distribution,27950,-10650000,10266600,-383400
37139,2020-12-31,7379,Value,3429300,-10650000,10266600,-383400
37139,2021-02-14,7379,Capital Call,-70000,-10720000,10266600,-453400
37139,2021-02-14,7379,Distribution,46040,-10720000,10312640,-407360
37139,2021-03-31,7379,Value,4223680,-10720000,10312640,-407360
37139,2021-06-30,7379,Value,4223680,-10720000,10312640,-407360
37139,2021-08-15,7379,Capital Call,-40000,-10760000,10312640,-447360
37139,2021-08-15,7379,Distribution,6200,-10760000,10318840,-441160
37139,2021-09-30,7379,Value,5874960,-10760000,10318840,-441160
37139,2021-12-31,7379,Value,6531320,-10760000,10318840,-441160
37210,2020-01-15,367,Capital Call,0,-8027761,2632179,-5395582
37210,2020-01-15,367,Distribution,0,-8027761,2632179,-5395582
37210,2020-02-29,367,Value,10422170,-8027761,2632179,-5395582
37210,2020-04-15,367,Capital Call,0,-8027761,2632179,-5395582
37210,2020-04-15,367,Distribution,0,-8027761,2632179,-5395582
37210,2020-05-31,367,Value,9893080,-8027761,2632179,-5395582
37210,2020-07-16,367,Capital Call,-1238991,-9266752,2632179,-6634573
37210,2020-07-16,367,Distribution,1296373,-9266752,3928552,-5338200
37210,2020-08-31,367,Value,10028970,-9266752,3928552,-5338200
37210,2020-10-16,367,Capital Call,-272143,-9538895,3928552,-5610343
37210,2020-11-30,367,Value,11214210,-9538895,3928552,-5610343
37210,2021-01-14,367,Capital Call,-227610,-9766505,3928552,-5837953
37210,2021-01-14,367,Distribution,878630,-9766505,4807182,-4959323
37210,2021-02-28,367,Value,10563190,-9766505,4807182,-4959323
37210,2021-05-31,367,Value,12717470,-9766505,4807182,-4959323
37210,2021-07-16,367,Capital Call,-267194,-10033699,4807182,-5226517
37210,2021-07-16,367,Distribution,2211106,-10033699,7018288,-3015411
37210,2021-08-31,367,Value,12486970,-10033699,7018288,-3015411
37210,2021-10-16,367,Capital Call,-94013,-10127712,7018288,-3109424
37210,2021-10-16,367,Distribution,4131019,-10127712,11149307,1021595
37210,2021-11-30,367,Value,9774920,-10127712,11149307,1021595
37220,2020-02-15,1314,Capital Call,-274000,-8597000,1562227,-7034773
37220,2020-02-15,1314,Distribution,191561,-8597000,1753788,-6843212
37220,2020-03-31,1314,Value,11090130,-8597000,1753788,-6843212
37220,2020-05-16,1314,Capital Call,-86000,-8683000,1753788,-6929212
37220,2020-05-16,1314,Distribution,178,-8683000,1753966,-6929034
37220,2020-06-30,1314,Value,11616980,-8683000,1753966,-6929034
37220,2020-08-15,1314,Capital Call,-14000,-8697000,1753966,-6943034
37220,2020-08-15,1314,Distribution,150677,-8697000,1904643,-6792357
37220,2020-09-30,1314,Value,12205360,-8697000,1904643,-6792357
37220,2020-11-15,1314,Distribution,147849,-8697000,2052492,-6644508
37220,2020-12-31,1314,Value,14030870,-8697000,2052492,-6644508
37220,2021-02-14,1314,Capital Call,-100000,-8797000,2052492,-6744508
37220,2021-02-14,1314,Distribution,361405,-8797000,2413897,-6383103
37220,2021-03-31,1314,Value,14805350,-8797000,2413897,-6383103
37220,2021-05-16,1314,Capital Call,-200000,-8997000,2413897,-6583103
37220,2021-05-16,1314,Distribution,510128,-8997000,2924025,-6072975
37220,2021-06-30,1314,Value,15902190,-8997000,2924025,-6072975
37220,2021-08-15,1314,Distribution,-22493,-8997000,2901532,-6095468
37220,2021-09-30,1314,Value,15558510,-8997000,2901532,-6095468
37248,2020-02-15,346,Distribution,1379420,-9008702,8457765,-550937
37248,2020-03-31,346,Value,8964060,-9008702,8457765,-550937
37248,2020-06-30,346,Value,8015680,-9008702,8457765,-550937
37248,2020-08-15,346,Capital Call,-177268,-9185970,8457765,-728205
37248,2020-08-15,346,Distribution,2539978,-9185970,10997743,1811773
37248,2020-09-30,346,Value,7385350,-9185970,10997743,1811773
37248,2020-11-15,346,Capital Call,-343877,-9529847,10997743,1467896
37248,2020-11-15,346,Distribution,3800981,-9529847,14798724,5268877
37248,2020-12-31,346,Value,9745430,-9529847,14798724,5268877
37248,2021-02-14,346,Capital Call,-496,-9530343,14798724,5268381
37248,2021-02-14,346,Distribution,712600,-9530343,15511324,5980981
37248,2021-03-31,346,Value,18504740,-9530343,15511324,5980981
37248,2021-05-16,346,Distribution,1535500,-9530343,17046824,7516481
37248,2021-06-30,346,Value,20523810,-9530343,17046824,7516481
37248,2021-08-15,346,Capital Call,-47241,-9577584,17046824,7469240
37248,2021-08-15,346,Distribution,1734089,-9577584,18780913,9203329
37248,2021-09-30,346,Value,21521490,-9577584,18780913,9203329
37250,2020-02-15,7252,Capital Call,2999,-7238141,4354098,-2884043
37250,2020-02-15,7252,Distribution,-3975,-7238141,4350123,-2888018
37250,2020-03-31,7252,Value,5739840,-7238141,4350123,-2888018
37250,2020-05-16,7252,Capital Call,-879774,-8117915,4350123,-3767792
37250,2020-05-16,7252,Distribution,122848,-8117915,4472971,-3644944
37250,2020-06-30,7252,Value,7151880,-8117915,4472971,-3644944
37250,2020-08-15,7252,Capital Call,1941,-8115974,4472971,-3643003
37250,2020-08-15,7252,Distribution,91109,-8115974,4564080,-3551894
37250,2020-09-30,7252,Value,6499450,-8115974,4564080,-3551894
37250,2020-11-15,7252,Capital Call,-182995,-8298969,4564080,-3734889
37250,2020-11-15,7252,Distribution,-464389,-8298969,4099691,-4199278
37250,2020-12-31,7252,Value,8523040,-8298969,4099691,-4199278
37250,2021-02-14,7252,Capital Call,-1032,-8300001,4099691,-4200310
37250,2021-02-14,7252,Distribution,33975,-8300001,4133666,-4166335
37250,2021-03-31,7252,Value,9420500,-8300001,4133666,-4166335
37283,2020-03-31,1360,Distribution,1512407,-8603001,9076165,473164
37283,2020-06-30,1360,Value,7209310,-8603001,9076165,473164
37283,2020-08-15,1360,Distribution,321752,-8603001,9397917,794916
37283,2020-09-30,1360,Value,7237700,-8603001,9397917,794916
37283,2020-11-15,1360,Distribution,656409,-8603001,10054326,1451325
37283,2020-12-31,1360,Value,7394270,-8603001,10054326,1451325
37283,2021-02-14,1360,Distribution,559195,-8603001,10613521,2010520
37283,2021-03-31,1360,Value,7367600,-8603001,10613521,2010520
37283,2021-05-16,1360,Distribution,591026,-8603001,11204547,2601546
37283,2021-06-30,1360,Value,7811520,-8603001,11204547,2601546
37283,2021-08-15,1360,Distribution,1089140,-8603001,12293687,3690686
37283,2021-09-30,1360,Value,6950360,-8603001,12293687,3690686
37320,2020-02-15,579,Capital Call,-160236,-9319288,3561885,-5757403
37320,2020-02-15,579,Distribution,300692,-9319288,3862577,-5456711
37320,2020-03-31,579,Value,10144640,-9319288,3862577,-5456711
37320,2020-05-16,579,Capital Call,-240714,-9560002,3862577,-5697425
37320,2020-05-16,579,Distribution,611502,-9560002,4474079,-5085923
37320,2020-06-30,579,Value,11022680,-9560002,4474079,-5085923
37375,2020-03-31,416,Capital Call,10000,-9700000,5557033,-4142967
37375,2020-03-31,416,Distribution,1590897,-9700000,7147930,-2552070
37375,2020-06-30,416,Value,9207240,-9700000,7147930,-2552070
37375,2020-08-15,416,Distribution,127070,-9700000,7275000,-2425000
37375,2020-09-30,416,Value,9894000,-9700000,7275000,-2425000
37375,2020-11-15,416,Capital Call,180000,-9520000,7275000,-2245000
37375,2020-11-15,416,Distribution,4939160,-9520000,12214160,2694160
37375,2020-12-31,416,Value,5312160,-9520000,12214160,2694160
37375,2021-02-14,416,Distribution,57120,-9520000,12271280,2751280
37375,2021-03-31,416,Value,5588240,-9520000,12271280,2751280
37375,2021-06-30,416,Value,6178480,-9520000,12271280,2751280
37375,2021-09-30,416,Value,6768720,-9520000,12271280,2751280
37379,2020-02-15,18,Capital Call,-154,-8180000,2054074,-6125926
37379,2020-02-15,18,Distribution,39,-8180000,2054113,-6125887
37379,2020-03-31,18,Value,9823370,-8180000,2054113,-6125887
37379,2020-05-16,18,Distribution,375465,-8180000,2429578,-5750422
37379,2020-06-30,18,Value,10401720,-8180000,2429578,-5750422
37379,2020-08-15,18,Distribution,337729,-8180000,2767307,-5412693
37379,2020-09-30,18,Value,10941350,-8180000,2767307,-5412693
37379,2020-12-31,18,Value,13616980,-8180000,2767307,-5412693
37379,2021-02-14,18,Distribution,545273,-8180000,3312580,-4867420
37379,2021-03-31,18,Value,14325790,-8180000,3312580,-4867420
37379,2021-05-16,18,Capital Call,-755000,-8935000,3312580,-5622420
37379,2021-05-16,18,Distribution,1528273,-8935000,4840853,-4094147
37379,2021-06-30,18,Value,15095000,-8935000,4840853,-4094147
37379,2021-08-15,18,Distribution,524518,-8935000,5365371,-3569629
37379,2021-09-30,18,Value,15805000,-8935000,5365371,-3569629
37382,2020-03-31,32667,Value,2232790,-9809738,9283717,-526021
37382,2020-06-30,32667,Value,2327920,-9809738,9283717,-526021
37382,2020-09-30,32667,Value,2445430,-9809738,9283717,-526021
37382,2020-12-31,32667,Value,2462220,-9809738,9283717,-526021
37382,2021-03-31,32667,Value,2534970,-9809738,9283717,-526021
37382,2021-05-16,32667,Distribution,346950,-9809738,9630667,-179071
37382,2021-06-30,32667,Value,2216000,-9809738,9630667,-179071
37382,2021-08-15,32667,Distribution,184667,-9809738,9815334,5596
37382,2021-09-30,32667,Value,2025740,-9809738,9815334,5596
37398,2020-02-15,18,Capital Call,0,-9355087,2218091,-7136996
37398,2020-02-15,18,Distribution,-81,-9355087,2218010,-7137077
37398,2020-03-31,18,Value,7324330,-9355087,2218010,-7137077
37398,2020-05-16,18,Capital Call,-345003,-9700090,2218010,-7482080
37398,2020-06-30,18,Value,7926390,-9700090,2218010,-7482080
37398,2020-08-15,18,Distribution,189509,-9700090,2407519,-7292571
37398,2020-09-30,18,Value,8815100,-9700090,2407519,-7292571
37398,2020-11-15,18,Distribution,280473,-9700090,2687992,-7012098
37398,2020-12-31,18,Value,9511150,-9700090,2687992,-7012098
37398,2021-02-14,18,Distribution,491207,-9700090,3179199,-6520891
37398,2021-03-31,18,Value,10617240,-9700090,3179199,-6520891
37398,2021-05-16,18,Capital Call,93,-9699997,3179199,-6520798
37398,2021-05-16,18,Distribution,-30,-9699997,3179169,-6520828
37398,2021-06-30,18,Value,10543290,-9699997,3179169,-6520828
37398,2021-09-30,18,Value,11895330,-9699997,3179169,-6520828
37399,2020-09-30,105004,Value,11739120,-9839998,3817920,-6022078
37784,2020-02-15,7,Capital Call,-150000,-9650000,4250301,-5399699
37784,2020-02-15,7,Distribution,299675,-9650000,4549976,-5100024
37784,2020-03-31,7,Value,9801500,-9650000,4549976,-5100024
37784,2020-05-16,7,Distribution,1930,-9650000,4551906,-5098094
37784,2020-06-30,7,Value,10972050,-9650000,4551906,-5098094
37784,2020-08-15,7,Capital Call,-150000,-9800000,4551906,-5248094
37784,2020-08-15,7,Distribution,498035,-9800000,5049941,-4750059
37784,2020-09-30,7,Value,12579280,-9800000,5049941,-4750059
37785,2020-02-15,7,Distribution,5820,-9700000,3505580,-6194420
37785,2020-03-31,7,Value,10454660,-9700000,3505580,-6194420
37785,2020-05-16,7,Capital Call,-100000,-9800000,3505580,-6294420
37785,2020-05-16,7,Distribution,303680,-9800000,3809260,-5990740
37785,2020-06-30,7,Value,11453260,-9800000,3809260,-5990740
37785,2020-08-15,7,Capital Call,-50000,-9850000,3809260,-6040740
37785,2020-08-15,7,Distribution,145515,-9850000,3954775,-5895225
37785,2020-09-30,7,Value,13387130,-9850000,3954775,-5895225
37918,2020-03-31,1718,Value,3330000,-9000000,11880000,2880000
37918,2020-06-30,1718,Value,3330000,-9000000,11880000,2880000
37918,2020-09-30,1718,Value,3330000,-9000000,11880000,2880000
37918,2020-12-31,1718,Value,3870000,-9000000,11880000,2880000
37918,2021-03-31,1718,Value,3870000,-9000000,11880000,2880000
37918,2021-05-16,1718,Distribution,270000,-9000000,12150000,3150000
37918,2021-06-30,1718,Value,4770000,-9000000,12150000,3150000
37918,2021-08-15,1718,Distribution,2160000,-9000000,14310000,5310000
37918,2021-09-30,1718,Value,2610000,-9000000,14310000,5310000
37918,2021-12-31,1718,Value,2970000,-9000000,14310000,5310000
37931,2020-02-15,436,Capital Call,-17855,-9903947,4953341,-4950606
37931,2020-03-31,436,Value,9023510,-9903947,4953341,-4950606
37931,2020-05-16,436,Capital Call,-18814,-9922761,4953341,-4969420
37931,2020-05-16,436,Distribution,1821236,-9922761,6774577,-3148184
37931,2020-06-30,436,Value,8234360,-9922761,6774577,-3148184
37931,2020-08-15,436,Capital Call,-18059,-9940820,6774577,-3166243
37931,2020-08-15,436,Distribution,439579,-9940820,7214156,-2726664
37931,2020-09-30,436,Value,8735070,-9940820,7214156,-2726664
37931,2020-11-15,436,Capital Call,-580258,-10521078,7214156,-3306922
37931,2020-11-15,436,Distribution,174069,-10521078,7388225,-3132853
37931,2020-12-31,436,Value,10374420,-10521078,7388225,-3132853
37948,2020-02-15,106403,Capital Call,-90000,-8270000,130880,-8139120
37948,2020-02-15,106403,Distribution,1440,-8270000,132320,-8137680
37948,2020-03-31,106403,Value,10717920,-8270000,132320,-8137680
37948,2020-05-16,106403,Capital Call,-10000,-8280000,132320,-8147680
37948,2020-05-16,106403,Distribution,33280,-8280000,165600,-8114400
37948,2020-06-30,106403,Value,11815560,-8280000,165600,-8114400
37948,2020-08-15,106403,Capital Call,880000,-7400000,165600,-7234400
37948,2020-08-15,106403,Distribution,1958200,-7400000,2123800,-5276200
37948,2020-09-30,106403,Value,8687600,-7400000,2123800,-5276200
37948,2020-11-15,106403,Capital Call,-30000,-7430000,2123800,-5306200
37948,2020-11-15,106403,Distribution,180986,-7430000,2304786,-5125214
37948,2020-12-31,106403,Value,8792660,-7430000,2304786,-5125214
37948,2021-02-14,106403,Capital Call,-170000,-7600000,2304786,-5295214
37948,2021-02-14,106403,Distribution,7134,-7600000,2311920,-5288080
37948,2021-03-31,106403,Value,9272760,-7600000,2311920,-5288080
37948,2021-05-16,106403,Capital Call,-100000,-7700000,2311920,-5388080
37948,2021-05-16,106403,Distribution,22720,-7700000,2334640,-5365360
37948,2021-06-30,106403,Value,9260790,-7700000,2334640,-5365360
37948,2021-08-15,106403,Capital Call,-869000,-8569000,2334640,-6234360
37948,2021-08-15,106403,Distribution,288331,-8569000,2622971,-5946029
37948,2021-09-30,106403,Value,11100280,-8569000,2622971,-5946029
37963,2020-03-31,2304,Value,10511580,-9954436,2138002,-7816434
37963,2020-05-16,2304,Capital Call,-871747,-10826183,2138002,-8688181
37963,2020-05-16,2304,Distribution,1235276,-10826183,3373278,-7452905
37963,2020-06-30,2304,Value,10619500,-10826183,3373278,-7452905
37963,2020-08-15,2304,Capital Call,-789614,-11615797,3373278,-8242519
37963,2020-09-30,2304,Value,13462560,-11615797,3373278,-8242519
37963,2020-11-15,2304,Capital Call,-46179,-11661976,3373278,-8288698
37963,2020-11-15,2304,Distribution,4604329,-11661976,7977607,-3684369
37963,2020-12-31,2304,Value,8904410,-11661976,7977607,-3684369
37963,2021-02-14,2304,Capital Call,-43883,-11705859,7977607,-3728252
37963,2021-03-31,2304,Value,11777060,-11705859,7977607,-3728252
37963,2021-06-30,2304,Value,11710370,-11705859,7977607,-3728252
38012,2020-02-15,5687,Capital Call,0,-9775289,3631399,-6143890
38012,2020-03-31,5687,Value,8471780,-9775289,3631399,-6143890
38012,2020-05-16,5687,Capital Call,0,-9775289,3631399,-6143890
38012,2020-06-30,5687,Value,8863660,-9775289,3631399,-6143890
38012,2020-08-15,5687,Capital Call,-1351581,-11126870,3631399,-7495471
38012,2020-08-15,5687,Distribution,751296,-11126870,4382695,-6744175
38012,2020-09-30,5687,Value,11414790,-11126870,4382695,-6744175
38012,2020-11-15,5687,Capital Call,-75356,-11202226,4382695,-6819531
38012,2020-11-15,5687,Distribution,5207906,-11202226,9590601,-1611625
38012,2020-12-31,5687,Value,7897960,-11202226,9590601,-1611625
38012,2021-02-14,5687,Distribution,193228,-11202226,9783829,-1418397
38012,2021-03-31,5687,Value,8037610,-11202226,9783829,-1418397
38059,2020-03-31,93,Value,9971640,-9125372,11064179,1938807
38059,2020-05-16,93,Distribution,1070149,-9125372,12134328,3008956
38059,2020-06-30,93,Value,8407460,-9125372,12134328,3008956
38059,2020-08-15,93,Distribution,400000,-9125372,12534328,3408956
38059,2020-09-30,93,Value,7691040,-9125372,12534328,3408956
38059,2020-12-31,93,Value,7171640,-9125372,12534328,3408956
38059,2021-03-31,93,Value,7588050,-9125372,12534328,3408956
38059,2021-06-30,93,Value,8322380,-9125372,12534328,3408956
38060,2020-03-31,8072,Value,14630000,-9950000,2992000,-6958000
38060,2020-05-16,8072,Capital Call,-50000,-10000000,2992000,-7008000
38060,2020-06-30,8072,Value,14601000,-10000000,2992000,-7008000
38060,2020-09-30,8072,Value,14846000,-10000000,2992000,-7008000
38060,2020-11-15,8072,Distribution,4886000,-10000000,7878000,-2122000
38060,2020-12-31,8072,Value,11804000,-10000000,7878000,-2122000
38060,2021-02-14,8072,Distribution,1622000,-10000000,9500000,-500000
38060,2021-03-31,8072,Value,13102000,-10000000,9500000,-500000
38060,2021-06-30,8072,Value,16317000,-10000000,9500000,-500000
38065,2020-02-15,1355,Capital Call,-125509,-9568418,8495260,-1073158
38065,2020-02-15,1355,Distribution,36416,-9568418,8531676,-1036742
38065,2020-03-31,1355,Value,6108000,-9568418,8531676,-1036742
38065,2020-05-16,1355,Capital Call,-323398,-9891816,8531676,-1360140
38065,2020-05-16,1355,Distribution,193518,-9891816,8725194,-1166622
38065,2020-06-30,1355,Value,5815780,-9891816,8725194,-1166622
38065,2020-08-15,1355,Capital Call,-49855,-9941671,8725194,-1216477
38065,2020-08-15,1355,Distribution,141645,-9941671,8866839,-1074832
38065,2020-09-30,1355,Value,6343920,-9941671,8866839,-1074832
38065,2020-11-15,1355,Capital Call,-57860,-9999531,8866839,-1132692
38065,2020-11-15,1355,Distribution,928224,-9999531,9795063,-204468
38065,2020-12-31,1355,Value,6004200,-9999531,9795063,-204468
38065,2021-02-14,1355,Capital Call,-26232,-10025763,9795063,-230700
38065,2021-03-31,1355,Value,6947960,-10025763,9795063,-230700
38065,2021-05-16,1355,Capital Call,-101212,-10126975,9795063,-331912
38065,2021-05-16,1355,Distribution,1200115,-10126975,10995178,868203
38065,2021-06-30,1355,Value,6321950,-10126975,10995178,868203
38164,2020-02-15,1590,Capital Call,-87896,-11061408,8209509,-2851899
38164,2020-02-15,1590,Distribution,34374,-11061408,8243883,-2817525
38164,2020-03-31,1590,Value,7145040,-11061408,8243883,-2817525
38164,2020-05-16,1590,Capital Call,-72903,-11134311,8243883,-2890428
38164,2020-05-16,1590,Distribution,14309,-11134311,8258192,-2876119
38164,2020-06-30,1590,Value,7265470,-11134311,8258192,-2876119
38164,2020-08-15,1590,Capital Call,-183049,-11317360,8258192,-3059168
38164,2020-08-15,1590,Distribution,5687,-11317360,8263879,-3053481
38164,2020-09-30,1590,Value,7487790,-11317360,8263879,-3053481
38164,2020-11-15,1590,Capital Call,-133376,-11450736,8263879,-3186857
38164,2020-11-15,1590,Distribution,9022,-11450736,8272901,-3177835
38164,2020-12-31,1590,Value,7878920,-11450736,8272901,-3177835
38164,2021-02-14,1590,Capital Call,-228252,-11678988,8272901,-3406087
38164,2021-02-14,1590,Distribution,17212,-11678988,8290113,-3388875
38164,2021-03-31,1590,Value,8717460,-11678988,8290113,-3388875
38164,2021-05-16,1590,Capital Call,-73368,-11752356,8290113,-3462243
38164,2021-05-16,1590,Distribution,389949,-11752356,8680062,-3072294
38164,2021-06-30,1590,Value,9742330,-11752356,8680062,-3072294
38165,2020-03-31,8396,Value,10449780,-9372000,7414190,-1957810
38165,2020-05-16,8396,Capital Call,-304000,-9676000,7414190,-2261810
38165,2020-05-16,8396,Distribution,530,-9676000,7414720,-2261280
38165,2020-06-30,8396,Value,11825030,-9676000,7414720,-2261280
38165,2020-09-30,8396,Value,14735580,-9676000,7414720,-2261280
38165,2020-11-15,8396,Capital Call,-1010000,-10686000,7414720,-3271280
38165,2020-11-15,8396,Distribution,5508930,-10686000,12923650,2237650
38165,2020-12-31,8396,Value,13451530,-10686000,12923650,2237650
38165,2021-03-31,8396,Value,14670800,-10686000,12923650,2237650
38165,2021-05-16,8396,Distribution,2937581,-10686000,15861231,5175231
38165,2021-06-30,8396,Value,14415410,-10686000,15861231,5175231
38165,2021-09-30,8396,Value,16326070,-10686000,15861231,5175231
38176,2020-03-31,1480,Value,10489090,-10499592,13901460,3401868
38176,2020-05-16,1480,Capital Call,-408,-10500000,13901460,3401460
38176,2020-05-16,1480,Distribution,840540,-10500000,14742000,4242000
38176,2020-06-30,1480,Value,12369000,-10500000,14742000,4242000
38176,2020-09-30,1480,Distribution,5113500,-10500000,19855500,9355500
38176,2020-12-31,1480,Value,11245500,-10500000,19855500,9355500
38176,2021-02-14,1480,Distribution,766500,-10500000,20622000,10122000
38176,2021-03-31,1480,Value,10311000,-10500000,20622000,10122000
38176,2021-07-01,1480,Distribution,910350,-10500000,21532350,11032350
38176,2021-09-30,1480,Value,10862250,-10500000,21532350,11032350
38176,2021-11-15,1480,Capital Call,-100000,-10600000,21532350,10932350
38176,2021-11-15,1480,Distribution,1054130,-10600000,22586480,11986480
38176,2021-12-31,1480,Value,10750520,-10600000,22586480,11986480
38202,2020-03-31,8723,Value,8488690,-9318000,7418060,-1899940
38202,2020-07-01,8723,Capital Call,-438000,-9756000,7418060,-2337940
38202,2020-07-01,8723,Distribution,268693,-9756000,7686753,-2069247
38202,2020-09-30,8723,Value,10634040,-9756000,7686753,-2069247
38202,2020-11-15,8723,Capital Call,-14000,-9770000,7686753,-2083247
38202,2020-11-15,8723,Distribution,284,-9770000,7687037,-2082963
38202,2020-12-31,8723,Value,11156360,-9770000,7687037,-2082963
38202,2021-02-14,8723,Capital Call,134,-9769866,7687037,-2082829
38202,2021-02-14,8723,Distribution,293,-9769866,7687330,-2082536
38202,2021-03-31,8723,Value,11401230,-9769866,7687330,-2082536
38202,2021-05-16,8723,Capital Call,-64637,-9834503,7687330,-2147173
38202,2021-06-30,8723,Value,12416240,-9834503,7687330,-2147173
38208,2020-03-31,100681,Value,3305020,-10040540,12008232,1967692
38208,2020-05-16,100681,Capital Call,-553858,-10594398,12008232,1413834
38208,2020-06-30,100681,Value,3907800,-10594398,12008232,1413834
38208,2020-09-30,100681,Value,4086760,-10594398,12008232,1413834
38208,2020-12-31,100681,Value,4353040,-10594398,12008232,1413834
38208,2021-03-31,100681,Value,4758420,-10594398,12008232,1413834
38278,2020-02-15,24,Distribution,301104,-9050000,6639773,-2410227
38278,2020-03-31,24,Value,3634370,-9050000,6639773,-2410227
38278,2020-05-16,24,Capital Call,0,-9050000,6639773,-2410227
38278,2020-05-16,24,Distribution,211,-9050000,6639984,-2410016
38278,2020-06-30,24,Value,3948510,-9050000,6639984,-2410016
38278,2020-08-15,24,Distribution,614495,-9050000,7254479,-1795521
38278,2020-09-30,24,Value,3498730,-9050000,7254479,-1795521
38278,2020-11-15,24,Capital Call,0,-9050000,7254479,-1795521
38278,2020-11-15,24,Distribution,120,-9050000,7254599,-1795401
38278,2020-12-31,24,Value,3854870,-9050000,7254599,-1795401
38278,2021-02-14,24,Capital Call,0,-9050000,7254599,-1795401
38278,2021-02-14,24,Distribution,138345,-9050000,7392944,-1657056
38278,2021-03-31,24,Value,3723170,-9050000,7392944,-1657056
38278,2021-06-30,24,Value,3894210,-9050000,7392944,-1657056
38278,2021-08-15,24,Distribution,562910,-9050000,7955854,-1094146
38278,2021-09-30,24,Value,3662530,-9050000,7955854,-1094146
38302,2020-02-15,11324,Capital Call,-66667,-10293333,7279999,-3013334
38302,2020-03-31,11324,Value,9520000,-10293333,7279999,-3013334
38302,2020-06-30,11324,Value,10253330,-10293333,7279999,-3013334
38302,2020-08-15,11324,Capital Call,-66667,-10360000,7279999,-3080001
38302,2020-09-30,11324,Value,12066660,-10360000,7279999,-3080001
38302,2020-11-15,11324,Distribution,1906667,-10360000,9186666,-1173334
38302,2020-12-31,11324,Value,10306660,-10360000,9186666,-1173334
38302,2021-02-14,11324,Capital Call,-66667,-10426667,9186666,-1240001
38302,2021-03-31,11324,Value,10093330,-10426667,9186666,-1240001
38302,2021-05-16,11324,Distribution,13333,-10426667,9199999,-1226668
38302,2021-06-30,11324,Value,12440000,-10426667,9199999,-1226668
38302,2021-08-15,11324,Capital Call,-160000,-10586667,9199999,-1386668
38302,2021-08-15,11324,Distribution,1840000,-10586667,11039999,453332
38302,2021-09-30,11324,Value,10293330,-10586667,11039999,453332
38474,2020-03-31,13322,Value,10107000,-9848000,368316,-9479684
38474,2020-05-16,13322,Capital Call,-4000,-9852000,368316,-9483684
38474,2020-05-16,13322,Distribution,150,-9852000,368466,-9483534
38474,2020-06-30,13322,Value,5261950,-9852000,368466,-9483534
38474,2020-09-30,13322,Value,6809700,-9852000,368466,-9483534
38474,2020-11-15,13322,Capital Call,2000,-9850000,368466,-9481534
38474,2020-11-15,13322,Distribution,-11895,-9850000,356571,-9493429
38474,2020-12-31,13322,Value,8521230,-9850000,356571,-9493429
38625,2020-02-15,16154,Capital Call,-200000,-8300000,243000,-8057000
38625,2020-02-15,16154,Distribution,6000,-8300000,249000,-8051000
38625,2020-03-31,16154,Value,7885000,-8300000,249000,-8051000
38625,2020-05-16,16154,Capital Call,-300000,-8600000,249000,-8351000
38625,2020-05-16,16154,Distribution,9000,-8600000,258000,-8342000
38625,2020-06-30,16154,Value,8084000,-8600000,258000,-8342000
38625,2020-08-15,16154,Capital Call,-600000,-9200000,258000,-8942000
38625,2020-08-15,16154,Distribution,11978000,-9200000,12236000,3036000
38625,2020-09-30,16154,Value,7268000,-9200000,12236000,3036000
38625,2020-11-15,16154,Capital Call,-300000,-9500000,12236000,2736000
38625,2020-11-15,16154,Distribution,-76000,-9500000,12160000,2660000
38625,2020-12-31,16154,Value,7315000,-9500000,12160000,2660000
38625,2021-03-31,16154,Value,7220000,-9500000,12160000,2660000
38625,2021-05-16,16154,Capital Call,-300000,-9800000,12160000,2360000
38625,2021-05-16,16154,Distribution,90000,-9800000,12250000,2450000
38625,2021-06-30,16154,Value,7448000,-9800000,12250000,2450000
38625,2021-08-15,16154,Capital Call,-200000,-10000000,12250000,2250000
38625,2021-08-15,16154,Distribution,-450000,-10000000,11800000,1800000
38625,2021-09-30,16154,Value,7700000,-10000000,11800000,1800000
38625,2021-11-15,16154,Distribution,600000,-10000000,12400000,2400000
38625,2021-12-31,16154,Value,7100000,-10000000,12400000,2400000
38793,2020-03-31,109575,Value,12622860,-9692000,2219467,-7472533
38793,2020-06-30,109575,Value,12627700,-9692000,2219467,-7472533
38793,2020-08-15,109575,Capital Call,-93000,-9785000,2219467,-7565533
38793,2020-08-15,109575,Distribution,4235696,-9785000,6455163,-3329837
38793,2020-09-30,109575,Value,9967000,-9785000,6455163,-3329837
38793,2020-12-31,109575,Value,9898500,-9785000,6455163,-3329837
38793,2021-02-14,109575,Capital Call,-15000,-9800000,6455163,-3344837
38793,2021-02-14,109575,Distribution,96,-9800000,6455259,-3344741
38793,2021-03-31,109575,Value,9871540,-9800000,6455259,-3344741
38793,2021-05-16,109575,Capital Call,-68000,-9868000,6455259,-3412741
38793,2021-05-16,109575,Distribution,3370308,-9868000,9825567,-42433
38793,2021-06-30,109575,Value,6131970,-9868000,9825567,-42433
38793,2021-09-30,109575,Value,6717140,-9868000,9825567,-42433
38793,2021-11-15,109575,Capital Call,-46000,-9914000,9825567,-88433
38793,2021-11-15,109575,Distribution,-794,-9914000,9824773,-89227
38793,2021-12-31,109575,Value,6755390,-9914000,9824773,-89227
38952,2020-03-31,304,Value,8998780,-10371610,2189353,-8182257
38952,2020-05-16,304,Capital Call,-166103,-10537713,2189353,-8348360
38952,2020-05-16,304,Distribution,48998,-10537713,2238351,-8299362
38952,2020-06-30,304,Value,9103630,-10537713,2238351,-8299362
38952,2020-08-15,304,Capital Call,-11913,-10549626,2238351,-8311275
38952,2020-09-30,304,Value,10315680,-10549626,2238351,-8311275
38952,2020-11-15,304,Capital Call,-158746,-10708372,2238351,-8470021
38952,2020-11-15,304,Distribution,600000,-10708372,2838351,-7870021
38952,2020-12-31,304,Value,10657590,-10708372,2838351,-7870021
38952,2021-02-14,304,Capital Call,-91365,-10799737,2838351,-7961386
38952,2021-02-14,304,Distribution,2621772,-10799737,5460123,-5339614
38952,2021-03-31,304,Value,8479460,-10799737,5460123,-5339614
38952,2021-05-16,304,Capital Call,770093,-10029644,5460123,-4569521
38952,2021-06-30,304,Value,8960080,-10029644,5460123,-4569521
38953,2020-02-15,673,Distribution,383875,-9175268,2538299,-6636969
38953,2020-03-31,673,Value,16190280,-9175268,2538299,-6636969
38953,2020-05-16,673,Distribution,366854,-9175268,2905153,-6270115
38953,2020-06-30,673,Value,17760650,-9175268,2905153,-6270115
38953,2020-08-15,673,Distribution,333000,-9175268,3238153,-5937115
38953,2020-09-30,673,Value,18876460,-9175268,3238153,-5937115
38953,2020-11-15,673,Distribution,1031375,-9175268,4269528,-4905740
38953,2020-12-31,673,Value,24437390,-9175268,4269528,-4905740
38953,2021-03-31,673,Value,27053670,-9175268,4269528,-4905740
38956,2020-02-15,15,Capital Call,-400000,-8465000,4500000,-3965000
38956,2020-03-31,15,Value,9955000,-8465000,4500000,-3965000
38956,2020-06-30,15,Value,8445000,-8465000,4500000,-3965000
38985,2020-02-15,1878,Distribution,623000,-8900000,2136000,-6764000
38985,2020-03-31,1878,Value,9790000,-8900000,2136000,-6764000
38985,2020-06-30,1878,Value,10769000,-8900000,2136000,-6764000
38985,2020-08-15,1878,Distribution,979000,-8900000,3115000,-5785000
38985,2020-09-30,1878,Value,10947000,-8900000,3115000,-5785000
38985,2020-11-15,1878,Distribution,356000,-8900000,3471000,-5429000
38985,2020-12-31,1878,Value,11659000,-8900000,3471000,-5429000
38985,2021-03-31,1878,Value,12104000,-8900000,3471000,-5429000
38985,2021-05-16,1878,Distribution,1869000,-8900000,5340000,-3560000
38985,2021-06-30,1878,Value,10591000,-8900000,5340000,-3560000
38985,2021-08-15,1878,Distribution,1513000,-8900000,6853000,-2047000
38985,2021-09-30,1878,Value,9434000,-8900000,6853000,-2047000
39022,2020-06-30,13022,Value,11887400,-9538750,6000119,-3538631
39022,2020-08-15,13022,Distribution,544593,-9538750,6544712,-2994038
39022,2020-09-30,13022,Value,19762700,-9538750,6544712,-2994038
39022,2020-11-15,13022,Distribution,800937,-9538750,7345649,-2193101
39022,2020-12-31,13022,Value,18961760,-9538750,7345649,-2193101
39022,2021-02-14,13022,Distribution,9315742,-9538750,16661391,7122641
39022,2021-03-31,13022,Value,10984900,-9538750,16661391,7122641
39108,2020-03-31,872,Value,3033680,-9218777,17494566,8275789
39108,2020-06-30,872,Value,3025510,-9218777,17494566,8275789
39108,2020-09-30,872,Value,3014480,-9218777,17494566,8275789
39108,2020-12-31,872,Value,3007850,-9218777,17494566,8275789
39108,2021-03-31,872,Value,2994320,-9218777,17494566,8275789
39108,2021-06-30,872,Value,2988580,-9218777,17494566,8275789
39110,2020-01-15,65967,Capital Call,-143548,-5616853,2809554,-2807299
39110,2020-01-15,65967,Distribution,483463,-5616853,3293017,-2323836
39110,2020-02-29,65967,Value,8388840,-5616853,3293017,-2323836
39110,2020-04-15,65967,Capital Call,-232269,-5849122,3293017,-2556105
39110,2020-04-15,65967,Distribution,444087,-5849122,3737104,-2112018
39110,2020-05-31,65967,Value,8177020,-5849122,3737104,-2112018
39110,2020-07-16,65967,Capital Call,-285626,-6134748,3737104,-2397644
39110,2020-07-16,65967,Distribution,78850,-6134748,3815954,-2318794
39110,2020-08-31,65967,Value,9524230,-6134748,3815954,-2318794
39110,2020-10-16,65967,Capital Call,-233125,-6367873,3815954,-2551919
39110,2020-10-16,65967,Distribution,118576,-6367873,3934530,-2433343
39110,2020-11-30,65967,Value,9410340,-6367873,3934530,-2433343
39110,2021-01-14,65967,Capital Call,-198685,-6566558,3934530,-2632028
39110,2021-01-14,65967,Distribution,165969,-6566558,4100499,-2466059
39110,2021-02-28,65967,Value,10565990,-6566558,4100499,-2466059
39110,2021-04-15,65967,Capital Call,-416968,-6983526,4100499,-2883027
39110,2021-04-15,65967,Distribution,234573,-6983526,4335072,-2648454
39110,2021-05-31,65967,Value,11106370,-6983526,4335072,-2648454
39110,2021-07-16,65967,Capital Call,-505269,-7488795,4335072,-3153723
39110,2021-07-16,65967,Distribution,489671,-7488795,4824743,-2664052
39110,2021-08-31,65967,Value,15902350,-7488795,4824743,-2664052
39110,2021-10-16,65967,Capital Call,-433244,-7922039,4824743,-3097296
39110,2021-10-16,65967,Distribution,838549,-7922039,5663292,-2258747
39110,2021-11-30,65967,Value,17229820,-7922039,5663292,-2258747
39140,2020-02-15,367,Capital Call,-224479,-6866610,1696034,-5170576
39140,2020-02-15,367,Distribution,0,-6866610,1696034,-5170576
39140,2020-03-31,367,Value,5416790,-6866610,1696034,-5170576
39140,2020-05-16,367,Capital Call,-672849,-7539459,1696034,-5843425
39140,2020-05-16,367,Distribution,0,-7539459,1696034,-5843425
39140,2020-06-30,367,Value,6421320,-7539459,1696034,-5843425
39140,2020-08-15,367,Capital Call,-608995,-8148454,1696034,-6452420
39140,2020-08-15,367,Distribution,119579,-8148454,1815613,-6332841
39140,2020-09-30,367,Value,7365080,-8148454,1815613,-6332841
39140,2020-11-15,367,Distribution,63637,-8148454,1879250,-6269204
39140,2020-12-31,367,Value,9511220,-8148454,1879250,-6269204
39140,2021-02-14,367,Capital Call,-517483,-8665937,1879250,-6786687
39140,2021-02-14,367,Distribution,658889,-8665937,2538139,-6127798
39140,2021-03-31,367,Value,9648060,-8665937,2538139,-6127798
39140,2021-05-16,367,Capital Call,-500928,-9166865,2538139,-6628726
39140,2021-05-16,367,Distribution,1026586,-9166865,3564725,-5602140
39140,2021-06-30,367,Value,9953870,-9166865,3564725,-5602140
39140,2021-08-15,367,Distribution,528645,-9166865,4093370,-5073495
39140,2021-09-30,367,Value,9664320,-9166865,4093370,-5073495
39330,2020-02-15,13324,Capital Call,-11373,-7724048,3919738,-3804310
39330,2020-02-15,13324,Distribution,76037,-7724048,3995775,-3728273
39330,2020-03-31,13324,Value,7162730,-7724048,3995775,-3728273
39330,2020-05-16,13324,Capital Call,-9674,-7733722,3995775,-3737947
39330,2020-05-16,13324,Distribution,35912,-7733722,4031687,-3702035
39330,2020-06-30,13324,Value,7992260,-7733722,4031687,-3702035
39330,2020-08-15,13324,Capital Call,-20024,-7753746,4031687,-3722059
39330,2020-09-30,13324,Value,8244220,-7753746,4031687,-3722059
39330,2020-11-15,13324,Capital Call,-16555,-7770301,4031687,-3738614
39330,2020-11-15,13324,Distribution,11256,-7770301,4042943,-3727358
39330,2020-12-31,13324,Value,8749070,-7770301,4042943,-3727358
39468,2020-02-15,424,Capital Call,-13667,-11266834,7295166,-3971668
39468,2020-02-15,424,Distribution,1162667,-11266834,8457833,-2809001
39468,2020-03-31,424,Value,6710330,-11266834,8457833,-2809001
39468,2020-05-16,424,Capital Call,-13167,-11280001,8457833,-2822168
39468,2020-05-16,424,Distribution,35667,-11280001,8493500,-2786501
39468,2020-06-30,424,Value,7275330,-11280001,8493500,-2786501
39468,2020-08-15,424,Capital Call,-248667,-11528668,8493500,-3035168
39468,2020-08-15,424,Distribution,95500,-11528668,8589000,-2939668
39468,2020-09-30,424,Value,8093990,-11528668,8589000,-2939668
39468,2020-12-31,424,Value,9038000,-11528668,8589000,-2939668
39468,2021-02-14,424,Capital Call,-35667,-11564335,8589000,-2975335
39468,2021-02-14,424,Distribution,3590000,-11564335,12179000,614665
39468,2021-03-31,424,Value,5917330,-11564335,12179000,614665
39468,2021-05-16,424,Capital Call,-7333,-11571668,12179000,607332
39468,2021-05-16,424,Distribution,34500,-11571668,12213500,641832
39468,2021-06-30,424,Value,6153160,-11571668,12213500,641832
39479,2020-02-15,2147,Distribution,482533,-10017067,4890266,-5126801
39479,2020-03-31,2147,Value,5774530,-10017067,4890266,-5126801
39479,2020-05-16,2147,Capital Call,-52400,-10069467,4890266,-5179201
39479,2020-05-16,2147,Distribution,445733,-10069467,5335999,-4733468
39479,2020-06-30,2147,Value,6120660,-10069467,5335999,-4733468
39479,2020-08-15,2147,Capital Call,-115733,-10185200,5335999,-4849201
39479,2020-08-15,2147,Distribution,496267,-10185200,5832266,-4352934
39479,2020-09-30,2147,Value,6889730,-10185200,5832266,-4352934
39479,2020-11-15,2147,Capital Call,-106533,-10291733,5832266,-4459467
39479,2020-11-15,2147,Distribution,635600,-10291733,6467866,-3823867
39479,2020-12-31,2147,Value,6981060,-10291733,6467866,-3823867
39479,2021-03-31,2147,Value,7236930,-10291733,6467866,-3823867
39479,2021-05-16,2147,Capital Call,-55600,-10347333,6467866,-3879467
39479,2021-05-16,2147,Distribution,262800,-10347333,6730666,-3616667
39479,2021-06-30,2147,Value,7202930,-10347333,6730666,-3616667
39480,2020-03-31,2212,Value,6948960,-6651000,500820,-6150180
39480,2020-05-16,2212,Capital Call,-188000,-6839000,500820,-6338180
39480,2020-05-16,2212,Distribution,68185,-6839000,569005,-6269995
39480,2020-06-30,2212,Value,7543410,-6839000,569005,-6269995
39480,2020-08-15,2212,Capital Call,-57000,-6896000,569005,-6326995
39480,2020-08-15,2212,Distribution,-85,-6896000,568920,-6327080
39480,2020-09-30,2212,Value,8341400,-6896000,568920,-6327080
39480,2020-11-15,2212,Capital Call,46000,-6850000,568920,-6281080
39480,2020-11-15,2212,Distribution,24975,-6850000,593895,-6256105
39480,2020-12-31,2212,Value,8923490,-6850000,593895,-6256105
39480,2021-02-14,2212,Capital Call,-26000,-6876000,593895,-6282105
39480,2021-02-14,2212,Distribution,191,-6876000,594086,-6281914
39480,2021-03-31,2212,Value,10179910,-6876000,594086,-6281914
39480,2021-05-16,2212,Capital Call,-27000,-6903000,594086,-6308914
39480,2021-05-16,2212,Distribution,38919,-6903000,633005,-6269995
39480,2021-06-30,2212,Value,12247300,-6903000,633005,-6269995
39480,2021-08-15,2212,Capital Call,-27000,-6930000,633005,-6296995
39480,2021-08-15,2212,Distribution,1567963,-6930000,2200968,-4729032
39480,2021-09-30,2212,Value,10785150,-6930000,2200968,-4729032
39485,2020-02-15,2059,Distribution,506333,-9968999,5085332,-4883667
39485,2020-03-31,2059,Value,16339660,-9968999,5085332,-4883667
39485,2020-05-16,2059,Distribution,556000,-9968999,5641332,-4327667
39485,2020-06-30,2059,Value,18575660,-9968999,5641332,-4327667
39485,2020-08-15,2059,Capital Call,-31000,-9999999,5641332,-4358667
39485,2020-08-15,2059,Distribution,4671333,-9999999,10312665,312666
39485,2020-09-30,2059,Value,17902330,-9999999,10312665,312666
39485,2020-12-31,2059,Value,20034000,-9999999,10312665,312666
39485,2021-03-31,2059,Value,23254330,-9999999,10312665,312666
39485,2021-05-16,2059,Distribution,2526000,-9999999,12838665,2838666
39485,2021-06-30,2059,Value,18286660,-9999999,12838665,2838666
39486,2020-03-31,5813,Value,5053860,-8820000,14614740,5794740
39486,2020-06-30,5813,Value,5344920,-8820000,14614740,5794740
39486,2020-08-15,5813,Distribution,679140,-8820000,15293880,6473880
39486,2020-09-30,5813,Value,4992120,-8820000,15293880,6473880
39486,2020-11-15,5813,Capital Call,-210000,-9030000,15293880,6263880
39486,2020-11-15,5813,Distribution,-15120,-9030000,15278760,6248760
39486,2020-12-31,5813,Value,6239730,-9030000,15278760,6248760
39486,2021-03-31,5813,Value,7774830,-9030000,15278760,6248760
39486,2021-06-30,5813,Value,9201570,-9030000,15278760,6248760
39486,2021-08-15,5813,Distribution,704340,-9030000,15983100,6953100
39486,2021-09-30,5813,Value,8921640,-9030000,15983100,6953100
39486,2021-11-15,5813,Distribution,4406640,-9030000,20389740,11359740
39486,2021-12-31,5813,Value,5535390,-9030000,20389740,11359740
39598,2020-02-15,6691,Distribution,392000,-9800000,6566000,-3234000
39598,2020-03-31,6691,Value,17346000,-9800000,6566000,-3234000
39598,2020-05-16,6691,Distribution,4410000,-9800000,10976000,1176000
39598,2020-06-30,6691,Value,18522000,-9800000,10976000,1176000
39598,2020-08-15,6691,Distribution,4900000,-9800000,15876000,6076000
39598,2020-09-30,6691,Value,22344000,-9800000,15876000,6076000
39598,2020-11-15,6691,Distribution,4998000,-9800000,20874000,11074000
39598,2020-12-31,6691,Value,19698000,-9800000,20874000,11074000
39598,2021-02-14,6691,Distribution,8232000,-9800000,29106000,19306000
39598,2021-03-31,6691,Value,11074000,-9800000,29106000,19306000
39603,2020-02-15,283389,Capital Call,-608894,-9367519,1799762,-7567757
39603,2020-03-31,283389,Value,12370650,-9367519,1799762,-7567757
39603,2020-06-30,283389,Value,12394250,-9367519,1799762,-7567757
39603,2020-08-15,283389,Capital Call,-632481,-10000000,1799762,-8200238
39603,2020-09-30,283389,Value,13314160,-10000000,1799762,-8200238
39603,2020-12-31,283389,Value,13439620,-10000000,1799762,-8200238
39603,2021-03-31,283389,Value,13439620,-10000000,1799762,-8200238
39796,2020-03-31,109772,Value,6600000,-10000000,0,-10000000
39796,2020-06-30,109772,Value,6600000,-10000000,0,-10000000
39796,2020-09-30,109772,Value,6700000,-10000000,0,-10000000
39796,2020-12-31,109772,Value,7900000,-10000000,0,-10000000
39846,2020-02-15,2562,Distribution,1932600,-6000001,4470000,-1530001
39846,2020-03-31,2562,Value,12673800,-6000001,4470000,-1530001
39846,2020-06-30,2562,Value,12673200,-6000001,4470000,-1530001
39846,2020-08-15,2562,Distribution,606000,-6000001,5076000,-924001
39846,2020-09-30,2562,Value,11916000,-6000001,5076000,-924001
39846,2021-02-14,2562,Distribution,480000,-6000001,5556000,-444001
39846,2021-06-30,2562,Value,14220000,-6000001,5556000,-444001
39846,2021-09-30,2562,Distribution,2304000,-6000001,7860000,1859999
39846,2021-12-31,2562,Value,14310000,-6000001,7860000,1859999
39938,2020-02-15,350,Capital Call,-31291,-10469141,6525688,-3943453
39938,2020-02-15,350,Distribution,197144,-10469141,6722832,-3746309
39938,2020-03-31,350,Value,4404740,-10469141,6722832,-3746309
39938,2020-05-16,350,Capital Call,-27642,-10496783,6722832,-3773951
39938,2020-05-16,350,Distribution,935439,-10496783,7658271,-2838512
39938,2020-06-30,350,Value,6850350,-10496783,7658271,-2838512
39938,2020-08-15,350,Capital Call,-40456,-10537239,7658271,-2878968
39938,2020-08-15,350,Distribution,547043,-10537239,8205314,-2331925
39938,2020-09-30,350,Value,7350960,-10537239,8205314,-2331925
39938,2020-11-15,350,Capital Call,-34607,-10571846,8205314,-2366532
39938,2020-11-15,350,Distribution,579723,-10571846,8785037,-1786809
39938,2020-12-31,350,Value,7009870,-10571846,8785037,-1786809
39938,2021-02-14,350,Capital Call,-29222,-10601068,8785037,-1816031
39938,2021-02-14,350,Distribution,490957,-10601068,9275994,-1325074
39938,2021-03-31,350,Value,6683630,-10601068,9275994,-1325074
39955,2020-02-15,140,Capital Call,-20090,-10719413,3771974,-6947439
39955,2020-03-31,140,Value,8748650,-10719413,3771974,-6947439
39955,2020-05-16,140,Capital Call,19906,-10699507,3771974,-6927533
39955,2020-06-30,140,Value,8993380,-10699507,3771974,-6927533
39955,2020-08-15,140,Capital Call,-88208,-10787715,3771974,-7015741
39955,2020-08-15,140,Distribution,1942796,-10787715,5714770,-5072945
39955,2020-09-30,140,Value,7796820,-10787715,5714770,-5072945
39955,2020-11-15,140,Capital Call,16934,-10770781,5714770,-5056011
39955,2020-11-15,140,Distribution,4674,-10770781,5719444,-5051337
39955,2020-12-31,140,Value,9397490,-10770781,5719444,-5051337
39982,2020-03-31,66257,Value,4870870,-5124000,0,-5124000
39982,2020-06-30,66257,Value,5125020,-5124000,0,-5124000
39982,2020-08-15,66257,Capital Call,-96000,-5220000,0,-5220000
39982,2020-09-30,66257,Value,4771080,-5220000,0,-5220000
39982,2020-11-15,66257,Capital Call,-904000,-6124000,0,-6124000
39982,2020-12-31,66257,Value,6161960,-6124000,0,-6124000
39982,2021-02-14,66257,Capital Call,-133000,-6257000,0,-6257000
39982,2021-03-31,66257,Value,6194430,-6257000,0,-6257000
39982,2021-05-16,66257,Capital Call,-592000,-6849000,0,-6849000
39982,2021-06-30,66257,Value,7083920,-6849000,0,-6849000
39982,2021-09-30,66257,Capital Call,-23000,-6872000,0,-6872000
39982,2021-09-30,66257,Distribution,1617669,-6872000,1617669,-5254331
39982,2021-12-31,66257,Value,6498160,-6872000,1617669,-5254331
40053,2020-02-15,14052,Capital Call,-72366,-9973883,6537938,-3435945
40053,2020-02-15,14052,Distribution,525517,-9973883,7063455,-2910428
40053,2020-03-31,14052,Value,10844240,-9973883,7063455,-2910428
40053,2020-05-16,14052,Capital Call,-2181,-9976064,7063455,-2912609
40053,2020-05-16,14052,Distribution,220988,-9976064,7284443,-2691621
40053,2020-06-30,14052,Value,13308690,-9976064,7284443,-2691621
40053,2020-08-15,14052,Capital Call,-27213,-10003277,7284443,-2718834
40053,2020-08-15,14052,Distribution,473893,-10003277,7758336,-2244941
40053,2020-09-30,14052,Value,14175280,-10003277,7758336,-2244941
40053,2020-11-15,14052,Capital Call,-847497,-10850774,7758336,-3092438
40053,2020-11-15,14052,Distribution,670539,-10850774,8428875,-2421899
40053,2020-12-31,14052,Value,15202020,-10850774,8428875,-2421899
40053,2021-02-14,14052,Distribution,439685,-10850774,8868560,-1982214
40053,2021-03-31,14052,Value,16757180,-10850774,8868560,-1982214
40289,2020-03-31,11773,Value,4462510,-8687000,9800675,1113675
40289,2020-05-16,11773,Distribution,869,-8687000,9801544,1114544
40289,2020-06-30,11773,Value,4427760,-8687000,9801544,1114544
40289,2020-08-15,11773,Capital Call,-115000,-8802000,9801544,999544
40289,2020-08-15,11773,Distribution,12688,-8802000,9814232,1012232
40289,2020-09-30,11773,Value,4503100,-8802000,9814232,1012232
40289,2020-12-31,11773,Value,7251080,-8802000,9814232,1012232
40392,2020-03-31,184415,Value,16533890,-11033300,798718,-10234582
40434,2020-02-15,16819,Capital Call,-597866,-8044025,1976499,-6067526
40434,2020-03-31,16819,Value,8404500,-8044025,1976499,-6067526
40434,2020-05-16,16819,Capital Call,-336217,-8380242,1976499,-6403743
40434,2020-06-30,16819,Value,8684040,-8380242,1976499,-6403743
40434,2020-09-30,16819,Value,8867680,-8380242,1976499,-6403743
40434,2020-11-15,16819,Capital Call,-117993,-8498235,1976499,-6521736
40434,2020-11-15,16819,Distribution,2687281,-8498235,4663780,-3834455
40434,2020-12-31,16819,Value,6483840,-8498235,4663780,-3834455
40434,2021-02-14,16819,Capital Call,-40023,-8538258,4663780,-3874478
40434,2021-02-14,16819,Distribution,47470,-8538258,4711250,-3827008
40434,2021-03-31,16819,Value,6677440,-8538258,4711250,-3827008
40434,2021-05-16,16819,Capital Call,-24221,-8562479,4711250,-3851229
40434,2021-06-30,16819,Value,6627390,-8562479,4711250,-3851229
40434,2021-08-15,16819,Capital Call,-81892,-8644371,4711250,-3933121
40434,2021-08-15,16819,Distribution,8480,-8644371,4719730,-3924641
40434,2021-09-30,16819,Value,7024910,-8644371,4719730,-3924641
40651,2020-02-15,458,Capital Call,-275695,-9035119,4391162,-4643957
40651,2020-02-15,458,Distribution,411956,-9035119,4803118,-4232001
40651,2020-03-31,458,Value,6990590,-9035119,4803118,-4232001
40651,2020-05-16,458,Distribution,439642,-9035119,5242760,-3792359
40651,2020-06-30,458,Value,6397320,-9035119,5242760,-3792359
40651,2020-08-15,458,Distribution,151974,-9035119,5394734,-3640385
40651,2020-09-30,458,Value,6198500,-9035119,5394734,-3640385
40651,2020-11-15,458,Distribution,440461,-9035119,5835195,-3199924
40651,2020-12-31,458,Value,6313350,-9035119,5835195,-3199924
40651,2021-02-14,458,Capital Call,-111356,-9146475,5835195,-3311280
40651,2021-02-14,458,Distribution,529738,-9146475,6364933,-2781542
40651,2021-03-31,458,Value,6509000,-9146475,6364933,-2781542
40651,2021-05-16,458,Distribution,407071,-9146475,6772004,-2374471
40651,2021-06-30,458,Value,7195050,-9146475,6772004,-2374471
40665,2020-03-31,2901,Value,7382070,-8954664,7464570,-1490094
40665,2020-05-16,2901,Capital Call,-45336,-9000000,7464570,-1535430
40665,2020-05-16,2901,Distribution,-497659,-9000000,6966911,-2033089
40665,2020-06-30,2901,Value,7495090,-9000000,6966911,-2033089
40665,2020-08-15,2901,Distribution,2033090,-9000000,9000001,1
40665,2020-09-30,2901,Value,6428570,-9000000,9000001,1
40665,2020-11-15,2901,Capital Call,-170000,-9170000,9000001,-169999
40665,2020-11-15,2901,Distribution,734572,-9170000,9734573,564573
40665,2020-12-31,2901,Value,5864000,-9170000,9734573,564573
40665,2021-02-14,2901,Capital Call,-20000,-9190000,9734573,544573
40665,2021-02-14,2901,Distribution,1418037,-9190000,11152610,1962610
40665,2021-03-31,2901,Value,7312240,-9190000,11152610,1962610
40669,2021-06-30,112528,Capital Call,-8690000,-8690000,0,-8690000
40669,2021-06-30,112528,Distribution,5048890,-8690000,5048890,-3641110
40669,2021-06-30,112528,Value,10718240,-8690000,5048890,-3641110
40669,2021-09-30,112528,Capital Call,-210000,-8900000,5048890,-3851110
40669,2021-09-30,112528,Distribution,291110,-8900000,5340000,-3560000
40669,2021-12-31,112528,Value,12905000,-8900000,5340000,-3560000
40676,2021-12-31,334824,Value,0,-7992000,0,-7992000
40703,2020-02-15,2379,Capital Call,-845000,-10280001,5347086,-4932915
40703,2020-02-15,2379,Distribution,77917,-10280001,5425003,-4854998
40703,2020-03-31,2379,Value,8202080,-10280001,5425003,-4854998
40703,2020-05-16,2379,Capital Call,-46250,-10326251,5425003,-4901248
40703,2020-06-30,2379,Value,7591250,-10326251,5425003,-4901248
40703,2020-09-30,2379,Value,7472080,-10326251,5425003,-4901248
40703,2020-11-15,2379,Capital Call,-65000,-10391251,5425003,-4966248
40703,2020-11-15,2379,Distribution,91667,-10391251,5516670,-4874581
40703,2020-12-31,2379,Value,8385000,-10391251,5516670,-4874581
40703,2021-03-31,2379,Value,8615000,-10391251,5516670,-4874581
40703,2021-05-16,2379,Capital Call,-58333,-10449584,5516670,-4932914
40703,2021-05-16,2379,Distribution,28750,-10449584,5545420,-4904164
40703,2021-06-30,2379,Value,10020000,-10449584,5545420,-4904164
40850,2020-03-31,324,Value,0,-5332804,5887410,554606
40850,2020-05-16,324,Capital Call,-1404386,-6737190,5887410,-849780
40850,2020-05-16,324,Distribution,1554118,-6737190,7441528,704338
40850,2020-06-30,324,Value,0,-6737190,7441528,704338
40850,2021-12-31,324,Value,0,-6737190,7441528,704338
40989,2020-02-15,11277,Capital Call,-11250,-10147656,6267509,-3880147
40989,2020-02-15,11277,Distribution,131133,-10147656,6398642,-3749014
40989,2020-03-31,11277,Value,12843620,-10147656,6398642,-3749014
40989,2020-05-16,11277,Capital Call,-28055,-10175711,6398642,-3777069
40989,2020-05-16,11277,Distribution,1264482,-10175711,7663124,-2512587
40989,2020-06-30,11277,Value,13428600,-10175711,7663124,-2512587
40989,2020-08-15,11277,Capital Call,-36410,-10212121,7663124,-2548997
40989,2020-08-15,11277,Distribution,1673577,-10212121,9336701,-875420
40989,2020-09-30,11277,Value,14102820,-10212121,9336701,-875420
40989,2020-11-15,11277,Capital Call,-10125,-10222246,9336701,-885545
40989,2020-11-15,11277,Distribution,1125264,-10222246,10461965,239719
40989,2020-12-31,11277,Value,15798910,-10222246,10461965,239719
40989,2021-02-14,11277,Capital Call,-36313,-10258559,10461965,203406
40989,2021-02-14,11277,Distribution,1439796,-10258559,11901761,1643202
40989,2021-03-31,11277,Value,17049960,-10258559,11901761,1643202
41027,2020-02-15,20804,Capital Call,-52000,-8824000,3552660,-5271340
41027,2020-02-15,20804,Distribution,-118,-8824000,3552542,-5271458
41027,2020-03-31,20804,Value,8884000,-8824000,3552542,-5271458
41027,2020-06-30,20804,Value,9021650,-8824000,3552542,-5271458
41027,2020-08-15,20804,Capital Call,-51000,-8875000,3552542,-5322458
41027,2020-08-15,20804,Distribution,120,-8875000,3552662,-5322338
41027,2020-09-30,20804,Value,9359570,-8875000,3552662,-5322338
41027,2020-12-31,20804,Value,9587660,-8875000,3552662,-5322338
41027,2021-02-14,20804,Capital Call,-27000,-8902000,3552662,-5349338
41027,2021-02-14,20804,Distribution,-765,-8902000,3551897,-5350103
41027,2021-03-31,20804,Value,10390410,-8902000,3551897,-5350103
41042,2020-02-15,1632,Distribution,1220672,-11334000,20431803,9097803
41042,2020-03-31,1632,Value,8607030,-11334000,20431803,9097803
41042,2020-05-16,1632,Capital Call,-57000,-11391000,20431803,9040803
41042,2020-05-16,1632,Distribution,2855959,-11391000,23287762,11896762
41042,2020-06-30,1632,Value,9129880,-11391000,23287762,11896762
41042,2020-08-15,1632,Distribution,1081006,-11391000,24368768,12977768
41042,2020-09-30,1632,Value,8260750,-11391000,24368768,12977768
41042,2020-11-15,1632,Distribution,669791,-11391000,25038559,13647559
41042,2020-12-31,1632,Value,7867760,-11391000,25038559,13647559
41042,2021-02-14,1632,Distribution,-22782,-11391000,25015777,13624777
41042,2021-03-31,1632,Value,8925980,-11391000,25015777,13624777
41042,2021-05-16,1632,Distribution,3117717,-11391000,28133494,16742494
41042,2021-06-30,1632,Value,8218600,-11391000,28133494,16742494
41042,2021-09-30,1632,Value,9725630,-11391000,28133494,16742494
41059,2020-03-31,116384,Value,32395000,-9500000,1900000,-7600000
41059,2020-07-01,116384,Capital Call,-500000,-10000000,1900000,-8100000
41059,2020-07-01,116384,Distribution,200000,-10000000,2100000,-7900000
41059,2020-09-30,116384,Value,32800000,-10000000,2100000,-7900000
41088,2020-02-15,5571,Distribution,-8047,-5500000,6308500,808500
41088,2020-03-31,5571,Value,2425500,-5500000,6308500,808500
41088,2020-05-16,5571,Distribution,8047,-5500000,6316547,816547
41088,2020-06-30,5571,Value,2415840,-5500000,6316547,816547
41088,2020-09-30,5571,Value,2673620,-5500000,6316547,816547
41088,2020-11-15,5571,Distribution,259253,-5500000,6575800,1075800
41088,2020-12-31,5571,Value,3279650,-5500000,6575800,1075800
41088,2021-02-14,5571,Distribution,-260,-5500000,6575540,1075540
41088,2021-03-31,5571,Value,3288170,-5500000,6575540,1075540
41088,2021-06-30,5571,Value,3154280,-5500000,6575540,1075540
41088,2021-08-15,5571,Distribution,260,-5500000,6575800,1075800
41088,2021-09-30,5571,Value,3102000,-5500000,6575800,1075800
41188,2020-03-31,296,Value,4144000,-7400000,7474000,74000
41188,2020-06-30,296,Value,3996000,-7400000,7474000,74000
41342,2020-02-15,598,Capital Call,-150000,-6080000,0,-6080000
41342,2020-03-31,598,Value,8512000,-6080000,0,-6080000
41342,2020-05-16,598,Capital Call,-890000,-6970000,0,-6970000
41342,2020-06-30,598,Value,8782200,-6970000,0,-6970000
41342,2020-08-15,598,Capital Call,-480000,-7450000,0,-7450000
41342,2020-09-30,598,Value,9908500,-7450000,0,-7450000
41342,2020-11-15,598,Capital Call,-20000,-7470000,0,-7470000
41342,2020-12-31,598,Value,13894200,-7470000,0,-7470000
41342,2021-02-14,598,Capital Call,-490000,-7960000,0,-7960000
41342,2021-02-14,598,Distribution,10825600,-7960000,10825600,2865600
41342,2021-03-31,598,Value,4457600,-7960000,10825600,2865600
41342,2021-05-16,598,Distribution,-636800,-7960000,10188800,2228800
41342,2021-06-30,598,Value,5810800,-7960000,10188800,2228800
41342,2021-08-15,598,Capital Call,-580000,-8540000,10188800,1648800
41342,2021-08-15,598,Distribution,2194200,-8540000,12383000,3843000
41342,2021-09-30,598,Value,4953200,-8540000,12383000,3843000
41342,2021-11-15,598,Capital Call,-100000,-8640000,12383000,3743000
41342,2021-11-15,598,Distribution,58600,-8640000,12441600,3801600
41342,2021-12-31,598,Value,5270400,-8640000,12441600,3801600
41569,2020-01-15,13139,Capital Call,-1316,-9483382,164192,-9319190
41569,2020-01-15,13139,Distribution,255742,-9483382,419934,-9063448
41569,2020-02-29,13139,Value,12331230,-9483382,419934,-9063448
41569,2020-05-31,13139,Value,11913180,-9483382,419934,-9063448
41569,2020-07-16,13139,Capital Call,-147220,-9630602,419934,-9210668
41569,2020-08-31,13139,Value,12278680,-9630602,419934,-9210668
41569,2020-10-16,13139,Capital Call,-82992,-9713594,419934,-9293660
41569,2020-10-16,13139,Distribution,107834,-9713594,527768,-9185826
41569,2020-11-30,13139,Value,13145300,-9713594,527768,-9185826
41569,2021-01-14,13139,Capital Call,-157306,-9870900,527768,-9343132
41569,2021-02-28,13139,Value,14583350,-9870900,527768,-9343132
41569,2021-04-15,13139,Capital Call,-44690,-9915590,527768,-9387822
41569,2021-05-31,13139,Value,16655260,-9915590,527768,-9387822
41569,2021-07-16,13139,Capital Call,-224754,-10140344,527768,-9612576
41569,2021-08-31,13139,Value,17665630,-10140344,527768,-9612576
41569,2021-10-16,13139,Capital Call,-265434,-10405778,527768,-9878010
41569,2021-10-16,13139,Distribution,2461832,-10405778,2989600,-7416178
41569,2021-11-30,13139,Value,14967920,-10405778,2989600,-7416178
41635,2020-03-31,124,Value,8910420,-10053749,3608373,-6445376
41635,2020-06-30,124,Value,9511810,-10053749,3608373,-6445376
41635,2020-08-15,124,Capital Call,-87135,-10140884,3608373,-6532511
41635,2020-08-15,124,Distribution,1176627,-10140884,4785000,-5355884
41635,2020-09-30,124,Value,9508030,-10140884,4785000,-5355884
41635,2020-11-15,124,Distribution,80826,-10140884,4865826,-5275058
41635,2020-12-31,124,Value,10572230,-10140884,4865826,-5275058
41673,2020-03-31,8734,Value,0,-9793527,9133227,-660300
41673,2020-06-30,8734,Value,0,-9793527,9133227,-660300
41673,2020-09-30,8734,Value,0,-9793527,9133227,-660300
41673,2020-12-31,8734,Value,0,-9793527,9133227,-660300
41673,2021-03-31,8734,Value,0,-9793527,9133227,-660300
41673,2021-06-30,8734,Value,0,-9793527,9133227,-660300
41673,2021-09-30,8734,Value,0,-9793527,9133227,-660300
41673,2021-12-31,8734,Value,0,-9793527,9133227,-660300
41876,2020-03-31,355,Value,13801090,-9555744,8209118,-1346626
41876,2020-05-16,355,Distribution,418883,-9555744,8628001,-927743
41876,2020-06-30,355,Value,15378020,-9555744,8628001,-927743
41876,2020-08-15,355,Distribution,711164,-9555744,9339165,-216579
41876,2020-09-30,355,Value,17897160,-9555744,9339165,-216579
41876,2020-12-30,355,Distribution,2879289,-9555744,12218454,2662710
41876,2021-03-31,355,Value,20729390,-9555744,12218454,2662710
41885,2020-01-15,14497,Capital Call,-187500,-8987500,8230515,-756985
41885,2020-01-15,14497,Distribution,0,-8987500,8230515,-756985
41885,2020-02-29,14497,Value,8384100,-8987500,8230515,-756985
41885,2020-04-15,14497,Distribution,0,-8987500,8230515,-756985
41885,2020-05-31,14497,Value,8281730,-8987500,8230515,-756985
41885,2020-07-16,14497,Capital Call,-150000,-9137500,8230515,-906985
41885,2020-07-16,14497,Distribution,111111,-9137500,8341626,-795874
41885,2020-08-31,14497,Value,8496520,-9137500,8341626,-795874
41885,2020-11-30,14497,Value,8578230,-9137500,8341626,-795874
41885,2021-02-28,14497,Value,9728820,-9137500,8341626,-795874
41885,2021-04-15,14497,Capital Call,-187500,-9325000,8341626,-983374
41885,2021-05-31,14497,Value,10362850,-9325000,8341626,-983374
41885,2021-07-16,14497,Distribution,536965,-9325000,8878591,-446409
41885,2021-08-31,14497,Value,9058040,-9325000,8878591,-446409
41885,2021-10-16,14497,Distribution,0,-9325000,8878591,-446409
41885,2021-11-30,14497,Value,9315340,-9325000,8878591,-446409
41911,2020-02-15,1759,Capital Call,-120827,-9207847,2726106,-6481741
41911,2020-02-15,1759,Distribution,138455,-9207847,2864561,-6343286
41911,2020-03-31,1759,Value,9023680,-9207847,2864561,-6343286
41911,2020-05-16,1759,Capital Call,-262625,-9470472,2864561,-6605911
41911,2020-05-16,1759,Distribution,262589,-9470472,3127150,-6343322
41911,2020-06-30,1759,Value,9754580,-9470472,3127150,-6343322
41911,2020-08-15,1759,Capital Call,-13529,-9484001,3127150,-6356851
41911,2020-08-15,1759,Distribution,4467,-9484001,3131617,-6352384
41911,2020-09-30,1759,Value,10811760,-9484001,3131617,-6352384
41911,2020-11-15,1759,Capital Call,-150000,-9634001,3131617,-6502384
41911,2020-11-15,1759,Distribution,1015820,-9634001,4147437,-5486564
41911,2020-12-31,1759,Value,10982760,-9634001,4147437,-5486564
41911,2021-02-14,1759,Capital Call,-276000,-9910001,4147437,-5762564
41911,2021-02-14,1759,Distribution,1441803,-9910001,5589240,-4320761
41911,2021-03-31,1759,Value,10901000,-9910001,5589240,-4320761
41911,2021-05-16,1759,Capital Call,-361000,-10271001,5589240,-4681761
41911,2021-05-16,1759,Distribution,573360,-10271001,6162600,-4108401
41911,2021-06-30,1759,Value,12325200,-10271001,6162600,-4108401
41911,2021-08-15,1759,Capital Call,-229000,-10500001,6162600,-4337401
41911,2021-08-15,1759,Distribution,1092900,-10500001,7255500,-3244501
41911,2021-09-30,1759,Value,12075000,-10500001,7255500,-3244501
42086,2020-02-15,4955,Capital Call,-171695,-9568591,51248,-9517343
42086,2020-03-31,4955,Value,8461400,-9568591,51248,-9517343
42086,2020-05-16,4955,Capital Call,28375,-9540216,51248,-9488968
42086,2020-06-30,4955,Value,10267530,-9540216,51248,-9488968
42086,2020-08-15,4955,Capital Call,87729,-9452487,51248,-9401239
42086,2020-08-15,4955,Distribution,602525,-9452487,653773,-8798714
42086,2020-09-30,4955,Value,10955750,-9452487,653773,-8798714
42086,2020-11-15,4955,Capital Call,-68910,-9521397,653773,-8867624
42086,2020-12-31,4955,Value,15073830,-9521397,653773,-8867624
42086,2021-02-14,4955,Capital Call,-33007,-9554404,653773,-8900631
42086,2021-02-14,4955,Distribution,1819156,-9554404,2472929,-7081475
42086,2021-03-31,4955,Value,14603910,-9554404,2472929,-7081475
42153,2020-03-31,6198,Value,3890050,-10163469,13017913,2854444
42153,2020-05-16,6198,Capital Call,-27526,-10190995,13017913,2826918
42153,2020-05-16,6198,Distribution,27526,-10190995,13045439,2854444
42153,2020-06-30,6198,Value,3177030,-10190995,13045439,2854444
42153,2020-09-30,6198,Value,3288640,-10190995,13045439,2854444
42153,2021-03-31,6198,Value,4007440,-10190995,13045439,2854444
42155,2020-01-15,9323,Capital Call,-305000,-10000001,0,-10000001
42155,2020-02-29,9323,Value,9155590,-10000001,0,-10000001
42155,2020-05-31,9323,Value,9126800,-10000001,0,-10000001
42155,2020-08-31,9323,Value,8670700,-10000001,0,-10000001
42155,2020-11-30,9323,Value,7905430,-10000001,0,-10000001
42155,2021-02-28,9323,Value,9451410,-10000001,0,-10000001
42155,2021-05-31,9323,Value,9451410,-10000001,0,-10000001
42155,2021-08-31,9323,Value,8480410,-10000001,0,-10000001
42155,2021-11-30,9323,Value,8396730,-10000001,0,-10000001
42207,2020-02-15,337,Distribution,1410000,-10195000,10300000,105000
42207,2020-03-31,337,Value,9382150,-10195000,10300000,105000
42207,2020-05-16,337,Capital Call,-105000,-10300000,10300000,0
42207,2020-06-30,337,Value,11069310,-10300000,10300000,0
42207,2020-08-15,337,Distribution,2242612,-10300000,12542612,2242612
42207,2020-09-30,337,Value,10971070,-10300000,12542612,2242612
42207,2020-11-15,337,Distribution,4019713,-10300000,16562325,6262325
42207,2020-12-31,337,Value,8203260,-10300000,16562325,6262325
42207,2021-03-31,337,Value,8868170,-10300000,16562325,6262325
42207,2021-06-30,337,Value,10345360,-10300000,16562325,6262325
42207,2021-08-15,337,Distribution,4474124,-10300000,21036449,10736449
42207,2021-09-30,337,Value,6317170,-10300000,21036449,10736449
42362,2020-03-31,690,Value,13698600,-9050000,11853800,2803800
42362,2020-05-16,690,Capital Call,-300000,-9350000,11853800,2503800
42362,2020-06-30,690,Value,14749200,-9350000,11853800,2503800
42362,2020-09-30,690,Value,29948400,-9350000,11853800,2503800
42362,2020-11-15,690,Distribution,3003800,-9350000,14857600,5507600
42362,2020-12-31,690,Value,23972400,-9350000,14857600,5507600
42362,2021-03-31,690,Value,28703600,-9350000,14857600,5507600
42362,2021-05-16,690,Distribution,3252200,-9350000,18109800,8759800
42362,2021-06-30,690,Value,25377400,-9350000,18109800,8759800
42459,2020-02-15,1886,Distribution,225000,-10000000,9274894,-725106
42459,2020-03-31,1886,Value,4475070,-10000000,9274894,-725106
42459,2020-05-16,1886,Distribution,-34894,-10000000,9240000,-760000
42459,2020-06-30,1886,Value,5201000,-10000000,9240000,-760000
42459,2020-09-30,1886,Value,5126000,-10000000,9240000,-760000
42459,2020-11-15,1886,Distribution,-10000,-10000000,9230000,-770000
42459,2020-12-31,1886,Value,4948000,-10000000,9230000,-770000
42459,2021-02-14,1886,Distribution,-55000,-10000000,9175000,-825000
42459,2021-03-31,1886,Value,5176000,-10000000,9175000,-825000
42459,2021-06-30,1886,Value,4915000,-10000000,9175000,-825000
42459,2021-08-15,1886,Distribution,1915000,-10000000,11090000,1090000
42459,2021-09-30,1886,Value,2984000,-10000000,11090000,1090000
42518,2020-02-15,558,Capital Call,-125000,-12750000,17575000,4825000
42518,2020-02-15,558,Distribution,1225000,-12750000,18800000,6050000
42518,2020-03-31,558,Value,13525000,-12750000,18800000,6050000
42518,2020-05-16,558,Capital Call,-225000,-12975000,18800000,5825000
42518,2020-05-16,558,Distribution,2775000,-12975000,21575000,8600000
42518,2020-06-30,558,Value,13350000,-12975000,21575000,8600000
42518,2020-08-15,558,Capital Call,-400000,-13375000,21575000,8200000
42518,2020-08-15,558,Distribution,1125000,-13375000,22700000,9325000
42518,2020-09-30,558,Value,12475000,-13375000,22700000,9325000
42518,2020-11-15,558,Capital Call,-150000,-13525000,22700000,9175000
42518,2020-11-15,558,Distribution,1900000,-13525000,24600000,11075000
42518,2020-12-31,558,Value,12450000,-13525000,24600000,11075000
42518,2021-03-31,558,Value,10675000,-13525000,24600000,11075000
42518,2021-05-16,558,Capital Call,-200000,-13725000,24600000,10875000
42518,2021-05-16,558,Distribution,400000,-13725000,25000000,11275000
42518,2021-06-30,558,Value,10125000,-13725000,25000000,11275000
42518,2021-09-30,558,Value,9925000,-13725000,25000000,11275000
42576,2020-02-15,2166,Capital Call,-25537,-10128688,6427238,-3701450
42576,2020-02-15,2166,Distribution,2570271,-10128688,8997509,-1131179
42576,2020-03-31,2166,Value,8343290,-10128688,8997509,-1131179
42576,2020-05-16,2166,Capital Call,-229891,-10358579,8997509,-1361070
42576,2020-05-16,2166,Distribution,381485,-10358579,9378994,-979585
42576,2020-06-30,2166,Value,9571740,-10358579,9378994,-979585
42576,2020-09-30,2166,Value,12175490,-10358579,9378994,-979585
42576,2020-11-15,2166,Capital Call,-193610,-10552189,9378994,-1173195
42576,2020-11-15,2166,Distribution,1516233,-10552189,10895227,343038
42576,2020-12-31,2166,Value,11244390,-10552189,10895227,343038
42576,2021-02-14,2166,Capital Call,-20060,-10572249,10895227,322978
42576,2021-02-14,2166,Distribution,1617820,-10572249,12513047,1940798
42576,2021-03-31,2166,Value,9791350,-10572249,12513047,1940798
42614,2020-03-31,173,Value,8155350,-8630000,3559875,-5070125
42614,2020-06-30,173,Value,9526650,-8630000,3559875,-5070125
42614,2020-08-15,173,Capital Call,-32000,-8662000,3559875,-5102125
42614,2020-08-15,173,Distribution,32256,-8662000,3592131,-5069869
42614,2020-09-30,173,Value,9551580,-8662000,3592131,-5069869
42614,2020-12-30,173,Distribution,192296,-8662000,3784427,-4877573
42614,2021-03-31,173,Value,11621800,-8662000,3784427,-4877573
42614,2021-07-01,173,Distribution,4207133,-8662000,7991560,-670440
42614,2021-09-30,173,Value,11136730,-8662000,7991560,-670440
42631,2020-01-01,8361,Capital Call,-1285000,-8615000,3943540,-4671460
42631,2020-01-01,8361,Distribution,2130,-8615000,3945670,-4669330
42631,2020-12-31,8361,Value,11285650,-8615000,3945670,-4669330
42667,2020-03-31,16605,Value,13542250,-9499999,318250,-9181749
42667,2020-05-16,16605,Capital Call,-250000,-9749999,318250,-9431749
42667,2020-05-16,16605,Distribution,575,-9749999,318825,-9431174
42667,2020-06-30,16605,Value,14478750,-9749999,318825,-9431174
42667,2020-09-30,16605,Value,16224000,-9749999,318825,-9431174
42667,2020-12-31,16605,Value,17270170,-9749999,318825,-9431174
42667,2021-03-31,16605,Value,17193150,-9749999,318825,-9431174
42667,2021-06-30,16605,Value,17075170,-9749999,318825,-9431174
42667,2021-08-15,16605,Distribution,10910250,-9749999,11229075,1479076
42667,2021-09-30,16605,Value,5738850,-9749999,11229075,1479076
42667,2021-11-15,16605,Capital Call,-195000,-9944999,11229075,1284076
42667,2021-11-15,16605,Distribution,224581,-9944999,11453656,1508657
42667,2021-12-31,16605,Value,5853620,-9944999,11453656,1508657
42677,2020-02-15,672,Capital Call,-350000,-8849305,1821385,-7027920
42677,2020-02-15,672,Distribution,62956,-8849305,1884341,-6964964
42677,2020-03-31,672,Value,11886620,-8849305,1884341,-6964964
42677,2020-05-16,672,Capital Call,-100000,-8949305,1884341,-7064964
42677,2020-05-16,672,Distribution,92824,-8949305,1977165,-6972140
42677,2020-06-30,672,Value,11635970,-8949305,1977165,-6972140
42677,2020-08-15,672,Capital Call,-100000,-9049305,1977165,-7072140
42677,2020-08-15,672,Distribution,658660,-9049305,2635825,-6413480
42677,2020-09-30,672,Value,11620130,-9049305,2635825,-6413480
42677,2020-11-15,672,Capital Call,-80000,-9129305,2635825,-6493480
42677,2020-11-15,672,Distribution,226570,-9129305,2862395,-6266910
42677,2020-12-31,672,Value,11473560,-9129305,2862395,-6266910
42677,2021-02-14,672,Distribution,312510,-9129305,3174905,-5954400
42677,2021-03-31,672,Value,11725330,-9129305,3174905,-5954400
42737,2020-03-31,296,Value,7446000,-7300000,2555000,-4745000
42737,2020-06-30,296,Value,8030000,-7300000,2555000,-4745000
42737,2020-11-14,296,Distribution,897170,-7300000,3452170,-3847830
42737,2021-03-31,296,Value,11036870,-7300000,3452170,-3847830
42737,2021-05-16,296,Distribution,1047550,-7300000,4499720,-2800280
42737,2021-06-30,296,Value,10618580,-7300000,4499720,-2800280
42737,2021-08-15,296,Distribution,1026380,-7300000,5526100,-1773900
42737,2021-09-30,296,Value,9896610,-7300000,5526100,-1773900
42864,2020-03-31,10966,Value,0,-7018040,9096591,2078551
42864,2020-06-30,10966,Value,0,-7018040,9096591,2078551
42864,2020-09-30,10966,Value,0,-7018040,9096591,2078551
42864,2020-12-31,10966,Value,0,-7018040,9096591,2078551
42864,2021-03-31,10966,Value,0,-7018040,9096591,2078551
42864,2021-06-30,10966,Value,0,-7018040,9096591,2078551
42908,2020-05-16,5655,Capital Call,-1309000,-10000000,2550808,-7449192
42908,2020-05-16,5655,Distribution,1000192,-10000000,3551000,-6449000
42908,2020-12-31,5655,Value,8241000,-10000000,3551000,-6449000
42908,2021-03-31,5655,Value,8290000,-10000000,3551000,-6449000
42908,2021-05-16,5655,Distribution,899000,-10000000,4450000,-5550000
42908,2021-06-30,5655,Value,8360000,-10000000,4450000,-5550000
42908,2021-09-30,5655,Value,8220000,-10000000,4450000,-5550000
42908,2021-11-15,5655,Distribution,2890000,-10000000,7340000,-2660000
42908,2021-12-31,5655,Value,5726000,-10000000,7340000,-2660000
43146,2020-02-15,18619,Capital Call,-128329,-6618216,6368396,-249820
43146,2020-02-15,18619,Distribution,135859,-6618216,6504255,-113961
43146,2020-03-31,18619,Value,3132130,-6618216,6504255,-113961
43146,2020-05-16,18619,Capital Call,-82754,-6700970,6504255,-196715
43146,2020-05-16,18619,Distribution,164662,-6700970,6668917,-32053
43146,2020-06-30,18619,Value,3026930,-6700970,6668917,-32053
43146,2020-08-15,18619,Capital Call,-13660,-6714630,6668917,-45713
43146,2020-08-15,18619,Distribution,248504,-6714630,6917421,202791
43146,2020-09-30,18619,Value,2423960,-6714630,6917421,202791
43146,2020-11-15,18619,Capital Call,-3953,-6718583,6917421,198838
43146,2020-11-15,18619,Distribution,152928,-6718583,7070349,351766
43146,2020-12-31,18619,Value,2413240,-6718583,7070349,351766
43146,2021-02-14,18619,Capital Call,-41262,-6759845,7070349,310504
43146,2021-02-14,18619,Distribution,183977,-6759845,7254326,494481
43146,2021-03-31,18619,Value,2468830,-6759845,7254326,494481
43146,2021-05-16,18619,Capital Call,-22073,-6781918,7254326,472408
43146,2021-05-16,18619,Distribution,215058,-6781918,7469384,687466
43146,2021-06-30,18619,Value,2664550,-6781918,7469384,687466
43146,2021-08-15,18619,Distribution,154336,-6781918,7623720,841802
43146,2021-09-30,18619,Value,2942340,-6781918,7623720,841802
43184,2020-03-31,10352,Value,8575930,-9002273,2870398,-6131875
43184,2020-06-30,10352,Value,6518600,-9002273,2870398,-6131875
43184,2020-08-15,10352,Capital Call,-325785,-9328058,2870398,-6457660
43184,2020-09-30,10352,Value,8047880,-9328058,2870398,-6457660
43184,2020-12-31,10352,Value,8047880,-9328058,2870398,-6457660
43184,2021-03-31,10352,Value,8047880,-9328058,2870398,-6457660
43184,2021-06-30,10352,Value,7831200,-9328058,2870398,-6457660
43184,2021-08-15,10352,Distribution,610556,-9328058,3480954,-5847104
43184,2021-09-30,10352,Value,7220640,-9328058,3480954,-5847104
43282,2020-02-15,123760,Distribution,1962000,-9810000,2177820,-7632180
43282,2020-03-31,123760,Value,11889720,-9810000,2177820,-7632180
43282,2020-12-30,123760,Capital Call,-136400,-9946400,2177820,-7768580
43282,2020-12-30,123760,Distribution,7404,-9946400,2185224,-7761176
43282,2021-09-30,123760,Value,16481180,-9946400,2185224,-7761176
43317,2020-02-15,306,Capital Call,-324410,-10619925,4894896,-5725029
43317,2020-02-15,306,Distribution,3737839,-10619925,8632735,-1987190
43317,2020-03-31,306,Value,5968020,-10619925,8632735,-1987190
43317,2020-06-30,306,Value,6369430,-10619925,8632735,-1987190
43317,2020-08-15,306,Capital Call,-375484,-10995409,8632735,-2362674
43317,2020-08-15,306,Distribution,32048,-10995409,8664783,-2330626
43317,2020-09-30,306,Value,7133700,-10995409,8664783,-2330626
43317,2020-11-15,306,Distribution,431581,-10995409,9096364,-1899045
43317,2020-12-31,306,Value,7165420,-10995409,9096364,-1899045
43317,2021-02-14,306,Capital Call,-24730,-11020139,9096364,-1923775
43317,2021-02-14,306,Distribution,473080,-11020139,9569444,-1450695
43317,2021-03-31,306,Value,7269710,-11020139,9569444,-1450695
43317,2021-05-16,306,Capital Call,-30709,-11050848,9569444,-1481404
43317,2021-05-16,306,Distribution,410337,-11050848,9979781,-1071067
43317,2021-06-30,306,Value,7759840,-11050848,9979781,-1071067
43355,2020-02-15,13158,Distribution,627229,-9200000,1547229,-7652771
43355,2020-03-31,13158,Value,16143120,-9200000,1547229,-7652771
43355,2020-05-16,13158,Distribution,1095720,-9200000,2642949,-6557051
43355,2020-06-30,13158,Value,16681790,-9200000,2642949,-6557051
43355,2020-08-15,13158,Distribution,506000,-9200000,3148949,-6051051
43355,2020-09-30,13158,Value,17037820,-9200000,3148949,-6051051
43355,2020-11-15,13158,Distribution,658341,-9200000,3807290,-5392710
43355,2020-12-31,13158,Value,21919930,-9200000,3807290,-5392710
43355,2021-02-14,13158,Distribution,165600,-9200000,3972890,-5227110
43355,2021-03-31,13158,Value,25199300,-9200000,3972890,-5227110
43362,2020-03-31,4170,Value,0,-10600001,20119999,9519998
43362,2020-06-30,4170,Value,0,-10600001,20119999,9519998
43362,2020-09-30,4170,Value,0,-10600001,20119999,9519998
43362,2020-12-31,4170,Value,0,-10600001,20119999,9519998
43362,2021-03-31,4170,Value,0,-10600001,20119999,9519998
43362,2021-06-30,4170,Value,0,-10600001,20119999,9519998
43362,2021-09-30,4170,Value,0,-10600001,20119999,9519998
43362,2021-12-31,4170,Value,0,-10600001,20119999,9519998
43400,2020-02-15,231,Capital Call,-800000,-8399999,0,-8399999
43400,2020-03-31,231,Value,10341240,-8399999,0,-8399999
43400,2020-05-16,231,Capital Call,-550000,-8949999,0,-8949999
43400,2020-06-30,231,Value,10797280,-8949999,0,-8949999
43400,2020-08-15,231,Capital Call,-100000,-9049999,0,-9049999
43400,2020-09-30,231,Value,10847330,-9049999,0,-9049999
43400,2020-12-31,231,Value,14625700,-9049999,0,-9049999
43400,2021-02-14,231,Capital Call,-300000,-9349999,0,-9349999
43400,2021-03-31,231,Value,15380750,-9349999,0,-9349999
43400,2021-06-30,231,Value,24418460,-9349999,0,-9349999
43400,2021-08-15,231,Capital Call,-650000,-9999999,0,-9999999
43400,2021-09-30,231,Value,19179000,-9999999,0,-9999999
43400,2021-12-31,231,Value,18586000,-9999999,0,-9999999
43428,2020-02-15,18,Capital Call,-229991,-9027075,1900042,-7127033
43428,2020-02-15,18,Distribution,378,-9027075,1900420,-7126655
43428,2020-03-31,18,Value,8820300,-9027075,1900420,-7126655
43428,2020-05-16,18,Capital Call,-288003,-9315078,1900420,-7414658
43428,2020-06-30,18,Value,10100540,-9315078,1900420,-7414658
43428,2020-08-15,18,Distribution,178339,-9315078,2078759,-7236319
43428,2020-09-30,18,Value,10486410,-9315078,2078759,-7236319
43428,2020-11-15,18,Distribution,257476,-9315078,2336235,-6978843
43428,2020-12-31,18,Value,10975160,-9315078,2336235,-6978843
43428,2021-02-14,18,Distribution,516067,-9315078,2852302,-6462776
43428,2021-03-31,18,Value,11536690,-9315078,2852302,-6462776
43428,2021-05-16,18,Capital Call,87,-9314991,2852302,-6462689
43428,2021-05-16,18,Distribution,-27,-9314991,2852275,-6462716
43428,2021-06-30,18,Value,11949140,-9314991,2852275,-6462716
43428,2021-09-30,18,Value,13094470,-9314991,2852275,-6462716
43429,2020-02-15,18,Capital Call,0,-9054999,631203,-8423796
43429,2020-02-15,18,Distribution,188,-9054999,631391,-8423608
43429,2020-03-31,18,Value,14464360,-9054999,631391,-8423608
43429,2020-06-30,18,Value,17210990,-9054999,631391,-8423608
43429,2020-09-30,18,Value,17730400,-9054999,631391,-8423608
43429,2020-11-15,18,Distribution,404738,-9054999,1036129,-8018870
43429,2020-12-31,18,Value,22692030,-9054999,1036129,-8018870
43429,2021-02-14,18,Distribution,331885,-9054999,1368014,-7686985
43429,2021-03-31,18,Value,22111680,-9054999,1368014,-7686985
43429,2021-05-16,18,Capital Call,-350000,-9404999,1368014,-8036985
43429,2021-05-16,18,Distribution,1481701,-9404999,2849715,-6555284
43429,2021-06-30,18,Value,22212720,-9404999,2849715,-6555284
43429,2021-08-15,18,Distribution,193747,-9404999,3043462,-6361537
43429,2021-09-30,18,Value,20793510,-9404999,3043462,-6361537
43430,2020-02-15,18,Capital Call,-205,-8019998,1658695,-6361303
43430,2020-02-15,18,Distribution,42,-8019998,1658737,-6361261
43430,2020-03-31,18,Value,9628340,-8019998,1658737,-6361261
43430,2020-06-30,18,Value,10749590,-8019998,1658737,-6361261
43430,2020-09-30,18,Value,11740850,-8019998,1658737,-6361261
43430,2020-11-15,18,Capital Call,-110000,-8129998,1658737,-6471261
43430,2020-11-15,18,Distribution,303100,-8129998,1961837,-6168161
43430,2020-12-31,18,Value,14286600,-8129998,1961837,-6168161
43430,2021-02-14,18,Distribution,399018,-8129998,2360855,-5769143
43430,2021-03-31,18,Value,15183120,-8129998,2360855,-5769143
43430,2021-05-16,18,Capital Call,-695000,-8824998,2360855,-6464143
43430,2021-05-16,18,Distribution,1711172,-8824998,4072027,-4752971
43430,2021-06-30,18,Value,15868720,-8824998,4072027,-4752971
43430,2021-08-15,18,Capital Call,-125000,-8949998,4072027,-4877971
43430,2021-08-15,18,Distribution,853284,-8949998,4925311,-4024687
43430,2021-09-30,18,Value,16391960,-8949998,4925311,-4024687
43431,2020-02-15,18,Capital Call,1278,-7095000,1087262,-6007738
43431,2020-02-15,18,Distribution,-196,-7095000,1087066,-6007934
43431,2020-03-31,18,Value,8470790,-7095000,1087066,-6007934
43431,2020-06-30,18,Value,9304430,-7095000,1087066,-6007934
43431,2020-09-30,18,Value,10972530,-7095000,1087066,-6007934
43431,2020-11-15,18,Distribution,376902,-7095000,1463968,-5631032
43431,2020-12-31,18,Value,13264130,-7095000,1463968,-5631032
43431,2021-02-14,18,Capital Call,-500000,-7595000,1463968,-6131032
43431,2021-02-14,18,Distribution,1043425,-7595000,2507393,-5087607
43431,2021-03-31,18,Value,14449960,-7595000,2507393,-5087607
43431,2021-05-16,18,Capital Call,-499852,-8094852,2507393,-5587459
43431,2021-05-16,18,Distribution,2443825,-8094852,4951218,-3143634
43431,2021-06-30,18,Value,14625680,-8094852,4951218,-3143634
43432,2020-02-15,18,Capital Call,14,-8035165,2420370,-5614795
43432,2020-02-15,18,Distribution,-4,-8035165,2420366,-5614799
43432,2020-03-31,18,Value,8972090,-8035165,2420366,-5614799
43432,2020-06-30,18,Value,9834300,-8035165,2420366,-5614799
43432,2020-09-30,18,Value,10775330,-8035165,2420366,-5614799
43432,2020-12-31,18,Value,13282220,-8035165,2420366,-5614799
43432,2021-02-14,18,Capital Call,-500010,-8535175,2420366,-6114809
43432,2021-02-14,18,Distribution,956275,-8535175,3376641,-5158534
43432,2021-03-31,18,Value,14460050,-8535175,3376641,-5158534
43432,2021-05-16,18,Capital Call,-324828,-8860003,3376641,-5483362
43432,2021-05-16,18,Distribution,938601,-8860003,4315242,-4544761
43432,2021-06-30,18,Value,15757060,-8860003,4315242,-4544761
43432,2021-08-15,18,Distribution,971644,-8860003,5286886,-3573117
43432,2021-09-30,18,Value,16750940,-8860003,5286886,-3573117
43464,2020-03-31,906,Value,14408820,-9700000,0,-9700000
43464,2020-06-30,906,Value,12697330,-9700000,0,-9700000
43464,2020-09-30,906,Value,15971900,-9700000,0,-9700000
43464,2020-11-15,906,Distribution,591109,-9700000,591109,-9108891
43464,2020-12-31,906,Value,15940000,-9700000,591109,-9108891
43464,2021-02-14,906,Distribution,1181818,-9700000,1772927,-7927073
43464,2021-03-31,906,Value,17770770,-9700000,1772927,-7927073
43506,2020-02-15,2389,Capital Call,0,-9657358,6985567,-2671791
43506,2020-02-15,2389,Distribution,0,-9657358,6985567,-2671791
43506,2020-03-31,2389,Value,15684650,-9657358,6985567,-2671791
43506,2020-05-16,2389,Capital Call,-136719,-9794077,6985567,-2808510
43506,2020-05-16,2389,Distribution,0,-9794077,6985567,-2808510
43506,2020-06-30,2389,Value,20052060,-9794077,6985567,-2808510
43506,2020-11-14,2389,Capital Call,-550498,-10344575,6985567,-3359008
43506,2020-11-14,2389,Distribution,17014681,-10344575,24000248,13655673
43506,2021-03-31,2389,Value,12500330,-10344575,24000248,13655673
43506,2021-05-16,2389,Capital Call,-390625,-10735200,24000248,13265048
43506,2021-06-30,2389,Value,14697570,-10735200,24000248,13265048
43506,2021-08-15,2389,Capital Call,-120891,-10856091,24000248,13144157
43506,2021-08-15,2389,Distribution,504743,-10856091,24504991,13648900
43506,2021-09-30,2389,Value,15385750,-10856091,24504991,13648900
43597,2020-02-15,812,Capital Call,-10667,-6919332,769333,-6149999
43597,2020-02-15,812,Distribution,686667,-6919332,1456000,-5463332
43597,2020-03-31,812,Value,9868000,-6919332,1456000,-5463332
43597,2020-05-16,812,Capital Call,-10667,-6929999,1456000,-5473999
43597,2020-05-16,812,Distribution,94000,-6929999,1550000,-5379999
43597,2020-06-30,812,Value,8864000,-6929999,1550000,-5379999
43597,2020-08-15,812,Capital Call,-10000,-6939999,1550000,-5389999
43597,2020-08-15,812,Distribution,27333,-6939999,1577333,-5362666
43597,2020-09-30,812,Value,10579330,-6939999,1577333,-5362666
43597,2020-11-15,812,Capital Call,-10000,-6949999,1577333,-5372666
43597,2020-11-15,812,Distribution,568667,-6949999,2146000,-4803999
43597,2020-12-31,812,Value,10010000,-6949999,2146000,-4803999
43597,2021-02-14,812,Capital Call,-9333,-6959332,2146000,-4813332
43597,2021-02-14,812,Distribution,179333,-6959332,2325333,-4633999
43597,2021-03-31,812,Value,12011330,-6959332,2325333,-4633999
43597,2021-05-16,812,Capital Call,-9333,-6968665,2325333,-4643332
43597,2021-05-16,812,Distribution,376667,-6968665,2702000,-4266665
43597,2021-06-30,812,Value,12703330,-6968665,2702000,-4266665
43611,2020-03-31,1360,Value,7112490,-8712500,2850000,-5862500
43611,2020-05-16,1360,Distribution,300000,-8712500,3150000,-5562500
43611,2020-06-30,1360,Value,8725000,-8712500,3150000,-5562500
43615,2020-03-31,1360,Value,10178500,-8742548,879468,-7863080
43615,2020-05-16,1360,Capital Call,-560665,-9303213,879468,-8423745
43615,2020-05-16,1360,Distribution,192483,-9303213,1071951,-8231262
43615,2020-06-30,1360,Value,12405690,-9303213,1071951,-8231262
43615,2020-09-30,1360,Value,12481750,-9303213,1071951,-8231262
43615,2020-12-30,1360,Distribution,215649,-9303213,1287600,-8015613
43615,2021-03-31,1360,Value,15954250,-9303213,1287600,-8015613
43662,2020-02-15,28564,Capital Call,-357688,-12674859,8071828,-4603031
43662,2020-03-31,28564,Value,9298500,-12674859,8071828,-4603031
43662,2020-05-16,28564,Distribution,149441,-12674859,8221269,-4453590
43662,2020-06-30,28564,Value,9286440,-12674859,8221269,-4453590
43662,2020-08-15,28564,Capital Call,-174946,-12849805,8221269,-4628536
43662,2020-08-15,28564,Distribution,136246,-12849805,8357515,-4492290
43662,2020-09-30,28564,Value,9448170,-12849805,8357515,-4492290
43662,2020-11-15,28564,Capital Call,-56388,-12906193,8357515,-4548678
43662,2020-11-15,28564,Distribution,1711017,-12906193,10068532,-2837661
43662,2020-12-31,28564,Value,8671270,-12906193,10068532,-2837661
43662,2021-02-14,28564,Distribution,154853,-12906193,10223385,-2682808
43662,2021-03-31,28564,Value,8716690,-12906193,10223385,-2682808
43830,2020-02-15,9281,Capital Call,47933,-5400185,866034,-4534151
43830,2020-02-15,9281,Distribution,3818,-5400185,869852,-4530333
43830,2020-03-31,9281,Value,5649890,-5400185,869852,-4530333
43830,2020-05-16,9281,Capital Call,-60611,-5460796,869852,-4590944
43830,2020-05-16,9281,Distribution,2903342,-5460796,3773194,-1687602
43830,2020-06-30,9281,Value,2843800,-5460796,3773194,-1687602
43830,2020-08-15,9281,Capital Call,-975947,-6436743,3773194,-2663549
43830,2020-09-30,9281,Value,3939000,-6436743,3773194,-2663549
43830,2020-11-15,9281,Capital Call,-1510837,-7947580,3773194,-4174386
43830,2020-11-15,9281,Distribution,1951,-7947580,3775145,-4172435
43830,2020-12-31,9281,Value,5618870,-7947580,3775145,-4172435
43830,2021-02-14,9281,Capital Call,-76000,-8023580,3775145,-4248435
43830,2021-03-31,9281,Value,5471410,-8023580,3775145,-4248435
43832,2020-02-15,802,Distribution,1027476,-8927007,5198307,-3728700
43832,2020-03-31,802,Value,9474350,-8927007,5198307,-3728700
43832,2020-05-16,802,Capital Call,-44989,-8971996,5198307,-3773689
43832,2020-06-30,802,Value,8635030,-8971996,5198307,-3773689
43832,2020-08-15,802,Capital Call,-217023,-9189019,5198307,-3990712
43832,2020-08-15,802,Distribution,888091,-9189019,6086398,-3102621
43832,2020-09-30,802,Value,9294520,-9189019,6086398,-3102621
43832,2020-11-15,802,Capital Call,-263268,-9452287,6086398,-3365889
43832,2020-11-15,802,Distribution,2107855,-9452287,8194253,-1258034
43832,2020-12-31,802,Value,10210020,-9452287,8194253,-1258034
43832,2021-02-14,802,Capital Call,-114495,-9566782,8194253,-1372529
43832,2021-02-14,802,Distribution,274033,-9566782,8468286,-1098496
43832,2021-03-31,802,Value,10765650,-9566782,8468286,-1098496
43832,2021-05-16,802,Capital Call,-158411,-9725193,8468286,-1256907
43832,2021-06-30,802,Value,13425770,-9725193,8468286,-1256907
43832,2021-08-15,802,Distribution,1886538,-9725193,10354824,629631
43832,2021-09-30,802,Value,12630860,-9725193,10354824,629631
43843,2020-02-15,1189,Capital Call,-900000,-8600000,0,-8600000
43843,2020-03-31,1189,Value,9087710,-8600000,0,-8600000
43843,2020-06-30,1189,Value,8938070,-8600000,0,-8600000
43843,2020-09-30,1189,Value,9087720,-8600000,0,-8600000
43843,2020-11-15,1189,Capital Call,-400000,-9000000,0,-9000000
43843,2020-12-31,1189,Value,9529320,-9000000,0,-9000000
43843,2021-03-31,1189,Value,9632040,-9000000,0,-9000000
43843,2021-05-16,1189,Capital Call,-400000,-9400000,0,-9400000
43843,2021-06-30,1189,Value,10206460,-9400000,0,-9400000
43873,2020-02-15,244,Distribution,1244000,-9136000,1988000,-7148000
43873,2020-03-31,244,Value,8596000,-9136000,1988000,-7148000
43873,2020-06-30,244,Value,8596000,-9136000,1988000,-7148000
43873,2020-09-30,244,Value,7926000,-9136000,1988000,-7148000
43873,2020-11-15,244,Distribution,3068000,-9136000,5056000,-4080000
43873,2020-12-31,244,Value,4758000,-9136000,5056000,-4080000
43873,2021-02-14,244,Distribution,698000,-9136000,5754000,-3382000
43873,2021-03-31,244,Value,5804000,-9136000,5754000,-3382000
43873,2021-05-16,244,Distribution,534000,-9136000,6288000,-2848000
43873,2021-06-30,244,Value,5286000,-9136000,6288000,-2848000
43873,2021-09-30,244,Value,6812510,-9136000,6288000,-2848000
43985,2021-12-31,48402,Value,0,-4731000,531291,-4199709
43991,2020-02-15,11324,Capital Call,-580000,-12185000,11995000,-190000
43991,2020-03-31,11324,Value,9904990,-12185000,11995000,-190000
43991,2020-06-30,11324,Value,10799990,-12185000,11995000,-190000
43991,2020-08-15,11324,Capital Call,-40000,-12225000,11995000,-230000
43991,2020-09-30,11324,Value,10969990,-12225000,11995000,-230000
43991,2020-12-31,11324,Value,12144990,-12225000,11995000,-230000
43991,2021-02-14,11324,Capital Call,-55000,-12280000,11995000,-285000
43991,2021-03-31,11324,Value,12859990,-12280000,11995000,-285000
43991,2021-06-30,11324,Value,14180000,-12280000,11995000,-285000
43991,2021-08-15,11324,Capital Call,-50000,-12330000,11995000,-335000
43991,2021-09-30,11324,Value,14505000,-12330000,11995000,-335000
44150,2020-05-16,1973,Capital Call,-1750000,-10500000,2528750,-7971250
44150,2020-05-16,1973,Distribution,96250,-10500000,2625000,-7875000
44150,2020-12-31,1973,Value,11235000,-10500000,2625000,-7875000
44184,2020-03-31,22035,Value,19307420,-9800000,283954,-9516046
44184,2020-06-30,22035,Value,19205450,-9800000,283954,-9516046
44184,2020-08-15,22035,Distribution,530386,-9800000,814340,-8985660
44184,2020-09-30,22035,Value,18346220,-9800000,814340,-8985660
44265,2020-03-31,1703,Value,10784660,-9610113,4591442,-5018671
44265,2020-05-16,1703,Capital Call,-53176,-9663289,4591442,-5071847
44265,2020-06-30,1703,Value,10125340,-9663289,4591442,-5071847
44265,2020-09-30,1703,Value,10049810,-9663289,4591442,-5071847
44265,2020-11-15,1703,Capital Call,-48902,-9712191,4591442,-5120749
44265,2020-11-15,1703,Distribution,1833266,-9712191,6424708,-3287483
44265,2020-12-31,1703,Value,8571000,-9712191,6424708,-3287483
44265,2021-03-31,1703,Value,9076770,-9712191,6424708,-3287483
44265,2021-05-16,1703,Distribution,594943,-9712191,7019651,-2692540
44265,2021-06-30,1703,Value,10325770,-9712191,7019651,-2692540
44265,2021-09-30,1703,Value,12052190,-9712191,7019651,-2692540
44287,2020-02-15,444,Capital Call,-402606,-8887864,5767391,-3120473
44287,2020-02-15,444,Distribution,879121,-8887864,6646512,-2241352
44287,2020-03-31,444,Value,5847520,-8887864,6646512,-2241352
44287,2020-06-30,444,Value,5597360,-8887864,6646512,-2241352
44287,2020-08-15,444,Capital Call,-207791,-9095655,6646512,-2449143
44287,2020-08-15,444,Distribution,188976,-9095655,6835488,-2260167
44287,2020-09-30,444,Value,5947210,-9095655,6835488,-2260167
44287,2020-11-15,444,Distribution,158758,-9095655,6994246,-2101409
44287,2020-12-31,444,Value,6593240,-9095655,6994246,-2101409
44287,2021-02-14,444,Capital Call,-17858,-9113513,6994246,-2119267
44287,2021-02-14,444,Distribution,715651,-9113513,7709897,-1403616
44287,2021-03-31,444,Value,7039080,-9113513,7709897,-1403616
44287,2021-05-16,444,Distribution,60199,-9113513,7770096,-1343417
44287,2021-06-30,444,Value,7406790,-9113513,7770096,-1343417
44300,2020-02-15,465,Capital Call,94693,-8205306,830001,-7375305
44300,2020-02-15,465,Distribution,-9469,-8205306,820532,-7384774
44300,2020-03-31,465,Value,5743710,-8205306,820532,-7384774
44300,2020-05-16,465,Capital Call,-26687,-8231993,820532,-7411461
44300,2020-05-16,465,Distribution,2669,-8231993,823201,-7408792
44300,2020-06-30,465,Value,6585590,-8231993,823201,-7408792
44300,2020-11-14,465,Capital Call,-6,-8231999,823201,-7408798
44300,2020-11-14,465,Distribution,823201,-8231999,1646402,-6585597
44300,2021-03-31,465,Value,8232000,-8231999,1646402,-6585597
44300,2021-05-16,465,Distribution,1070160,-8231999,2716562,-5515437
44300,2021-06-30,465,Value,7573440,-8231999,2716562,-5515437
44300,2021-09-30,465,Value,7573440,-8231999,2716562,-5515437
44333,2020-01-15,367,Capital Call,0,-7674836,3392073,-4282763
44333,2020-01-15,367,Distribution,0,-7674836,3392073,-4282763
44333,2020-02-29,367,Value,8394180,-7674836,3392073,-4282763
44333,2020-04-15,367,Capital Call,0,-7674836,3392073,-4282763
44333,2020-04-15,367,Distribution,296399,-7674836,3688472,-3986364
44333,2020-05-31,367,Value,6906230,-7674836,3688472,-3986364
44333,2020-07-16,367,Capital Call,-1462690,-9137526,3688472,-5449054
44333,2020-07-16,367,Distribution,412717,-9137526,4101189,-5036337
44333,2020-08-31,367,Value,7956060,-9137526,4101189,-5036337
44333,2020-11-30,367,Value,8485330,-9137526,4101189,-5036337
44333,2021-01-14,367,Capital Call,-285682,-9423208,4101189,-5322019
44333,2021-01-14,367,Distribution,2503343,-9423208,6604532,-2818676
44333,2021-02-28,367,Value,6267670,-9423208,6604532,-2818676
44333,2021-05-31,367,Value,9507640,-9423208,6604532,-2818676
44333,2021-07-16,367,Distribution,1374611,-9423208,7979143,-1444065
44333,2021-08-31,367,Value,8540460,-9423208,7979143,-1444065
44333,2021-10-16,367,Capital Call,0,-9423208,7979143,-1444065
44333,2021-10-16,367,Distribution,1362910,-9423208,9342053,-81155
44333,2021-11-30,367,Value,8708410,-9423208,9342053,-81155
44342,2020-02-15,345712,Capital Call,-75000,-9800000,1930333,-7869667
44342,2020-03-31,345712,Value,13275330,-9800000,1930333,-7869667
44342,2020-05-16,345712,Distribution,3047000,-9800000,4977333,-4822667
44342,2020-06-30,345712,Value,16393000,-9800000,4977333,-4822667
44342,2020-08-15,345712,Distribution,662333,-9800000,5639666,-4160334
44342,2020-09-30,345712,Value,17256660,-9800000,5639666,-4160334
44342,2020-12-31,345712,Value,19286330,-9800000,5639666,-4160334
44342,2021-03-31,345712,Value,27678660,-9800000,5639666,-4160334
44367,2020-03-31,6715,Value,12214410,-7300000,571428,-6728572
44367,2020-06-30,6715,Value,12629310,-7300000,571428,-6728572
44367,2020-09-30,6715,Distribution,804909,-7300000,1376337,-5923663
44367,2020-12-31,6715,Value,22089860,-7300000,1376337,-5923663
44367,2021-03-31,6715,Value,43125010,-7300000,1376337,-5923663
44367,2021-05-16,6715,Capital Call,-2000000,-9300000,1376337,-7923663
44367,2021-05-16,6715,Distribution,8701472,-9300000,10077809,777809
44367,2021-06-30,6715,Value,19095290,-9300000,10077809,777809
44367,2021-08-15,6715,Distribution,3172674,-9300000,13250483,3950483
44367,2021-09-30,6715,Value,18556460,-9300000,13250483,3950483
44392,2020-02-15,9110,Capital Call,-318285,-11245286,1804047,-9441239
44392,2020-02-15,9110,Distribution,617127,-11245286,2421174,-8824112
44392,2020-03-31,9110,Value,11987490,-11245286,2421174,-8824112
44392,2020-05-16,9110,Capital Call,-156715,-11402001,2421174,-8980827
44392,2020-05-16,9110,Distribution,54200,-11402001,2475374,-8926627
44392,2020-06-30,9110,Value,12640250,-11402001,2475374,-8926627
44392,2020-08-15,9110,Capital Call,-246000,-11648001,2475374,-9172627
44392,2020-08-15,9110,Distribution,181535,-11648001,2656909,-8991092
44392,2020-09-30,9110,Value,13590880,-11648001,2656909,-8991092
44392,2020-11-15,9110,Capital Call,-167918,-11815919,2656909,-9159010
44392,2020-11-15,9110,Distribution,302236,-11815919,2959145,-8856774
44392,2020-12-31,9110,Value,15349040,-11815919,2959145,-8856774
44392,2021-02-14,9110,Capital Call,-192840,-12008759,2959145,-9049614
44392,2021-02-14,9110,Distribution,323198,-12008759,3282343,-8726416
44392,2021-03-31,9110,Value,16570510,-12008759,3282343,-8726416
44392,2021-05-16,9110,Capital Call,-22241,-12031000,3282343,-8748657
44392,2021-05-16,9110,Distribution,212662,-12031000,3495005,-8535995
44392,2021-06-30,9110,Value,17616990,-12031000,3495005,-8535995
44392,2021-08-15,9110,Capital Call,-56000,-12087000,3495005,-8591995
44392,2021-08-15,9110,Distribution,416348,-12087000,3911353,-8175647
44392,2021-09-30,9110,Value,17303740,-12087000,3911353,-8175647
44437,2020-02-15,170017,Capital Call,-203576,-10380711,8883320,-1497391
44437,2020-02-15,170017,Distribution,476993,-10380711,9360313,-1020398
44437,2020-03-31,170017,Value,10155420,-10380711,9360313,-1020398
44437,2020-05-16,170017,Capital Call,-271498,-10652209,9360313,-1291896
44437,2020-06-30,170017,Value,10878880,-10652209,9360313,-1291896
44437,2020-09-30,170017,Value,13328890,-10652209,9360313,-1291896
44437,2020-11-15,170017,Capital Call,-828881,-11481090,9360313,-2120777
44437,2020-11-15,170017,Distribution,2317941,-11481090,11678254,197164
44437,2020-12-31,170017,Value,14039380,-11481090,11678254,197164
44437,2021-03-31,170017,Value,15302300,-11481090,11678254,197164
44437,2021-06-30,170017,Value,19894740,-11481090,11678254,197164
44450,2020-03-31,8114,Value,8130000,-11060000,7670000,-3390000
44450,2020-05-16,8114,Capital Call,-360000,-11420000,7670000,-3750000
44450,2020-05-16,8114,Distribution,20000,-11420000,7690000,-3730000
44450,2020-06-30,8114,Value,9040000,-11420000,7690000,-3730000
44450,2020-08-15,8114,Capital Call,-470000,-11890000,7690000,-4200000
44450,2020-09-30,8114,Value,10450000,-11890000,7690000,-4200000
44450,2020-12-31,8114,Value,11579990,-11890000,7690000,-4200000
44450,2021-02-14,8114,Capital Call,-160000,-12050000,7690000,-4360000
44450,2021-02-14,8114,Distribution,1780000,-12050000,9470000,-2580000
44450,2021-03-31,8114,Value,11499990,-12050000,9470000,-2580000
44450,2021-06-30,8114,Value,13190000,-12050000,9470000,-2580000
44450,2021-08-15,8114,Capital Call,-300000,-12350000,9470000,-2880000
44450,2021-08-15,8114,Distribution,2630000,-12350000,12100000,-250000
44450,2021-09-30,8114,Value,13379990,-12350000,12100000,-250000
44525,2020-02-15,15,Capital Call,-104444,-7668887,2744445,-4924442
44525,2020-02-15,15,Distribution,304444,-7668887,3048889,-4619998
44525,2020-03-31,15,Value,9033330,-7668887,3048889,-4619998
44525,2020-05-16,15,Capital Call,-108889,-7777776,3048889,-4728887
44525,2020-05-16,15,Distribution,104444,-7777776,3153333,-4624443
44525,2020-06-30,15,Value,7986660,-7777776,3153333,-4624443
44525,2020-08-15,15,Distribution,373333,-7777776,3526666,-4251110
44525,2020-09-30,15,Value,8022220,-7777776,3526666,-4251110
44525,2020-11-15,15,Distribution,386667,-7777776,3913333,-3864443
44525,2020-12-31,15,Value,7968880,-7777776,3913333,-3864443
44525,2021-02-14,15,Distribution,1113333,-7777776,5026666,-2751110
44525,2021-03-31,15,Value,7048880,-7777776,5026666,-2751110
44525,2021-05-16,15,Capital Call,-97778,-7875554,5026666,-2848888
44525,2021-06-30,15,Value,8424440,-7875554,5026666,-2848888
44525,2021-08-15,15,Distribution,808889,-7875554,5835555,-2039999
44525,2021-09-30,15,Value,7902010,-7875554,5835555,-2039999
44527,2020-02-15,1892,Capital Call,-700000,-7600000,0,-7600000
44527,2020-03-31,1892,Value,8345160,-7600000,0,-7600000
44527,2020-05-16,1892,Capital Call,-500000,-8100000,0,-8100000
44527,2020-06-30,1892,Value,8845160,-8100000,0,-8100000
44527,2020-09-30,1892,Value,9293020,-8100000,0,-8100000
44527,2020-12-31,1892,Value,10075440,-8100000,0,-8100000
44527,2021-03-31,1892,Value,10603490,-8100000,0,-8100000
44527,2021-05-16,1892,Distribution,382686,-8100000,382686,-7717314
44527,2021-06-30,1892,Value,12313690,-8100000,382686,-7717314
44551,2020-02-15,588,Capital Call,-150000,-8985180,6853346,-2131834
44551,2020-02-15,588,Distribution,372533,-8985180,7225879,-1759301
44551,2020-03-31,588,Value,7668760,-8985180,7225879,-1759301
44551,2020-05-16,588,Capital Call,-100000,-9085180,7225879,-1859301
44551,2020-05-16,588,Distribution,125925,-9085180,7351804,-1733376
44551,2020-06-30,588,Value,8036980,-9085180,7351804,-1733376
44551,2020-08-15,588,Capital Call,-100000,-9185180,7351804,-1833376
44551,2020-08-15,588,Distribution,424341,-9185180,7776145,-1409035
44551,2020-09-30,588,Value,8678750,-9185180,7776145,-1409035
44551,2020-11-15,588,Capital Call,-100000,-9285180,7776145,-1509035
44551,2020-11-15,588,Distribution,471094,-9285180,8247239,-1037941
44551,2020-12-31,588,Value,9285520,-9285180,8247239,-1037941
44551,2021-03-31,588,Value,10907940,-9285180,8247239,-1037941
44693,2020-02-15,128273,Distribution,98000,-9800000,13230000,3430000
44693,2020-03-31,128273,Value,2744000,-9800000,13230000,3430000
44693,2020-05-16,128273,Distribution,588000,-9800000,13818000,4018000
44693,2020-06-30,128273,Value,2450000,-9800000,13818000,4018000
44693,2020-08-15,128273,Capital Call,-100000,-9900000,13818000,3918000
44693,2020-08-15,128273,Distribution,240000,-9900000,14058000,4158000
44693,2020-09-30,128273,Value,2376000,-9900000,14058000,4158000
44693,2020-12-31,128273,Value,2574000,-9900000,14058000,4158000
44693,2021-02-14,128273,Distribution,178200,-9900000,14236200,4336200
44693,2021-03-31,128273,Value,2534400,-9900000,14236200,4336200
44693,2021-05-16,128273,Distribution,19800,-9900000,14256000,4356000
44693,2021-06-30,128273,Value,2673000,-9900000,14256000,4356000
44693,2021-08-15,128273,Distribution,99000,-9900000,14355000,4455000
44693,2021-09-30,128273,Value,2673000,-9900000,14355000,4455000
44710,2020-03-31,47870,Value,2016760,-2540000,99060,-2440940
44710,2020-07-01,47870,Capital Call,-220000,-2760000,99060,-2660940
44710,2020-07-01,47870,Distribution,300,-2760000,99360,-2660640
44710,2020-09-30,47870,Value,1573200,-2760000,99360,-2660640
44710,2020-11-15,47870,Capital Call,-350000,-3110000,99360,-3010640
44710,2020-11-15,47870,Distribution,160,-3110000,99520,-3010480
44710,2020-12-31,47870,Value,2214320,-3110000,99520,-3010480
44710,2021-02-14,47870,Capital Call,-1270000,-4380000,99520,-4280480
44710,2021-02-14,47870,Distribution,1220,-4380000,100740,-4279260
44710,2021-03-31,47870,Value,3504000,-4380000,100740,-4279260
44710,2021-05-16,47870,Capital Call,-1270000,-5650000,100740,-5549260
44710,2021-05-16,47870,Distribution,960,-5650000,101700,-5548300
44710,2021-06-30,47870,Value,5265800,-5650000,101700,-5548300
44710,2021-08-15,47870,Capital Call,-10000,-5660000,101700,-5558300
44710,2021-08-15,47870,Distribution,180,-5660000,101880,-5558120
44710,2021-09-30,47870,Value,5688300,-5660000,101880,-5558120
44710,2021-11-15,47870,Capital Call,-590000,-6250000,101880,-6148120
44710,2021-11-15,47870,Distribution,-1880,-6250000,100000,-6150000
44710,2021-12-31,47870,Value,6281250,-6250000,100000,-6150000
44826,2020-02-15,555,Capital Call,-53912,-8799937,0,-8799937
44826,2020-03-31,555,Value,10370260,-8799937,0,-8799937
44826,2020-05-16,555,Capital Call,-855479,-9655416,0,-9655416
44826,2020-06-30,555,Value,11839630,-9655416,0,-9655416
44826,2020-08-15,555,Capital Call,-128424,-9783840,0,-9783840
44826,2020-09-30,555,Value,11915160,-9783840,0,-9783840
44826,2020-11-15,555,Capital Call,-55693,-9839533,0,-9839533
44826,2020-12-31,555,Value,11677380,-9839533,0,-9839533
44826,2021-02-14,555,Capital Call,-131475,-9971008,0,-9971008
44826,2021-03-31,555,Value,11622460,-9971008,0,-9971008
44826,2021-05-16,555,Capital Call,-31025,-10002033,0,-10002033
44826,2021-06-30,555,Value,10001780,-10002033,0,-10002033
44852,2020-02-15,7,Capital Call,-84303,-8085000,2083328,-6001672
44852,2020-02-15,7,Distribution,29284,-8085000,2112612,-5972388
44852,2020-03-31,7,Value,7725210,-8085000,2112612,-5972388
44852,2020-06-30,7,Value,8156950,-8085000,2112612,-5972388
44852,2020-08-15,7,Capital Call,-600000,-8685000,2112612,-6572388
44852,2020-08-15,7,Distribution,614480,-8685000,2727092,-5957908
44852,2020-09-30,7,Value,8990710,-8685000,2727092,-5957908
44857,2020-03-31,7,Value,10135680,-9600000,3199680,-6400320
44857,2020-06-30,7,Value,11308800,-9600000,3199680,-6400320
44857,2020-08-15,7,Capital Call,-100000,-9700000,3199680,-6500320
44857,2020-08-15,7,Distribution,250610,-9700000,3450290,-6249710
44857,2020-09-30,7,Value,13081420,-9700000,3450290,-6249710
44879,2020-03-31,86,Value,8533220,-9419371,1236532,-8182839
44879,2020-05-16,86,Capital Call,-187179,-9606550,1236532,-8370018
44879,2020-06-30,86,Value,9364040,-9606550,1236532,-8370018
44879,2020-08-15,86,Capital Call,-122671,-9729221,1236532,-8492689
44879,2020-09-30,86,Value,9948580,-9729221,1236532,-8492689
44879,2020-11-15,86,Capital Call,-314756,-10043977,1236532,-8807445
44879,2020-11-15,86,Distribution,689761,-10043977,1926293,-8117684
44879,2020-12-31,86,Value,11946850,-10043977,1926293,-8117684
44879,2021-03-31,86,Value,12260580,-10043977,1926293,-8117684
44879,2021-05-16,86,Distribution,1958570,-10043977,3884863,-6159114
44879,2021-06-30,86,Value,12227250,-10043977,3884863,-6159114
44882,2020-02-15,5327,Capital Call,-296282,-7904325,3312576,-4591749
44882,2020-02-15,5327,Distribution,45482,-7904325,3358058,-4546267
44882,2020-03-31,5327,Value,6562260,-7904325,3358058,-4546267
44882,2020-06-30,5327,Value,7090280,-7904325,3358058,-4546267
44882,2020-09-30,5327,Capital Call,-1417896,-9322221,3358058,-5964163
44882,2020-12-31,5327,Value,9867990,-9322221,3358058,-5964163
44882,2021-03-31,5327,Value,10535380,-9322221,3358058,-5964163
44882,2021-05-16,5327,Capital Call,-81947,-9404168,3358058,-6046110
44882,2021-05-16,5327,Distribution,277333,-9404168,3635391,-5768777
44882,2021-06-30,5327,Value,10740260,-9404168,3635391,-5768777
44885,2020-03-31,687,Value,6962010,-5828407,607772,-5220635
44885,2020-05-16,687,Distribution,903026,-5828407,1510798,-4317609
44885,2020-06-30,687,Value,6432660,-5828407,1510798,-4317609
44885,2020-09-30,687,Value,6713870,-5828407,1510798,-4317609
44885,2020-11-15,687,Capital Call,-960379,-6788786,1510798,-5277988
44885,2020-11-15,687,Distribution,2076725,-6788786,3587523,-3201263
44885,2020-12-31,687,Value,6057820,-6788786,3587523,-3201263
44885,2021-02-14,687,Capital Call,-677708,-7466494,3587523,-3878971
44885,2021-03-31,687,Value,7026680,-7466494,3587523,-3878971
44885,2021-05-16,687,Capital Call,-245505,-7711999,3587523,-4124476
44885,2021-05-16,687,Distribution,-37689,-7711999,3549834,-4162165
44885,2021-06-30,687,Value,8490140,-7711999,3549834,-4162165
44912,2020-01-15,123418,Capital Call,1484191,-7420956,486,-7420470
44912,2020-01-15,123418,Distribution,0,-7420956,486,-7420470
44912,2020-02-29,123418,Value,15347800,-7420956,486,-7420470
44912,2020-04-15,123418,Capital Call,-27486,-7448442,486,-7447956
44912,2020-04-15,123418,Distribution,0,-7448442,486,-7447956
44912,2020-05-31,123418,Value,12747440,-7448442,486,-7447956
44912,2020-07-16,123418,Capital Call,-31819,-7480261,486,-7479775
44912,2020-08-31,123418,Value,14319540,-7480261,486,-7479775
44912,2020-10-16,123418,Capital Call,-165523,-7645784,486,-7645298
44912,2020-11-30,123418,Value,14867500,-7645784,486,-7645298
44912,2021-01-14,123418,Capital Call,-12605,-7658389,486,-7657903
44912,2021-02-28,123418,Value,14880110,-7658389,486,-7657903
44912,2021-04-15,123418,Capital Call,-4444,-7662833,486,-7662347
44912,2021-05-31,123418,Value,16795220,-7662833,486,-7662347
44912,2021-07-16,123418,Capital Call,-4444,-7667277,486,-7666791
44912,2021-08-31,123418,Value,17119420,-7667277,486,-7666791
44912,2021-10-16,123418,Capital Call,-4167,-7671444,486,-7670958
44912,2021-11-30,123418,Value,17121330,-7671444,486,-7670958
44927,2020-01-15,72210,Distribution,0,-9524999,17096,-9507903
44927,2020-02-29,72210,Value,10271840,-9524999,17096,-9507903
44927,2020-04-15,72210,Distribution,0,-9524999,17096,-9507903
44927,2020-05-31,72210,Value,9406120,-9524999,17096,-9507903
44927,2020-08-31,72210,Value,9153460,-9524999,17096,-9507903
44927,2020-11-30,72210,Value,9135640,-9524999,17096,-9507903
44927,2021-02-28,72210,Value,9135640,-9524999,17096,-9507903
44927,2021-05-31,72210,Value,11534270,-9524999,17096,-9507903
44927,2021-08-31,72210,Value,14241750,-9524999,17096,-9507903
44927,2021-10-16,72210,Capital Call,-635102,-10160101,17096,-10143005
44927,2021-10-16,72210,Distribution,2370931,-10160101,2388027,-7772074
44927,2021-11-30,72210,Value,14072720,-10160101,2388027,-7772074
44945,2020-02-15,32423,Capital Call,-60000,-9000000,7133226,-1866774
44945,2020-02-15,32423,Distribution,4752174,-9000000,11885400,2885400
44945,2020-03-31,32423,Value,7773300,-9000000,11885400,2885400
44945,2020-05-16,32423,Distribution,84600,-9000000,11970000,2970000
44945,2020-06-30,32423,Value,8511300,-9000000,11970000,2970000
44945,2020-09-30,32423,Value,8781300,-9000000,11970000,2970000
44945,2020-11-15,32423,Distribution,1727100,-9000000,13697100,4697100
44945,2020-12-31,32423,Value,7226100,-9000000,13697100,4697100
44945,2021-02-14,32423,Distribution,1282500,-9000000,14979600,5979600
44945,2021-03-31,32423,Value,6121800,-9000000,14979600,5979600
44945,2021-05-16,32423,Distribution,484200,-9000000,15463800,6463800
44945,2021-06-30,32423,Value,5517900,-9000000,15463800,6463800
44945,2021-09-30,32423,Value,5652900,-9000000,15463800,6463800
44978,2020-02-15,18,Capital Call,5,-8996212,1642395,-7353817
44978,2020-02-15,18,Distribution,460021,-8996212,2102416,-6893796
44978,2020-03-31,18,Value,11105820,-8996212,2102416,-6893796
44978,2020-05-16,18,Distribution,352,-8996212,2102768,-6893444
44978,2020-06-30,18,Value,12314910,-8996212,2102768,-6893444
44978,2020-09-30,18,Value,14222110,-8996212,2102768,-6893444
44978,2020-11-15,18,Capital Call,-794,-8997006,2102768,-6894238
44978,2020-11-15,18,Distribution,116846,-8997006,2219614,-6777392
44978,2020-12-31,18,Value,18294140,-8997006,2219614,-6777392
44978,2021-02-14,18,Distribution,600590,-8997006,2820204,-6176802
44978,2021-03-31,18,Value,17884400,-8997006,2820204,-6176802
44978,2021-05-16,18,Distribution,3297520,-8997006,6117724,-2879282
44978,2021-06-30,18,Value,15695370,-8997006,6117724,-2879282
44978,2021-08-15,18,Distribution,233693,-8997006,6351417,-2645589
44978,2021-09-30,18,Value,15680370,-8997006,6351417,-2645589
45006,2020-07-10,12176,Capital Call,-254395,-4307615,61572,-4246043
45006,2020-12-31,12176,Value,5577810,-4307615,61572,-4246043
45009,2020-02-15,350,Capital Call,-37239,-9225859,4046683,-5179176
45009,2020-02-15,350,Distribution,1051060,-9225859,5097743,-4128116
45009,2020-03-31,350,Value,6862040,-9225859,5097743,-4128116
45009,2020-05-16,350,Capital Call,-55341,-9281200,5097743,-4183457
45009,2020-05-16,350,Distribution,134564,-9281200,5232307,-4048893
45009,2020-06-30,350,Value,8304290,-9281200,5232307,-4048893
45009,2020-08-15,350,Capital Call,-37900,-9319100,5232307,-4086793
45009,2020-08-15,350,Distribution,211896,-9319100,5444203,-3874897
45009,2020-09-30,350,Value,8854260,-9319100,5444203,-3874897
45009,2020-12-31,350,Value,8854260,-9319100,5444203,-3874897
45009,2021-02-14,350,Capital Call,-53539,-9372639,5444203,-3928436
45009,2021-02-14,350,Distribution,1895347,-9372639,7339550,-2033089
45009,2021-03-31,350,Value,9819980,-9372639,7339550,-2033089
45009,2021-05-16,350,Capital Call,-16955,-9389594,7339550,-2050044
45009,2021-05-16,350,Distribution,298770,-9389594,7638320,-1751274
45009,2021-06-30,350,Value,10426100,-9389594,7638320,-1751274
45009,2021-08-15,350,Capital Call,-19,-9389613,7638320,-1751293
45009,2021-08-15,350,Distribution,1594324,-9389613,9232644,-156969
45009,2021-09-30,350,Value,7958550,-9389613,9232644,-156969
45115,2020-01-15,137606,Capital Call,-24653,-10026892,2476980,-7549912
45115,2020-01-15,137606,Distribution,0,-10026892,2476980,-7549912
45115,2020-02-29,137606,Value,4621260,-10026892,2476980,-7549912
45115,2020-04-15,137606,Capital Call,-65579,-10092471,2476980,-7615491
45115,2020-04-15,137606,Distribution,42412,-10092471,2519392,-7573079
45115,2020-05-31,137606,Value,3461880,-10092471,2519392,-7573079
45115,2020-07-16,137606,Capital Call,-18386,-10110857,2519392,-7591465
45115,2020-08-31,137606,Value,3862040,-10110857,2519392,-7591465
45115,2020-10-16,137606,Capital Call,-42412,-10153269,2519392,-7633877
45115,2020-10-16,137606,Distribution,82063,-10153269,2601455,-7551814
45115,2020-11-30,137606,Value,5765280,-10153269,2601455,-7551814
45115,2021-01-14,137606,Capital Call,-24466,-10177735,2601455,-7576280
45115,2021-02-28,137606,Value,5442630,-10177735,2601455,-7576280
45115,2021-04-15,137606,Capital Call,-24687,-10202422,2601455,-7600967
45115,2021-04-15,137606,Distribution,36452,-10202422,2637907,-7564515
45115,2021-05-31,137606,Value,5655580,-10202422,2637907,-7564515
45115,2021-07-16,137606,Capital Call,-73984,-10276406,2637907,-7638499
45115,2021-08-31,137606,Value,5901330,-10276406,2637907,-7638499
45115,2021-10-16,137606,Capital Call,-24774,-10301180,2637907,-7663273
45115,2021-10-16,137606,Distribution,47932,-10301180,2685839,-7615341
45115,2021-11-30,137606,Value,5923520,-10301180,2685839,-7615341
45130,2020-06-30,13320,Value,10594130,-7067000,931430,-6135570
45130,2020-08-15,13320,Capital Call,-347000,-7414000,931430,-6482570
45130,2020-08-15,13320,Distribution,509,-7414000,931939,-6482061
45130,2020-09-30,13320,Value,11723010,-7414000,931939,-6482061
45130,2020-12-31,13320,Value,14204480,-7414000,931939,-6482061
45130,2021-02-14,13320,Distribution,755487,-7414000,1687426,-5726574
45130,2021-03-31,13320,Value,14743480,-7414000,1687426,-5726574
45130,2021-06-30,13320,Value,18642500,-7414000,1687426,-5726574
45130,2021-08-15,13320,Distribution,202402,-7414000,1889828,-5524172
45130,2021-09-30,13320,Value,19079920,-7414000,1889828,-5524172
45172,2020-02-15,13158,Distribution,971727,-8166720,6088704,-2078016
45172,2020-03-31,13158,Value,15566180,-8166720,6088704,-2078016
45172,2020-05-16,13158,Distribution,933355,-8166720,7022059,-1144661
45172,2020-06-30,13158,Value,16104080,-8166720,7022059,-1144661
45172,2020-08-15,13158,Distribution,732165,-8166720,7754224,-412496
45172,2020-09-30,13158,Value,17045680,-8166720,7754224,-412496
45172,2020-11-15,13158,Distribution,1028806,-8166720,8783030,616310
45172,2020-12-31,13158,Value,25311780,-8166720,8783030,616310
45172,2021-02-14,13158,Distribution,1367552,-8166720,10150582,1983862
45172,2021-03-31,13158,Value,34248140,-8166720,10150582,1983862
45173,2020-02-15,13158,Distribution,398000,-7834463,543933,-7290530
45173,2020-03-31,13158,Value,17238730,-7834463,543933,-7290530
45173,2020-05-16,13158,Distribution,375889,-7834463,919822,-6914641
45173,2020-06-30,13158,Value,17553030,-7834463,919822,-6914641
45173,2020-08-15,13158,Distribution,473178,-7834463,1393000,-6441463
45173,2020-09-30,13158,Value,17655900,-7834463,1393000,-6441463
45173,2020-11-15,13158,Distribution,367044,-7834463,1760044,-6074419
45173,2020-12-31,13158,Value,21381360,-7834463,1760044,-6074419
45173,2021-02-14,13158,Distribution,402422,-7834463,2162466,-5671997
45173,2021-03-31,13158,Value,28568280,-7834463,2162466,-5671997
45176,2020-03-31,475912,Capital Call,-861327,-7942497,2475757,-5466740
45176,2020-03-31,475912,Distribution,278866,-7942497,2754623,-5187874
45176,2020-06-30,475912,Value,7847930,-7942497,2754623,-5187874
45176,2020-09-30,475912,Value,8562930,-7942497,2754623,-5187874
45176,2020-11-15,475912,Capital Call,442075,-7500422,2754623,-4745799
45176,2020-11-15,475912,Distribution,2250,-7500422,2756873,-4743549
45176,2020-12-31,475912,Value,8119520,-7500422,2756873,-4743549
45176,2021-02-14,475912,Capital Call,155338,-7345084,2756873,-4588211
45176,2021-02-14,475912,Distribution,885297,-7345084,3642170,-3702914
45176,2021-03-31,475912,Value,8823800,-7345084,3642170,-3702914
45200,2020-03-31,20998,Value,10606660,-10759999,4126665,-6633334
45200,2020-05-16,20998,Capital Call,-306667,-11066666,4126665,-6940001
45200,2020-06-30,20998,Value,12046660,-11066666,4126665,-6940001
45200,2020-09-30,20998,Value,13726660,-11066666,4126665,-6940001
45200,2020-11-15,20998,Capital Call,-220000,-11286666,4126665,-7160001
45200,2020-11-15,20998,Distribution,1173333,-11286666,5299998,-5986668
45200,2020-12-31,20998,Value,14813330,-11286666,5299998,-5986668
45200,2021-02-14,20998,Distribution,966667,-11286666,6266665,-5020001
45200,2021-03-31,20998,Value,14853330,-11286666,6266665,-5020001
45200,2021-05-16,20998,Capital Call,-120000,-11406666,6266665,-5140001
45200,2021-05-16,20998,Distribution,1080000,-11406666,7346665,-4060001
45200,2021-06-30,20998,Value,16933330,-11406666,7346665,-4060001
45200,2021-08-15,20998,Capital Call,-280000,-11686666,7346665,-4340001
45200,2021-08-15,20998,Distribution,397333,-11686666,7743998,-3942668
45200,2021-09-30,20998,Value,19998660,-11686666,7743998,-3942668
45287,2020-03-31,49839,Value,10599080,-9006354,1148998,-7857356
45287,2020-06-30,49839,Value,17085850,-9006354,1148998,-7857356
45287,2020-08-15,49839,Capital Call,-423447,-9429801,1148998,-8280803
45287,2020-08-15,49839,Distribution,1521423,-9429801,2670421,-6759380
45287,2020-09-30,49839,Value,21905010,-9429801,2670421,-6759380
45287,2020-11-15,49839,Capital Call,-896895,-10326696,2670421,-7656275
45287,2020-11-15,49839,Distribution,2960152,-10326696,5630573,-4696123
45287,2020-12-31,49839,Value,19162190,-10326696,5630573,-4696123
45308,2020-09-30,49653,Value,6607960,-8554000,0,-8554000
45368,2020-02-15,11813,Distribution,23100,-7700000,338800,-7361200
45368,2020-03-31,11813,Value,13773760,-7700000,338800,-7361200
45368,2020-06-30,11813,Value,15363040,-7700000,338800,-7361200
45368,2020-08-15,11813,Distribution,658350,-7700000,997150,-6702850
45368,2020-09-30,11813,Value,15172080,-7700000,997150,-6702850
45368,2020-12-31,11813,Value,19418630,-7700000,997150,-6702850
45368,2021-02-14,11813,Distribution,831600,-7700000,1828750,-5871250
45368,2021-03-31,11813,Value,23105390,-7700000,1828750,-5871250
45368,2021-05-16,11813,Distribution,830830,-7700000,2659580,-5040420
45368,2021-06-30,11813,Value,23083060,-7700000,2659580,-5040420
45413,2020-03-31,14,Value,11091550,-9200000,0,-9200000
45416,2020-01-15,9022,Distribution,527612,-9600000,3833980,-5766020
45416,2020-02-29,9022,Value,23688550,-9600000,3833980,-5766020
45416,2020-04-15,9022,Distribution,10223960,-9600000,14057940,4457940
45416,2020-05-31,9022,Value,17121500,-9600000,14057940,4457940
45416,2020-08-31,9022,Value,26297690,-9600000,14057940,4457940
45416,2020-10-16,9022,Distribution,27282353,-9600000,41340293,31740293
45416,2020-11-30,9022,Value,8377800,-9600000,41340293,31740293
45416,2021-02-28,9022,Value,8377800,-9600000,41340293,31740293
45416,2021-05-31,9022,Value,11529630,-9600000,41340293,31740293
45416,2021-07-16,9022,Capital Call,-200000,-9800000,41340293,31540293
45416,2021-08-31,9022,Value,12848460,-9800000,41340293,31540293
45416,2021-11-30,9022,Value,11266140,-9800000,41340293,31540293
45439,2020-02-15,723,Capital Call,-1271429,-8885714,2585715,-6299999
45439,2020-02-15,723,Distribution,2628571,-8885714,5214286,-3671428
45439,2020-03-31,723,Value,8128570,-8885714,5214286,-3671428
45439,2020-06-30,723,Value,9428570,-8885714,5214286,-3671428
45439,2020-09-30,723,Value,9942850,-8885714,5214286,-3671428
45439,2020-12-31,723,Value,10471420,-8885714,5214286,-3671428
45439,2021-03-31,723,Value,13028570,-8885714,5214286,-3671428
45439,2021-05-16,723,Distribution,1642857,-8885714,6857143,-2028571
45439,2021-06-30,723,Value,13700000,-8885714,6857143,-2028571
45439,2021-08-15,723,Capital Call,2857,-8882857,6857143,-2025714
45439,2021-09-30,723,Value,14795710,-8882857,6857143,-2025714
45450,2020-03-31,461,Value,9434830,-9834895,8649160,-1185735
45450,2020-06-30,461,Value,9300360,-9834895,8649160,-1185735
45450,2020-08-15,461,Distribution,295481,-9834895,8944641,-890254
45450,2020-09-30,461,Value,11376630,-9834895,8944641,-890254
45450,2020-11-15,461,Distribution,301275,-9834895,9245916,-588979
45450,2020-12-31,461,Value,13599650,-9834895,9245916,-588979
45450,2021-03-31,461,Value,17158410,-9834895,9245916,-588979
45450,2021-06-30,461,Value,20926420,-9834895,9245916,-588979
45450,2021-09-30,461,Value,24772820,-9834895,9245916,-588979
45522,2020-03-31,8927,Value,7171020,-10441517,1654557,-8786960
45522,2020-06-30,8927,Value,7730610,-10441517,1654557,-8786960
45522,2020-09-30,8927,Value,7808790,-10441517,1654557,-8786960
45522,2020-12-31,8927,Value,9237020,-10441517,1654557,-8786960
45522,2021-02-14,8927,Capital Call,-386700,-10828217,1654557,-9173660
45522,2021-02-14,8927,Distribution,400540,-10828217,2055097,-8773120
45522,2021-03-31,8927,Value,9360270,-10828217,2055097,-8773120
45522,2021-05-16,8927,Capital Call,-96208,-10924425,2055097,-8869328
45522,2021-05-16,8927,Distribution,1061689,-10924425,3116786,-7807639
45522,2021-06-30,8927,Value,8046850,-10924425,3116786,-7807639
45522,2021-09-30,8927,Value,8285900,-10924425,3116786,-7807639
45574,2020-03-31,9954,Value,10739770,-7886879,1058630,-6828249
45574,2020-05-16,9954,Capital Call,-474602,-8361481,1058630,-7302851
45574,2020-06-30,9954,Value,13028890,-8361481,1058630,-7302851
45574,2020-09-30,9954,Value,13024450,-8361481,1058630,-7302851
45574,2020-12-31,9954,Value,13086990,-8361481,1058630,-7302851
45574,2021-03-31,9954,Value,13162370,-8361481,1058630,-7302851
45574,2021-06-30,9954,Value,15681870,-8361481,1058630,-7302851
45686,2020-02-15,1632,Distribution,1260306,-10433000,12993258,2560258
45686,2020-03-31,1632,Value,15767390,-10433000,12993258,2560258
45686,2020-05-16,1632,Capital Call,38000,-10395000,12993258,2598258
45686,2020-05-16,1632,Distribution,3010884,-10395000,16004142,5609142
45686,2020-06-30,1632,Value,17948000,-10395000,16004142,5609142
45686,2020-08-15,1632,Distribution,1635134,-10395000,17639276,7244276
45686,2020-09-30,1632,Value,16917860,-10395000,17639276,7244276
45686,2020-11-15,1632,Distribution,1099791,-10395000,18739067,8344067
45686,2020-12-31,1632,Value,16654860,-10395000,18739067,8344067
45686,2021-02-14,1632,Distribution,1434510,-10395000,20173577,9778577
45686,2021-03-31,1632,Value,17056110,-10395000,20173577,9778577
45686,2021-06-30,1632,Value,18303510,-10395000,20173577,9778577
45686,2021-09-30,1632,Value,19744260,-10395000,20173577,9778577
45702,2020-02-15,461,Capital Call,-150000,-9600000,1847490,-7752510
45702,2020-02-15,461,Distribution,3110216,-9600000,4957706,-4642294
45702,2020-03-31,461,Value,14682120,-9600000,4957706,-4642294
45702,2020-05-16,461,Distribution,3110216,-9600000,8067922,-1532078
45702,2020-06-30,461,Value,14515960,-9600000,8067922,-1532078
45702,2020-08-15,461,Distribution,275591,-9600000,8343513,-1256487
45702,2020-09-30,461,Value,14376760,-9600000,8343513,-1256487
45702,2020-12-31,461,Value,22410930,-9600000,8343513,-1256487
45702,2021-02-14,461,Distribution,314961,-9600000,8658474,-941526
45702,2021-03-31,461,Value,29200370,-9600000,8658474,-941526
45702,2021-06-30,461,Value,35073510,-9600000,8658474,-941526
45713,2020-02-15,519,Capital Call,-120000,-8020000,5510001,-2509999
45713,2020-02-15,519,Distribution,840000,-8020000,6350001,-1669999
45713,2020-03-31,519,Value,3770000,-8020000,6350001,-1669999
45713,2020-05-16,519,Distribution,160000,-8020000,6510001,-1509999
45713,2020-06-30,519,Value,3200000,-8020000,6510001,-1509999
45713,2020-08-15,519,Distribution,110000,-8020000,6620001,-1399999
45713,2020-09-30,519,Value,3229990,-8020000,6620001,-1399999
45713,2020-11-15,519,Distribution,2680000,-8020000,9300001,1280001
45713,2020-12-31,519,Value,0,-8020000,9300001,1280001
45713,2021-03-31,519,Value,0,-8020000,9300001,1280001
45713,2021-06-30,519,Value,0,-8020000,9300001,1280001
45713,2021-09-30,519,Value,0,-8020000,9300001,1280001
45899,2020-02-15,11548,Capital Call,-732580,-6693115,0,-6693115
45899,2020-03-31,11548,Value,7378540,-6693115,0,-6693115
45899,2020-05-16,11548,Capital Call,-511764,-7204879,0,-7204879
45899,2020-06-30,11548,Value,7911000,-7204879,0,-7204879
45900,2020-03-31,23,Value,5640000,-7573332,2000000,-5573332
45900,2020-05-16,23,Capital Call,-146667,-7719999,2000000,-5719999
45900,2020-06-30,23,Value,7080000,-7719999,2000000,-5719999
45900,2020-08-15,23,Capital Call,-400000,-8119999,2000000,-6119999
45900,2020-09-30,23,Value,7626660,-8119999,2000000,-6119999
45900,2020-11-15,23,Capital Call,-400000,-8519999,2000000,-6519999
45900,2020-12-31,23,Value,9173330,-8519999,2000000,-6519999
45900,2021-02-14,23,Capital Call,-306667,-8826666,2000000,-6826666
45900,2021-03-31,23,Value,9960000,-8826666,2000000,-6826666
45900,2021-05-16,23,Capital Call,-320000,-9146666,2000000,-7146666
45900,2021-05-16,23,Distribution,1946667,-9146666,3946667,-5199999
45900,2021-06-30,23,Value,10320000,-9146666,3946667,-5199999
45900,2021-09-30,23,Value,11266660,-9146666,3946667,-5199999
45963,2020-02-15,32667,Distribution,516667,-10076665,7753334,-2323331
45963,2020-03-31,32667,Value,2979990,-10076665,7753334,-2323331
45963,2020-05-16,32667,Distribution,60000,-10076665,7813334,-2263331
45963,2020-06-30,32667,Value,3709990,-10076665,7813334,-2263331
45963,2020-08-15,32667,Distribution,240000,-10076665,8053334,-2023331
45963,2020-09-30,32667,Value,4046660,-10076665,8053334,-2023331
45963,2020-11-15,32667,Distribution,1320000,-10076665,9373334,-703331
45963,2020-12-31,32667,Value,3309990,-10076665,9373334,-703331
45963,2021-02-14,32667,Distribution,863333,-10076665,10236667,160002
45963,2021-03-31,32667,Value,2749990,-10076665,10236667,160002
45963,2021-05-16,32667,Distribution,83333,-10076665,10320000,243335
45963,2021-06-30,32667,Value,2893330,-10076665,10320000,243335
45963,2021-09-30,32667,Value,3349990,-10076665,10320000,243335
45980,2020-02-15,6360,Capital Call,-165903,-8713142,867851,-7845291
45980,2020-03-31,6360,Value,7607090,-8713142,867851,-7845291
45980,2020-06-30,6360,Value,7261880,-8713142,867851,-7845291
45980,2020-08-15,6360,Distribution,184036,-8713142,1051887,-7661255
45980,2020-09-30,6360,Value,7142120,-8713142,1051887,-7661255
45980,2020-12-31,6360,Value,7044440,-8713142,1051887,-7661255
45980,2021-02-14,6360,Capital Call,-959544,-9672686,1051887,-8620799
45980,2021-03-31,6360,Value,8283660,-9672686,1051887,-8620799
45980,2021-06-30,6360,Value,8116610,-9672686,1051887,-8620799
45980,2021-09-30,6360,Value,8422520,-9672686,1051887,-8620799
45982,2020-07-01,240230,Distribution,1843766,-8843000,6718030,-2124970
45982,2020-12-31,240230,Value,5835490,-8843000,6718030,-2124970
46029,2020-02-15,4936,Capital Call,-71972,-7601026,2453718,-5147308
46029,2020-02-15,4936,Distribution,-108,-7601026,2453610,-5147416
46029,2020-03-31,4936,Value,9546880,-7601026,2453610,-5147416
46029,2020-05-16,4936,Capital Call,-238907,-7839933,2453610,-5386323
46029,2020-05-16,4936,Distribution,288,-7839933,2453898,-5386035
46029,2020-06-30,4936,Value,10693660,-7839933,2453898,-5386035
46029,2020-08-15,4936,Capital Call,242905,-7597028,2453898,-5143130
46029,2020-08-15,4936,Distribution,-819,-7597028,2453079,-5143949
46029,2020-09-30,4936,Value,12622460,-7597028,2453079,-5143949
46029,2020-11-15,4936,Capital Call,-366972,-7964000,2453079,-5510921
46029,2020-11-15,4936,Distribution,1425,-7964000,2454504,-5509496
46029,2020-12-31,4936,Value,13493400,-7964000,2454504,-5509496
46029,2021-02-14,4936,Capital Call,-181000,-8145000,2454504,-5690496
46029,2021-02-14,4936,Distribution,398,-8145000,2454902,-5690098
46029,2021-03-31,4936,Value,14330310,-8145000,2454902,-5690098
46029,2021-05-16,4936,Capital Call,-235000,-8380000,2454902,-5925098
46029,2021-05-16,4936,Distribution,4933743,-8380000,7388645,-991355
46029,2021-06-30,4936,Value,10278900,-8380000,7388645,-991355
46029,2021-08-15,4936,Capital Call,-49000,-8429000,7388645,-1040355
46029,2021-08-15,4936,Distribution,404807,-8429000,7793452,-635548
46029,2021-09-30,4936,Value,12062740,-8429000,7793452,-635548
46046,2020-03-31,1357,Distribution,325000,-7826926,3474959,-4351967
46046,2020-06-30,1357,Value,13669860,-7826926,3474959,-4351967
46046,2020-08-15,1357,Distribution,500000,-7826926,3974959,-3851967
46046,2020-09-30,1357,Value,13747180,-7826926,3974959,-3851967
46046,2020-11-15,1357,Distribution,300000,-7826926,4274959,-3551967
46046,2020-12-31,1357,Value,13674010,-7826926,4274959,-3551967
46046,2021-03-31,1357,Value,14218890,-7826926,4274959,-3551967
46046,2021-06-30,1357,Value,16329500,-7826926,4274959,-3551967
46046,2021-08-15,1357,Distribution,2000000,-7826926,6274959,-1551967
46046,2021-09-30,1357,Value,9686500,-7826926,6274959,-1551967
46052,2020-02-15,44,Capital Call,-482220,-8506133,1138746,-7367387
46052,2020-02-15,44,Distribution,79293,-8506133,1218039,-7288094
46052,2020-03-31,44,Value,5408820,-8506133,1218039,-7288094
46052,2020-06-30,44,Value,6670640,-8506133,1218039,-7288094
46052,2020-08-15,44,Capital Call,-694648,-9200781,1218039,-7982742
46052,2020-08-15,44,Distribution,14869,-9200781,1232908,-7967873
46052,2020-09-30,44,Value,8085090,-9200781,1232908,-7967873
46052,2020-11-15,44,Capital Call,-7014,-9207795,1232908,-7974887
46052,2020-11-15,44,Distribution,180057,-9207795,1412965,-7794830
46052,2020-12-31,44,Value,9567100,-9207795,1412965,-7794830
46052,2021-02-14,44,Capital Call,-202116,-9409911,1412965,-7996946
46052,2021-02-14,44,Distribution,88371,-9409911,1501336,-7908575
46052,2021-03-31,44,Value,10714160,-9409911,1501336,-7908575
46052,2021-05-16,44,Capital Call,-36181,-9446092,1501336,-7944756
46052,2021-05-16,44,Distribution,391035,-9446092,1892371,-7553721
46052,2021-06-30,44,Value,11649180,-9446092,1892371,-7553721
46052,2021-08-15,44,Capital Call,-200924,-9647016,1892371,-7754645
46052,2021-08-15,44,Distribution,1696559,-9647016,3588930,-6058086
46052,2021-09-30,44,Value,11118900,-9647016,3588930,-6058086
46104,2020-01-15,2238,Distribution,289380,-9500000,4733056,-4766944
46104,2020-02-29,2238,Value,25095570,-9500000,4733056,-4766944
46104,2020-04-15,2238,Distribution,0,-9500000,4733056,-4766944
46104,2020-05-31,2238,Value,26601260,-9500000,4733056,-4766944
46104,2020-07-16,2238,Distribution,434075,-9500000,5167131,-4332869
46104,2020-08-31,2238,Value,28588500,-9500000,5167131,-4332869
46104,2020-10-16,2238,Capital Call,-50000,-9550000,5167131,-4382869
46104,2020-10-16,2238,Distribution,1953880,-9550000,7121011,-2428989
46104,2020-11-30,2238,Value,32474180,-9550000,7121011,-2428989
46104,2021-01-14,2238,Distribution,386583,-9550000,7507594,-2042406
46104,2021-02-28,2238,Value,32087600,-9550000,7507594,-2042406
46104,2021-04-15,2238,Distribution,353687,-9550000,7861281,-1688719
46104,2021-05-31,2238,Value,39859740,-9550000,7861281,-1688719
46104,2021-07-16,2238,Distribution,2763747,-9550000,10625028,1075028
46104,2021-08-31,2238,Value,39024250,-9550000,10625028,1075028
46104,2021-10-16,2238,Distribution,1238413,-9550000,11863441,2313441
46104,2021-11-30,2238,Value,41210510,-9550000,11863441,2313441
46167,2020-02-15,2447,Capital Call,-695158,-8496567,1631421,-6865146
46167,2020-03-31,2447,Value,7397740,-8496567,1631421,-6865146
46167,2020-05-16,2447,Capital Call,-194610,-8691177,1631421,-7059756
46167,2020-05-16,2447,Distribution,60586,-8691177,1692007,-6999170
46167,2020-06-30,2447,Value,8447520,-8691177,1692007,-6999170
46167,2020-09-30,2447,Value,9515030,-8691177,1692007,-6999170
46167,2020-11-15,2447,Capital Call,-176690,-8867867,1692007,-7175860
46167,2020-11-15,2447,Distribution,740920,-8867867,2432927,-6434940
46167,2020-12-31,2447,Value,10144970,-8867867,2432927,-6434940
46187,2020-02-15,504,Capital Call,-164970,-7570802,2038618,-5532184
46187,2020-02-15,504,Distribution,533225,-7570802,2571843,-4998959
46187,2020-03-31,504,Value,9759200,-7570802,2571843,-4998959
46187,2020-05-16,504,Capital Call,-79775,-7650577,2571843,-5078734
46187,2020-05-16,504,Distribution,122806,-7650577,2694649,-4955928
46187,2020-06-30,504,Value,11200320,-7650577,2694649,-4955928
46187,2020-08-15,504,Capital Call,-125472,-7776049,2694649,-5081400
46187,2020-08-15,504,Distribution,451958,-7776049,3146607,-4629442
46187,2020-09-30,504,Value,11247680,-7776049,3146607,-4629442
46187,2020-11-15,504,Capital Call,-145740,-7921789,3146607,-4775182
46187,2020-11-15,504,Distribution,610551,-7921789,3757158,-4164631
46187,2020-12-31,504,Value,13841160,-7921789,3757158,-4164631
46293,2020-02-15,643,Distribution,-6769,-9670000,541520,-9128480
46293,2020-03-31,643,Value,14276780,-9670000,541520,-9128480
46293,2020-05-16,643,Capital Call,-169000,-9839000,541520,-9297480
46293,2020-05-16,643,Distribution,6512,-9839000,548032,-9290968
46293,2020-06-30,643,Value,14566630,-9839000,548032,-9290968
46293,2020-08-15,643,Distribution,0,-9839000,548032,-9290968
46293,2020-09-30,643,Value,17424860,-9839000,548032,-9290968
46293,2020-11-15,643,Capital Call,-114000,-9953000,548032,-9404968
46293,2020-11-15,643,Distribution,1045443,-9953000,1593475,-8359525
46293,2020-12-31,643,Value,17264470,-9953000,1593475,-8359525
46293,2021-02-14,643,Capital Call,-35000,-9988000,1593475,-8394525
46293,2021-02-14,643,Distribution,910516,-9988000,2503991,-7484009
46293,2021-03-31,643,Value,29772230,-9988000,2503991,-7484009
46293,2021-05-16,643,Distribution,0,-9988000,2503991,-7484009
46293,2021-06-30,643,Value,35504340,-9988000,2503991,-7484009
46293,2021-08-15,643,Capital Call,-107000,-10095000,2503991,-7591009
46293,2021-08-15,643,Distribution,3838697,-10095000,6342688,-3752312
46293,2021-09-30,643,Value,32175790,-10095000,6342688,-3752312
46293,2021-11-15,643,Capital Call,-28000,-10123000,6342688,-3780312
46293,2021-11-15,643,Distribution,668501,-10123000,7011189,-3111811
46293,2021-12-31,643,Value,28087270,-10123000,7011189,-3111811
46476,2020-03-31,67055,Value,14900000,-10000000,7000000,-3000000
46476,2020-05-16,67055,Distribution,3400000,-10000000,10400000,400000
46476,2020-06-30,67055,Value,15400000,-10000000,10400000,400000
46476,2020-08-15,67055,Distribution,6168000,-10000000,16568000,6568000
46476,2020-09-30,67055,Value,12993000,-10000000,16568000,6568000
46476,2020-11-15,67055,Distribution,4032000,-10000000,20600000,10600000
46476,2020-12-31,67055,Value,10700000,-10000000,20600000,10600000
46721,2020-03-31,2225,Value,23000000,-9999999,400000,-9599999
46721,2020-05-16,2225,Distribution,2900000,-9999999,3300000,-6699999
46721,2020-06-30,2225,Value,29100000,-9999999,3300000,-6699999
46721,2020-09-30,2225,Value,32800000,-9999999,3300000,-6699999
46721,2020-12-31,2225,Value,51100000,-9999999,3300000,-6699999
46721,2021-02-14,2225,Distribution,6800000,-9999999,10100000,100001
46721,2021-03-31,2225,Value,37700000,-9999999,10100000,100001
46721,2021-05-16,2225,Distribution,400000,-9999999,10500000,500001
46721,2021-06-30,2225,Value,29000000,-9999999,10500000,500001
46721,2021-08-15,2225,Distribution,100000,-9999999,10600000,600001
46721,2021-09-30,2225,Value,33100000,-9999999,10600000,600001
46721,2021-12-31,2225,Value,19800000,-9999999,10600000,600001
46860,2020-02-15,872,Capital Call,-440000,-9187000,6358000,-2829000
46860,2020-03-31,872,Value,6426500,-9187000,6358000,-2829000
46860,2020-05-16,872,Capital Call,-226500,-9413500,6358000,-3055500
46860,2020-06-30,872,Value,6702000,-9413500,6358000,-3055500
46860,2020-08-15,872,Capital Call,500,-9413000,6358000,-3055000
46860,2020-08-15,872,Distribution,-500,-9413000,6357500,-3055500
46860,2020-09-30,872,Value,6835000,-9413000,6357500,-3055500
46860,2020-11-15,872,Capital Call,-500,-9413500,6357500,-3056000
46860,2020-11-15,872,Distribution,500,-9413500,6358000,-3055500
46860,2020-12-31,872,Value,7015000,-9413500,6358000,-3055500
46860,2021-02-14,872,Capital Call,-96500,-9510000,6358000,-3152000
46860,2021-02-14,872,Distribution,224000,-9510000,6582000,-2928000
46860,2021-03-31,872,Value,12772000,-9510000,6582000,-2928000
46860,2021-05-16,872,Capital Call,-79000,-9589000,6582000,-3007000
46860,2021-05-16,872,Distribution,3504000,-9589000,10086000,497000
46860,2021-06-30,872,Value,11549500,-9589000,10086000,497000
46865,2020-03-31,168964,Value,11141570,-9314590,4549787,-4764803
46865,2020-07-01,168964,Capital Call,-252590,-9567180,4549787,-5017393
46865,2020-09-30,168964,Value,16830480,-9567180,4549787,-5017393
46865,2020-12-31,168964,Value,21345300,-9567180,4549787,-5017393
46927,2020-02-15,741,Capital Call,-2997,-10940001,14111627,3171626
46927,2020-02-15,741,Distribution,974,-10940001,14112601,3172600
46927,2020-03-31,741,Value,18794920,-10940001,14112601,3172600
46927,2020-06-30,741,Value,23170920,-10940001,14112601,3172600
46927,2020-09-30,741,Value,30194400,-10940001,14112601,3172600
46927,2020-11-15,741,Capital Call,2997,-10937004,14112601,3175597
46927,2020-11-15,741,Distribution,1096322,-10937004,15208923,4271919
46927,2020-12-31,741,Value,31700510,-10937004,15208923,4271919
46927,2021-02-14,741,Capital Call,3,-10937001,15208923,4271922
46927,2021-02-14,741,Distribution,70,-10937001,15208993,4271992
46927,2021-03-31,741,Value,40038160,-10937001,15208993,4271992
46927,2021-06-30,741,Value,47334240,-10937001,15208993,4271992
46927,2021-08-15,741,Distribution,16803607,-10937001,32012600,21075599
46927,2021-09-30,741,Value,32570380,-10937001,32012600,21075599
46990,2020-02-15,1383,Capital Call,-1100000,-7650000,334050,-7315950
46990,2020-02-15,1383,Distribution,239700,-7650000,573750,-7076250
46990,2020-03-31,1383,Value,9103500,-7650000,573750,-7076250
46990,2020-07-01,1383,Capital Call,-420000,-8070000,573750,-7496250
46990,2020-07-01,1383,Distribution,426930,-8070000,1000680,-7069320
46990,2020-09-30,1383,Value,11540100,-8070000,1000680,-7069320
46990,2020-12-30,1383,Distribution,1823820,-8070000,2824500,-5245500
46990,2021-03-31,1383,Value,14122500,-8070000,2824500,-5245500
46990,2021-05-16,1383,Capital Call,-20000,-8090000,2824500,-5265500
46990,2021-05-16,1383,Distribution,7000,-8090000,2831500,-5258500
46990,2021-06-30,1383,Value,14481100,-8090000,2831500,-5258500
46990,2021-08-15,1383,Capital Call,-190000,-8280000,2831500,-5448500
46990,2021-08-15,1383,Distribution,-32860,-8280000,2798640,-5481360
46990,2021-09-30,1383,Value,15152400,-8280000,2798640,-5481360
46990,2021-11-15,1383,Distribution,24840,-8280000,2823480,-5456520
46990,2021-12-31,1383,Value,18878400,-8280000,2823480,-5456520
47016,2020-03-31,372,Value,11130760,-10438461,2884617,-7553844
47016,2020-05-16,372,Capital Call,-776923,-11215384,2884617,-8330767
47016,2020-05-16,372,Distribution,423077,-11215384,3307694,-7907690
47016,2020-06-30,372,Value,11361530,-11215384,3307694,-7907690
47016,2020-09-30,372,Value,12546150,-11215384,3307694,-7907690
47016,2020-12-31,372,Value,13876920,-11215384,3307694,-7907690
47016,2021-02-14,372,Distribution,776923,-11215384,4084617,-7130767
47016,2021-03-31,372,Value,15915380,-11215384,4084617,-7130767
47016,2021-05-16,372,Distribution,169231,-11215384,4253848,-6961536
47016,2021-06-30,372,Value,16592300,-11215384,4253848,-6961536
47016,2021-08-15,372,Distribution,623077,-11215384,4876925,-6338459
47016,2021-09-30,372,Value,17238460,-11215384,4876925,-6338459
47064,2020-03-31,9035,Value,27567070,-9999999,32432997,22432998
47157,2020-02-15,14055,Capital Call,-12000,-10311334,13320000,3008666
47157,2020-02-15,14055,Distribution,2287333,-10311334,15607333,5295999
47157,2020-03-31,14055,Value,7655330,-10311334,15607333,5295999
47157,2020-05-16,14055,Distribution,22667,-10311334,15630000,5318666
47157,2020-06-30,14055,Value,7974000,-10311334,15630000,5318666
47157,2020-09-30,14055,Value,8346660,-10311334,15630000,5318666
47157,2020-11-15,14055,Capital Call,-66667,-10378001,15630000,5251999
47157,2020-12-31,14055,Value,9516000,-10378001,15630000,5251999
47157,2021-02-14,14055,Distribution,134000,-10378001,15764000,5385999
47157,2021-03-31,14055,Value,9622000,-10378001,15764000,5385999
47157,2021-05-16,14055,Capital Call,-11333,-10389334,15764000,5374666
47157,2021-05-16,14055,Distribution,1427333,-10389334,17191333,6801999
47157,2021-06-30,14055,Value,8549330,-10389334,17191333,6801999
47261,2020-02-15,361,Capital Call,-16724,-10061211,975074,-9086137
47261,2020-03-31,361,Value,9468800,-10061211,975074,-9086137
47261,2020-05-16,361,Capital Call,-33976,-10095187,975074,-9120113
47261,2020-06-30,361,Value,12063620,-10095187,975074,-9120113
47261,2020-08-15,361,Capital Call,-17018,-10112205,975074,-9137131
47261,2020-08-15,361,Distribution,308946,-10112205,1284020,-8828185
47261,2020-09-30,361,Value,13561000,-10112205,1284020,-8828185
47261,2020-11-15,361,Distribution,560673,-10112205,1844693,-8267512
47261,2020-12-31,361,Value,13905340,-10112205,1844693,-8267512
47261,2021-02-14,361,Capital Call,-27327,-10139532,1844693,-8294839
47261,2021-02-14,361,Distribution,145853,-10139532,1990546,-8148986
47261,2021-03-31,361,Value,15057410,-10139532,1990546,-8148986
47261,2021-05-16,361,Capital Call,-31752,-10171284,1990546,-8180738
47261,2021-05-16,361,Distribution,806066,-10171284,2796612,-7374672
47261,2021-06-30,361,Value,17174660,-10171284,2796612,-7374672
47327,2020-03-31,5571,Value,7824710,-6200000,0,-6200000
47327,2020-05-16,5571,Capital Call,-500000,-6700000,0,-6700000
47327,2020-06-30,5571,Value,8761440,-6700000,0,-6700000
47327,2020-08-15,5571,Distribution,204358,-6700000,204358,-6495642
47327,2020-09-30,5571,Value,8834190,-6700000,204358,-6495642
47327,2020-11-15,5571,Distribution,255262,-6700000,459620,-6240380
47327,2020-12-31,5571,Value,9552860,-6700000,459620,-6240380
47327,2021-02-14,5571,Distribution,344380,-6700000,804000,-5896000
47327,2021-03-31,5571,Value,10656260,-6700000,804000,-5896000
47327,2021-05-16,5571,Distribution,601033,-6700000,1405033,-5294967
47327,2021-06-30,5571,Value,10580430,-6700000,1405033,-5294967
47327,2021-08-15,5571,Distribution,613007,-6700000,2018040,-4681960
47327,2021-09-30,5571,Value,10550490,-6700000,2018040,-4681960
47388,2020-03-31,134353,Value,14255650,-8966633,1523768,-7442865
47388,2020-06-10,134353,Distribution,864237,-8966633,2388005,-6578628
47388,2020-08-24,134353,Distribution,288079,-8966633,2676084,-6290549
47388,2020-09-30,134353,Distribution,1437432,-8966633,4113516,-4853117
47388,2020-09-30,134353,Value,15349910,-8966633,4113516,-4853117
47388,2020-12-18,134353,Distribution,806621,-8966633,4920137,-4046496
47388,2020-12-30,134353,Distribution,201655,-8966633,5121792,-3844841
47388,2020-12-31,134353,Value,18633310,-8966633,5121792,-3844841
47388,2021-03-30,134353,Distribution,357218,-8966633,5479010,-3487623
47388,2021-06-04,134353,Distribution,1843706,-8966633,7322716,-1643917
47388,2021-06-30,134353,Distribution,230463,-8966633,7553179,-1413454
47388,2021-06-30,134353,Value,23234330,-8966633,7553179,-1413454
47388,2021-12-31,134353,Value,0,-8966633,7553179,-1413454
47389,2020-03-31,134353,Value,0,-9544380,22746857,13202477
47389,2020-05-07,134353,Distribution,19383706,-9544380,42130563,32586183
47389,2020-06-30,134353,Value,0,-9544380,42130563,32586183
47389,2020-09-04,134353,Capital Call,0,-9544380,42130563,32586183
47389,2020-09-30,134353,Value,14074770,-9544380,42130563,32586183
47389,2020-12-31,134353,Value,23477190,-9544380,42130563,32586183
47389,2021-06-09,134353,Distribution,2513261,-9544380,44643824,35099444
47389,2021-06-30,134353,Value,21741990,-9544380,44643824,35099444
47389,2021-12-31,134353,Value,0,-9544380,44643824,35099444
47411,2020-03-31,496,Value,9922710,-11221857,4198327,-7023530
47411,2020-06-30,496,Value,10123720,-11221857,4198327,-7023530
47411,2020-09-30,496,Value,10398350,-11221857,4198327,-7023530
47411,2020-11-15,496,Capital Call,-130111,-11351968,4198327,-7153641
47411,2020-11-15,496,Distribution,1167332,-11351968,5365659,-5986309
47411,2020-12-31,496,Value,11721010,-11351968,5365659,-5986309
47411,2021-03-31,496,Value,11590910,-11351968,5365659,-5986309
47411,2021-06-30,496,Value,14773350,-11351968,5365659,-5986309
47448,2020-02-15,12208,Capital Call,-1750000,-7000000,1155000,-5845000
47448,2020-02-15,12208,Distribution,35000,-7000000,1190000,-5810000
47448,2020-03-31,12208,Value,6860000,-7000000,1190000,-5810000
47448,2020-06-30,12208,Value,6930000,-7000000,1190000,-5810000
47448,2020-09-30,12208,Value,7070000,-7000000,1190000,-5810000
47448,2020-12-31,12208,Value,8120000,-7000000,1190000,-5810000
47460,2020-02-15,741,Capital Call,-3038,-9800000,3665720,-6134280
47460,2020-02-15,741,Distribution,-520,-9800000,3665200,-6134800
47460,2020-03-31,741,Value,7800800,-9800000,3665200,-6134800
47460,2020-06-30,741,Value,8085000,-9800000,3665200,-6134800
47460,2020-09-30,741,Value,8859200,-9800000,3665200,-6134800
47460,2020-11-15,741,Capital Call,-351089,-10151089,3665200,-6485889
47460,2020-11-15,741,Distribution,530,-10151089,3665730,-6485359
47460,2020-12-31,741,Value,9663040,-10151089,3665730,-6485359
47460,2021-02-14,741,Capital Call,89,-10151000,3665730,-6485270
47460,2021-02-14,741,Distribution,-204,-10151000,3665526,-6485474
47460,2021-03-31,741,Value,10247430,-10151000,3665526,-6485474
47460,2021-05-16,741,Capital Call,-298000,-10449000,3665526,-6783474
47460,2021-05-16,741,Distribution,-17,-10449000,3665509,-6783491
47460,2021-06-30,741,Value,12682990,-10449000,3665509,-6783491
47460,2021-09-30,741,Value,14910720,-10449000,3665509,-6783491
47576,2020-03-31,736,Value,8152950,-10000000,1832644,-8167356
47576,2020-06-30,736,Value,8543700,-10000000,1832644,-8167356
47576,2020-09-30,736,Value,8043840,-10000000,1832644,-8167356
47576,2020-12-31,736,Value,10182910,-10000000,1832644,-8167356
47641,2020-02-15,428403,Capital Call,-237222,-8794335,2049710,-6744625
47641,2020-02-15,428403,Distribution,160926,-8794335,2210636,-6583699
47641,2020-03-31,428403,Value,5238060,-8794335,2210636,-6583699
47641,2020-05-16,428403,Capital Call,-211000,-9005335,2210636,-6794699
47641,2020-06-30,428403,Value,5501520,-9005335,2210636,-6794699
47641,2020-09-30,428403,Value,5802520,-9005335,2210636,-6794699
47641,2020-11-15,428403,Capital Call,-211309,-9216644,2210636,-7006008
47641,2020-12-31,428403,Value,6238620,-9216644,2210636,-7006008
47641,2021-02-14,428403,Capital Call,-403304,-9619948,2210636,-7409312
47641,2021-02-14,428403,Distribution,680592,-9619948,2891228,-6728720
47641,2021-03-31,428403,Value,5961330,-9619948,2891228,-6728720
47651,2020-02-15,111,Capital Call,-949267,-8586477,888866,-7697611
47651,2020-02-15,111,Distribution,14556,-8586477,903422,-7683055
47651,2020-03-31,111,Value,8716410,-8586477,903422,-7683055
47651,2020-05-16,111,Capital Call,-596286,-9182763,903422,-8279341
47651,2020-05-16,111,Distribution,4257,-9182763,907679,-8275084
47651,2020-06-30,111,Value,9738480,-9182763,907679,-8275084
47651,2020-08-15,111,Capital Call,-460794,-9643557,907679,-8735878
47651,2020-08-15,111,Distribution,4858,-9643557,912537,-8731020
47651,2020-09-30,111,Value,10781610,-9643557,912537,-8731020
47651,2020-11-15,111,Capital Call,-586251,-10229808,912537,-9317271
47651,2020-11-15,111,Distribution,248758,-10229808,1161295,-9068513
47651,2020-12-31,111,Value,12054540,-10229808,1161295,-9068513
47651,2021-02-14,111,Capital Call,-7910,-10237718,1161295,-9076423
47651,2021-02-14,111,Distribution,507268,-10237718,1668563,-8569155
47651,2021-03-31,111,Value,12785840,-10237718,1668563,-8569155
47651,2021-05-16,111,Capital Call,-26537,-10264255,1668563,-8595692
47651,2021-05-16,111,Distribution,669274,-10264255,2337837,-7926418
47651,2021-06-30,111,Value,13627300,-10264255,2337837,-7926418
47668,2020-02-15,70490,Capital Call,-350000,-7800000,17135,-7782865
47668,2020-02-15,70490,Distribution,1698865,-7800000,1716000,-6084000
47668,2020-03-31,70490,Value,10218000,-7800000,1716000,-6084000
47668,2020-06-30,70490,Value,10218000,-7800000,1716000,-6084000
47668,2020-08-15,70490,Capital Call,-250000,-8050000,1716000,-6334000
47668,2020-08-15,70490,Distribution,-25500,-8050000,1690500,-6359500
47668,2020-09-30,70490,Value,10948000,-8050000,1690500,-6359500
47668,2020-11-15,70490,Distribution,1288000,-8050000,2978500,-5071500
47668,2020-12-31,70490,Value,17629500,-8050000,2978500,-5071500
47668,2021-03-31,70490,Value,17549000,-8050000,2978500,-5071500
47668,2021-05-16,70490,Capital Call,-1300000,-9350000,2978500,-6371500
47668,2021-05-16,70490,Distribution,13500,-9350000,2992000,-6358000
47668,2021-06-30,70490,Value,18887000,-9350000,2992000,-6358000
47668,2021-08-15,70490,Distribution,9911000,-9350000,12903000,3553000
47668,2021-09-30,70490,Value,8882500,-9350000,12903000,3553000
47681,2020-02-15,77,Capital Call,-290793,-8076122,5969429,-2106693
47681,2020-02-15,77,Distribution,2676447,-8076122,8645876,569754
47681,2020-03-31,77,Value,2503690,-8076122,8645876,569754
47681,2020-05-16,77,Distribution,291682,-8076122,8937558,861436
47681,2020-06-30,77,Value,2081360,-8076122,8937558,861436
47681,2020-08-15,77,Distribution,798375,-8076122,9735933,1659811
47681,2020-09-30,77,Value,1484520,-8076122,9735933,1659811
47681,2020-11-15,77,Distribution,164116,-8076122,9900049,1823927
47681,2020-12-31,77,Value,1601540,-8076122,9900049,1823927
47681,2021-04-01,77,Distribution,357731,-8076122,10257780,2181658
47681,2021-06-30,77,Value,1647470,-8076122,10257780,2181658
47688,2020-02-15,11813,Capital Call,-110000,-7563000,1930328,-5632672
47688,2020-02-15,11813,Distribution,197145,-7563000,2127473,-5435527
47688,2020-03-31,11813,Value,12470630,-7563000,2127473,-5435527
47688,2020-05-16,11813,Capital Call,-34000,-7597000,2127473,-5469527
47688,2020-05-16,11813,Distribution,361305,-7597000,2488778,-5108222
47688,2020-06-30,11813,Value,13177750,-7597000,2488778,-5108222
47688,2020-08-15,11813,Capital Call,-384000,-7981000,2488778,-5492222
47688,2020-08-15,11813,Distribution,178473,-7981000,2667251,-5313749
47688,2020-09-30,11813,Value,13497460,-7981000,2667251,-5313749
47688,2020-11-15,11813,Capital Call,-137000,-8118000,2667251,-5450749
47688,2020-11-15,11813,Distribution,41726,-8118000,2708977,-5409023
47688,2020-12-31,11813,Value,16261970,-8118000,2708977,-5409023
47688,2021-02-14,11813,Capital Call,-336000,-8454000,2708977,-5745023
47688,2021-02-14,11813,Distribution,353062,-8454000,3062039,-5391961
47688,2021-03-31,11813,Value,17387340,-8454000,3062039,-5391961
47688,2021-05-16,11813,Capital Call,-161000,-8615000,3062039,-5552961
47688,2021-05-16,11813,Distribution,212523,-8615000,3274562,-5340438
47688,2021-06-30,11813,Value,23090780,-8615000,3274562,-5340438
47716,2020-01-15,52,Distribution,0,-9900000,1570732,-8329268
47716,2020-02-29,52,Value,19256080,-9900000,1570732,-8329268
47716,2020-04-15,52,Capital Call,-100000,-10000000,1570732,-8429268
47716,2020-04-15,52,Distribution,304795,-10000000,1875527,-8124473
47716,2020-05-31,52,Value,18753680,-10000000,1875527,-8124473
47716,2020-08-31,52,Value,20724500,-10000000,1875527,-8124473
47716,2020-10-16,52,Distribution,33529,-10000000,1909056,-8090944
47716,2020-11-30,52,Value,26742560,-10000000,1909056,-8090944
47716,2021-02-28,52,Value,26742560,-10000000,1909056,-8090944
47716,2021-04-15,52,Distribution,1447102,-10000000,3356158,-6643842
47716,2021-05-31,52,Value,32640130,-10000000,3356158,-6643842
47716,2021-07-16,52,Distribution,10964289,-10000000,14320447,4320447
47716,2021-08-31,52,Value,24278850,-10000000,14320447,4320447
47716,2021-10-16,52,Distribution,5716063,-10000000,20036510,10036510
47716,2021-11-30,52,Value,15945160,-10000000,20036510,10036510
47797,2020-03-31,184,Value,8331520,-7449005,0,-7449005
47797,2020-05-16,184,Capital Call,-220647,-7669652,0,-7669652
47797,2020-06-30,184,Value,8856330,-7669652,0,-7669652
47797,2020-08-15,184,Capital Call,65381,-7604271,0,-7604271
47797,2020-09-30,184,Value,7938430,-7604271,0,-7604271
47820,2020-03-31,771,Value,7728520,-9390278,2090228,-7300050
47820,2020-06-30,771,Value,7728520,-9390278,2090228,-7300050
47820,2020-09-30,771,Value,8233160,-9390278,2090228,-7300050
47820,2020-12-31,771,Value,8472840,-9390278,2090228,-7300050
47820,2021-03-31,771,Value,8951000,-9390278,2090228,-7300050
47820,2021-05-16,771,Capital Call,-29956,-9420234,2090228,-7330006
47820,2021-05-16,771,Distribution,457545,-9420234,2547773,-6872461
47820,2021-06-30,771,Value,8938890,-9420234,2547773,-6872461
47909,2020-02-15,2317,Capital Call,110000,-10250000,4589480,-5660520
47909,2020-02-15,2317,Distribution,-192230,-10250000,4397250,-5852750
47909,2020-03-31,2317,Value,8210250,-10250000,4397250,-5852750
47909,2020-06-30,2317,Value,9009750,-10250000,4397250,-5852750
47909,2020-09-30,2317,Value,9645250,-10250000,4397250,-5852750
47909,2020-11-15,2317,Capital Call,60000,-10190000,4397250,-5792750
47909,2020-11-15,2317,Distribution,106730,-10190000,4503980,-5686020
47909,2020-12-31,2317,Value,10607790,-10190000,4503980,-5686020
47909,2021-02-14,2317,Capital Call,-260000,-10450000,4503980,-5946020
47909,2021-02-14,2317,Distribution,2445270,-10450000,6949250,-3500750
47909,2021-03-31,2317,Value,10335050,-10450000,6949250,-3500750
47923,2020-03-31,24,Value,11119370,-9750000,947128,-8802872
48057,2020-02-15,264,Capital Call,-63000,-9263000,3997400,-5265600
48057,2020-02-15,264,Distribution,77394,-9263000,4074794,-5188206
48057,2020-03-31,264,Value,8656270,-9263000,4074794,-5188206
48057,2020-05-16,264,Capital Call,43000,-9220000,4074794,-5145206
48057,2020-05-16,264,Distribution,-202394,-9220000,3872400,-5347600
48057,2020-06-30,264,Value,9220000,-9220000,3872400,-5347600
48100,2020-02-15,40167,Capital Call,-5215,-11245094,13764738,2519644
48100,2020-02-15,40167,Distribution,18726,-11245094,13783464,2538370
48100,2020-03-31,40167,Value,4446480,-11245094,13783464,2538370
48100,2020-05-16,40167,Capital Call,-22977,-11268071,13783464,2515393
48100,2020-05-16,40167,Distribution,27408,-11268071,13810872,2542801
48100,2020-06-30,40167,Value,4019780,-11268071,13810872,2542801
48100,2020-08-15,40167,Capital Call,-23173,-11291244,13810872,2519628
48100,2020-08-15,40167,Distribution,544877,-11291244,14355749,3064505
48100,2020-09-30,40167,Value,3881990,-11291244,14355749,3064505
48100,2020-11-15,40167,Capital Call,-3639,-11294883,14355749,3060866
48100,2020-11-15,40167,Distribution,86815,-11294883,14442564,3147681
48100,2020-12-31,40167,Value,4111560,-11294883,14442564,3147681
48100,2021-02-14,40167,Capital Call,-4671,-11299554,14442564,3143010
48100,2021-02-14,40167,Distribution,24296,-11299554,14466860,3167306
48100,2021-03-31,40167,Value,4148020,-11299554,14466860,3167306
48136,2020-03-31,780,Value,18407080,-9791000,4601770,-5189230
48136,2020-06-30,780,Value,19973640,-9791000,4601770,-5189230
48136,2020-08-15,780,Capital Call,-6000,-9797000,4601770,-5195230
48136,2020-08-15,780,Distribution,-193120,-9797000,4408650,-5388350
48136,2020-09-30,780,Value,20965580,-9797000,4408650,-5388350
48136,2020-11-15,780,Capital Call,-523427,-10320427,4408650,-5911777
48136,2020-11-15,780,Distribution,239138,-10320427,4647788,-5672639
48136,2020-12-31,780,Value,22064140,-10320427,4647788,-5672639
48136,2021-03-31,780,Value,26530570,-10320427,4647788,-5672639
48136,2021-05-16,780,Capital Call,-2667,-10323094,4647788,-5675306
48136,2021-05-16,780,Distribution,4146632,-10323094,8794420,-1528674
48136,2021-06-30,780,Value,25165850,-10323094,8794420,-1528674
48136,2021-08-15,780,Distribution,4198836,-10323094,12993256,2670162
48136,2021-09-30,780,Value,23303240,-10323094,12993256,2670162
48162,2020-02-15,162111,Distribution,1912923,-9549999,6210710,-3339289
48162,2020-03-31,162111,Value,13818090,-9549999,6210710,-3339289
48162,2020-05-16,162111,Distribution,1415180,-9549999,7625890,-1924109
48162,2020-06-30,162111,Value,12504880,-9549999,7625890,-1924109
48162,2020-08-15,162111,Distribution,568341,-9549999,8194231,-1355768
48162,2020-09-30,162111,Value,12884570,-9549999,8194231,-1355768
48162,2020-12-30,162111,Distribution,1811862,-9549999,10006093,456094
48162,2021-03-31,162111,Value,11692120,-9549999,10006093,456094
48163,2020-03-31,1480,Value,3450000,-10000000,23390000,13390000
48163,2020-06-30,1480,Value,3490000,-10000000,23390000,13390000
48163,2020-12-31,1480,Value,3870000,-10000000,23390000,13390000
48163,2021-03-31,1480,Value,3770000,-10000000,23390000,13390000
48163,2021-07-01,1480,Distribution,2000,-10000000,23392000,13392000
48163,2021-09-30,1480,Value,4264000,-10000000,23392000,13392000
48163,2021-11-15,1480,Capital Call,-100000,-10100000,23392000,13292000
48163,2021-11-15,1480,Distribution,519750,-10100000,23911750,13811750
48163,2021-12-31,1480,Value,4320780,-10100000,23911750,13811750
48166,2020-03-31,58707,Value,1939610,-2501722,121771,-2379951
48166,2020-05-16,58707,Capital Call,-100274,-2601996,121771,-2480225
48166,2020-06-30,58707,Value,1757680,-2601996,121771,-2480225
48166,2020-09-30,58707,Value,2322860,-2601996,121771,-2480225
48166,2020-11-15,58707,Capital Call,-205820,-2807816,121771,-2686045
48166,2020-12-31,58707,Value,2528680,-2807816,121771,-2686045
48166,2021-03-31,58707,Value,2594830,-2807816,121771,-2686045
48166,2021-05-16,58707,Capital Call,-697953,-3505769,121771,-3383998
48166,2021-06-30,58707,Value,3868130,-3505769,121771,-3383998
48310,2020-02-15,21861,Capital Call,-70000,-9680000,3651800,-6028200
48310,2020-02-15,21861,Distribution,7240,-9680000,3659040,-6020960
48310,2020-03-31,21861,Value,9428320,-9680000,3659040,-6020960
48310,2020-05-16,21861,Capital Call,-20000,-9700000,3659040,-6040960
48310,2020-05-16,21861,Distribution,-205840,-9700000,3453200,-6246800
48310,2020-06-30,21861,Value,9612700,-9700000,3453200,-6246800
48310,2020-09-30,21861,Value,11028900,-9700000,3453200,-6246800
48310,2020-11-15,21861,Capital Call,3000,-9697000,3453200,-6243800
48310,2020-11-15,21861,Distribution,-1068,-9697000,3452132,-6244868
48310,2020-12-31,21861,Value,12498460,-9697000,3452132,-6244868
48310,2021-03-31,21861,Value,12818460,-9697000,3452132,-6244868
48310,2021-06-30,21861,Value,13076400,-9697000,3452132,-6244868
48310,2021-08-15,21861,Capital Call,-51000,-9748000,3452132,-6295868
48310,2021-08-15,21861,Distribution,-296704,-9748000,3155428,-6592572
48310,2021-09-30,21861,Value,14347100,-9748000,3155428,-6592572
48310,2021-12-31,21861,Value,15119140,-9748000,3155428,-6592572
48336,2020-03-31,8072,Value,19603720,-10000000,0,-10000000
48336,2020-06-30,8072,Value,19998180,-10000000,0,-10000000
48336,2020-09-30,8072,Value,20720350,-10000000,0,-10000000
48336,2020-11-15,8072,Distribution,6176514,-10000000,6176514,-3823486
48336,2020-12-31,8072,Value,23395610,-10000000,6176514,-3823486
48357,2020-03-31,537,Value,12829710,-9050000,2204286,-6845714
48357,2020-05-16,537,Capital Call,-100000,-9150000,2204286,-6945714
48357,2020-05-16,537,Distribution,11143,-9150000,2215429,-6934571
48357,2020-06-30,537,Value,13125420,-9150000,2215429,-6934571
48357,2020-08-15,537,Capital Call,-300000,-9450000,2215429,-7234571
48357,2020-08-15,537,Distribution,167143,-9450000,2382572,-7067428
48357,2020-09-30,537,Value,15490000,-9450000,2382572,-7067428
48357,2020-12-31,537,Value,18848570,-9450000,2382572,-7067428
48357,2021-02-14,537,Distribution,365429,-9450000,2748001,-6701999
48357,2021-03-31,537,Value,23546850,-9450000,2748001,-6701999
48357,2021-05-16,537,Distribution,884000,-9450000,3632001,-5817999
48357,2021-06-30,537,Value,24440280,-9450000,3632001,-5817999
48424,2020-03-31,350,Value,7837000,-7295999,1848620,-5447379
48424,2020-06-30,350,Value,7804960,-7295999,1848620,-5447379
48424,2020-08-15,350,Capital Call,-747395,-8043394,1848620,-6194774
48424,2020-08-15,350,Distribution,588885,-8043394,2437505,-5605889
48424,2020-12-31,350,Value,8349320,-8043394,2437505,-5605889
48424,2021-02-14,350,Capital Call,-134781,-8178175,2437505,-5740670
48424,2021-02-14,350,Distribution,420717,-8178175,2858222,-5319953
48424,2021-03-31,350,Value,8148410,-8178175,2858222,-5319953
48424,2021-05-16,350,Capital Call,-285396,-8463571,2858222,-5605349
48424,2021-05-16,350,Distribution,1406794,-8463571,4265016,-4198555
48424,2021-06-30,350,Value,9734050,-8463571,4265016,-4198555
48428,2020-02-15,2007,Capital Call,-120000,-10760000,4915680,-5844320
48428,2020-02-15,2007,Distribution,851680,-10760000,5767360,-4992640
48428,2020-03-31,2007,Value,9996040,-10760000,5767360,-4992640
48428,2020-05-16,2007,Distribution,656360,-10760000,6423720,-4336280
48428,2020-06-30,2007,Value,10092880,-10760000,6423720,-4336280
48428,2020-09-30,2007,Value,11330280,-10760000,6423720,-4336280
48428,2020-11-15,2007,Distribution,785480,-10760000,7209200,-3550800
48428,2020-12-31,2007,Value,14450680,-10760000,7209200,-3550800
48428,2021-02-14,2007,Distribution,5885720,-10760000,13094920,2334920
48428,2021-03-31,2007,Value,9920720,-10760000,13094920,2334920
48428,2021-07-01,2007,Distribution,1753880,-10760000,14848800,4088800
48428,2021-09-30,2007,Value,11599280,-10760000,14848800,4088800
48428,2021-11-15,2007,Distribution,925360,-10760000,15774160,5014160
48428,2021-12-31,2007,Value,10921400,-10760000,15774160,5014160
48430,2020-03-31,5752,Value,0,-7500000,8670085,1170085
48430,2020-06-30,5752,Value,0,-7500000,8670085,1170085
48430,2020-12-31,5752,Value,0,-7500000,8670085,1170085
48434,2020-02-15,29886,Distribution,1976492,-10000000,10067092,67092
48434,2020-03-31,29886,Value,14751610,-10000000,10067092,67092
48434,2020-06-30,29886,Value,15551930,-10000000,10067092,67092
48434,2020-08-15,29886,Distribution,87780,-10000000,10154872,154872
48434,2020-09-30,29886,Value,25638570,-10000000,10154872,154872
48474,2020-02-15,30882,Capital Call,-1000000,-7900000,1400000,-6500000
48474,2020-03-31,30882,Value,8713460,-7900000,1400000,-6500000
48474,2020-06-30,30882,Value,9119750,-7900000,1400000,-6500000
48474,2020-09-30,30882,Value,10439500,-7900000,1400000,-6500000
48474,2020-12-31,30882,Value,11743630,-7900000,1400000,-6500000
48474,2021-02-14,30882,Capital Call,-13822,-7913822,1400000,-6513822
48474,2021-02-14,30882,Distribution,3615693,-7913822,5015693,-2898129
48474,2021-03-31,30882,Value,9014520,-7913822,5015693,-2898129
48474,2021-05-16,30882,Distribution,474944,-7913822,5490637,-2423185
48474,2021-06-30,30882,Value,8852730,-7913822,5490637,-2423185
48474,2021-08-15,30882,Capital Call,-1330000,-9243822,5490637,-3753185
48474,2021-09-30,30882,Value,12223720,-9243822,5490637,-3753185
48488,2020-02-15,9110,Capital Call,-556926,-12570925,2566189,-10004736
48488,2020-02-15,9110,Distribution,862457,-12570925,3428646,-9142279
48488,2020-03-31,9110,Value,12424230,-12570925,3428646,-9142279
48488,2020-05-16,9110,Capital Call,-74,-12570999,3428646,-9142353
48488,2020-05-16,9110,Distribution,-536,-12570999,3428110,-9142889
48488,2020-06-30,9110,Value,12972010,-12570999,3428110,-9142889
48488,2020-08-15,9110,Capital Call,-155000,-12725999,3428110,-9297889
48488,2020-08-15,9110,Distribution,519493,-12725999,3947603,-8778396
48488,2020-09-30,9110,Value,13427200,-12725999,3947603,-8778396
48488,2020-11-15,9110,Capital Call,-30000,-12755999,3947603,-8808396
48488,2020-11-15,9110,Distribution,370301,-12755999,4317904,-8438095
48488,2020-12-31,9110,Value,14688530,-12755999,4317904,-8438095
48488,2021-02-14,9110,Capital Call,-1000,-12756999,4317904,-8439095
48488,2021-02-14,9110,Distribution,108773,-12756999,4426677,-8330322
48488,2021-03-31,9110,Value,15959000,-12756999,4426677,-8330322
48488,2021-05-16,9110,Capital Call,-232000,-12988999,4426677,-8562322
48488,2021-05-16,9110,Distribution,552005,-12988999,4978682,-8010317
48488,2021-06-30,9110,Value,16835040,-12988999,4978682,-8010317
48488,2021-08-15,9110,Capital Call,-147000,-13135999,4978682,-8157317
48488,2021-08-15,9110,Distribution,681619,-13135999,5660301,-7475698
48488,2021-09-30,9110,Value,16426560,-13135999,5660301,-7475698
48534,2020-03-31,11822,Value,9615890,-5357732,525748,-4831984
48534,2020-06-30,11822,Value,9952760,-5357732,525748,-4831984
48534,2020-12-31,11822,Value,7287970,-5357732,525748,-4831984
48556,2020-03-31,22035,Value,12609400,-10150000,2973586,-7176414
48556,2020-05-16,22035,Capital Call,-150000,-10300000,2973586,-7326414
48556,2020-05-16,22035,Distribution,403366,-10300000,3376952,-6923048
48556,2020-06-30,22035,Value,12373140,-10300000,3376952,-6923048
48556,2020-08-15,22035,Distribution,1321810,-10300000,4698762,-5601238
48556,2020-09-30,22035,Value,12856800,-10300000,4698762,-5601238
48556,2020-12-31,22035,Value,15148420,-10300000,4698762,-5601238
48556,2021-03-31,22035,Value,17868870,-10300000,4698762,-5601238
48556,2021-06-30,22035,Value,22326800,-10300000,4698762,-5601238
48556,2021-08-15,22035,Distribution,4735524,-10300000,9434286,-865714
48556,2021-09-30,22035,Value,21026870,-10300000,9434286,-865714
48586,2020-02-15,9004,Capital Call,-200000,-9650000,506444,-9143556
48586,2020-03-31,9004,Value,13024660,-9650000,506444,-9143556
48586,2020-06-30,9004,Value,12911550,-9650000,506444,-9143556
48586,2020-09-30,9004,Value,12997110,-9650000,506444,-9143556
48586,2020-12-31,9004,Value,16555330,-9650000,506444,-9143556
48586,2021-03-31,9004,Value,27438000,-9650000,506444,-9143556
48586,2021-05-16,9004,Distribution,2251556,-9650000,2758000,-6892000
48586,2021-06-30,9004,Value,27945330,-9650000,2758000,-6892000
48656,2020-02-15,1314,Capital Call,-169455,-7603776,2106006,-5497770
48656,2020-02-15,1314,Distribution,173653,-7603776,2279659,-5324117
48656,2020-03-31,1314,Value,8675740,-7603776,2279659,-5324117
48656,2020-05-16,1314,Capital Call,-238927,-7842703,2279659,-5563044
48656,2020-05-16,1314,Distribution,191799,-7842703,2471458,-5371245
48656,2020-06-30,1314,Value,9165680,-7842703,2471458,-5371245
48656,2020-09-30,1314,Capital Call,-481430,-8324133,2471458,-5852675
48656,2020-09-30,1314,Distribution,240693,-8324133,2712151,-5611982
48656,2020-12-31,1314,Value,11869560,-8324133,2712151,-5611982
48656,2021-02-14,1314,Capital Call,-255127,-8579260,2712151,-5867109
48656,2021-02-14,1314,Distribution,650978,-8579260,3363129,-5216131
48656,2021-03-31,1314,Value,12326920,-8579260,3363129,-5216131
48656,2021-05-16,1314,Distribution,633423,-8579260,3996552,-4582708
48656,2021-06-30,1314,Value,13490860,-8579260,3996552,-4582708
48666,2020-06-30,2165,Value,15162000,-11400000,5586000,-5814000
48666,2020-09-30,2165,Value,16872000,-11400000,5586000,-5814000
48666,2020-12-31,2165,Value,16986000,-11400000,5586000,-5814000
48666,2021-02-14,2165,Distribution,11628000,-11400000,17214000,5814000
48666,2021-03-31,2165,Value,6726000,-11400000,17214000,5814000
48666,2021-07-01,2165,Capital Call,7000,-11393000,17214000,5821000
48666,2021-07-01,2165,Distribution,661617,-11393000,17875617,6482617
48666,2021-09-30,2165,Value,6749210,-11393000,17875617,6482617
48666,2021-11-15,2165,Distribution,2517853,-11393000,20393470,9000470
48666,2021-12-31,2165,Value,6749210,-11393000,20393470,9000470
48719,2020-03-31,1597,Value,12461600,-9250000,967550,-8282450
48719,2020-05-16,1597,Distribution,229400,-9250000,1196950,-8053050
48719,2020-06-30,1597,Value,13109100,-9250000,1196950,-8053050
48719,2020-09-30,1597,Value,12971270,-9250000,1196950,-8053050
48719,2020-12-31,1597,Value,17138400,-9250000,1196950,-8053050
48719,2021-03-31,1597,Value,17092150,-9250000,1196950,-8053050
48719,2021-06-30,1597,Value,18630420,-9250000,1196950,-8053050
48719,2021-09-30,1597,Value,18014370,-9250000,1196950,-8053050
48727,2020-03-31,6754,Value,9480000,-9799999,1933333,-7866666
48727,2020-05-16,6754,Capital Call,-533333,-10333332,1933333,-8399999
48727,2020-05-16,6754,Distribution,706667,-10333332,2640000,-7693332
48727,2020-06-30,6754,Value,9573330,-10333332,2640000,-7693332
48727,2020-09-30,6754,Value,9986660,-10333332,2640000,-7693332
48727,2020-12-31,6754,Value,10186660,-10333332,2640000,-7693332
48727,2021-02-14,6754,Capital Call,-200000,-10533332,2640000,-7893332
48727,2021-02-14,6754,Distribution,1400000,-10533332,4040000,-6493332
48727,2021-03-31,6754,Value,9199990,-10533332,4040000,-6493332
48727,2021-06-30,6754,Value,9480000,-10533332,4040000,-6493332
48727,2021-08-15,6754,Capital Call,-13333,-10546665,4040000,-6506665
48727,2021-08-15,6754,Distribution,1000000,-10546665,5040000,-5506665
48727,2021-09-30,6754,Value,8533330,-10546665,5040000,-5506665
48739,2020-02-15,162111,Distribution,2523270,-11200000,5499357,-5700643
48739,2020-03-31,162111,Value,18356610,-11200000,5499357,-5700643
48739,2020-05-16,162111,Distribution,3055565,-11200000,8554922,-2645078
48739,2020-06-30,162111,Value,15133480,-11200000,8554922,-2645078
48739,2020-08-15,162111,Distribution,2869160,-11200000,11424082,224082
48739,2020-09-30,162111,Value,17263910,-11200000,11424082,224082
48739,2020-12-30,162111,Distribution,2575582,-11200000,13999664,2799664
48739,2021-03-31,162111,Value,17534130,-11200000,13999664,2799664
48740,2020-03-31,9052,Value,15351980,-10645800,1189975,-9455825
48746,2020-02-15,161,Capital Call,-51000,-10196333,6699001,-3497332
48746,2020-02-15,161,Distribution,256667,-10196333,6955668,-3240665
48746,2020-03-31,161,Value,7513330,-10196333,6955668,-3240665
48746,2020-05-16,161,Capital Call,-73667,-10270000,6955668,-3314332
48746,2020-05-16,161,Distribution,667,-10270000,6956335,-3313665
48746,2020-06-30,161,Value,7553330,-10270000,6956335,-3313665
48746,2020-08-15,161,Capital Call,-66333,-10336333,6956335,-3379998
48746,2020-08-15,161,Distribution,7667,-10336333,6964002,-3372331
48746,2020-09-30,161,Value,7843660,-10336333,6964002,-3372331
48746,2020-11-15,161,Capital Call,-27667,-10364000,6964002,-3399998
48746,2020-12-31,161,Value,8245660,-10364000,6964002,-3399998
48746,2021-02-14,161,Capital Call,-34667,-10398667,6964002,-3434665
48746,2021-02-14,161,Distribution,549667,-10398667,7513669,-2884998
48746,2021-03-31,161,Value,8636330,-10398667,7513669,-2884998
48746,2021-05-16,161,Capital Call,-32333,-10431000,7513669,-2917331
48746,2021-05-16,161,Distribution,1939333,-10431000,9453002,-977998
48746,2021-06-30,161,Value,6996660,-10431000,9453002,-977998
48792,2020-03-31,11,Value,8163050,-11147052,5659286,-5487766
48792,2020-05-16,11,Capital Call,-47125,-11194177,5659286,-5534891
48792,2020-05-16,11,Distribution,1855839,-11194177,7515125,-3679052
48792,2020-06-30,11,Value,7037300,-11194177,7515125,-3679052
48792,2020-08-15,11,Capital Call,-14527,-11208704,7515125,-3693579
48792,2020-08-15,11,Distribution,78499,-11208704,7593624,-3615080
48792,2020-09-30,11,Value,8098550,-11208704,7593624,-3615080
48792,2020-11-15,11,Capital Call,-8987,-11217691,7593624,-3624067
48792,2020-11-15,11,Distribution,1087206,-11217691,8680830,-2536861
48792,2020-12-31,11,Value,7584810,-11217691,8680830,-2536861
48792,2021-02-14,11,Capital Call,-29853,-11247544,8680830,-2566714
48792,2021-02-14,11,Distribution,217306,-11247544,8898136,-2349408
48792,2021-03-31,11,Value,7860700,-11247544,8898136,-2349408
48792,2021-05-16,11,Capital Call,-20039,-11267583,8898136,-2369447
48792,2021-05-16,11,Distribution,2680221,-11267583,11578357,310774
48792,2021-06-30,11,Value,5548360,-11267583,11578357,310774
48858,2020-02-15,13322,Capital Call,-2463000,-8165000,2752924,-5412076
48858,2020-02-15,13322,Distribution,-392424,-8165000,2360500,-5804500
48858,2020-03-31,13322,Value,5809390,-8165000,2360500,-5804500
48858,2020-05-16,13322,Capital Call,-343000,-8508000,2360500,-6147500
48858,2020-05-16,13322,Distribution,18335,-8508000,2378835,-6129165
48858,2020-06-30,13322,Value,5468090,-8508000,2378835,-6129165
48858,2020-08-15,13322,Capital Call,-92000,-8600000,2378835,-6221165
48858,2020-08-15,13322,Distribution,25723,-8600000,2404558,-6195442
48858,2020-09-30,13322,Value,6123200,-8600000,2404558,-6195442
48858,2020-11-15,13322,Capital Call,-147000,-8747000,2404558,-6342442
48858,2020-11-15,13322,Distribution,1126604,-8747000,3531162,-5215838
48858,2020-12-31,13322,Value,4949920,-8747000,3531162,-5215838
48871,2020-02-15,24,Capital Call,-299981,-7749520,1036061,-6713459
48871,2020-02-15,24,Distribution,151738,-7749520,1187799,-6561721
48871,2020-03-31,24,Value,9326810,-7749520,1187799,-6561721
48871,2020-05-16,24,Capital Call,-655,-7750175,1187799,-6562376
48871,2020-05-16,24,Distribution,100,-7750175,1187899,-6562276
48871,2020-06-30,24,Value,10004160,-7750175,1187899,-6562276
48871,2020-08-15,24,Capital Call,-319910,-8070085,1187899,-6882186
48871,2020-08-15,24,Distribution,122404,-8070085,1310303,-6759782
48871,2020-09-30,24,Value,10616450,-8070085,1310303,-6759782
48871,2020-11-15,24,Distribution,342766,-8070085,1653069,-6417016
48871,2020-12-31,24,Value,11827810,-8070085,1653069,-6417016
48871,2021-02-14,24,Capital Call,-182,-8070267,1653069,-6417198
48871,2021-02-14,24,Distribution,352942,-8070267,2006011,-6064256
48871,2021-03-31,24,Value,13021480,-8070267,2006011,-6064256
48871,2021-05-16,24,Capital Call,182,-8070085,2006011,-6064074
48871,2021-05-16,24,Distribution,495827,-8070085,2501838,-5568247
48871,2021-06-30,24,Value,13553650,-8070085,2501838,-5568247
48871,2021-08-15,24,Distribution,738953,-8070085,3240791,-4829294
48871,2021-09-30,24,Value,13832430,-8070085,3240791,-4829294
48955,2020-02-15,16986,Capital Call,-790735,-11070957,2432910,-8638047
48955,2020-02-15,16986,Distribution,580741,-11070957,3013651,-8057306
48955,2020-03-31,16986,Value,16200950,-11070957,3013651,-8057306
48955,2020-06-30,16986,Value,17681410,-11070957,3013651,-8057306
48955,2020-08-15,16986,Capital Call,-272382,-11343339,3013651,-8329688
48955,2020-09-30,16986,Value,20392810,-11343339,3013651,-8329688
48955,2020-11-15,16986,Capital Call,-270273,-11613612,3013651,-8599961
48955,2020-12-31,16986,Value,25762200,-11613612,3013651,-8599961
48993,2020-12-31,246,Value,15900000,-10000000,3800000,-6200000
49003,2020-03-31,656,Value,10261000,-8250000,0,-8250000
49003,2020-06-30,656,Value,10987400,-8250000,0,-8250000
49003,2020-09-30,656,Value,10138900,-8250000,0,-8250000
49003,2020-12-31,656,Value,13639000,-8250000,0,-8250000
49003,2021-03-31,656,Value,13639000,-8250000,0,-8250000
49003,2021-05-16,656,Distribution,414290,-8250000,414290,-7835710
49003,2021-06-30,656,Value,17567610,-8250000,414290,-7835710
49033,2020-01-20,1368,Distribution,89234,-6762257,7476130,713873
49033,2020-03-31,1368,Capital Call,259,-6761998,7476130,714132
49033,2020-03-31,1368,Distribution,-2274,-6761998,7473856,711858
49033,2020-03-31,1368,Value,4351000,-6761998,7473856,711858
49033,2020-05-16,1368,Capital Call,-259,-6762257,7473856,711599
49033,2020-05-16,1368,Distribution,91508,-6762257,7565364,803107
49033,2020-06-30,1368,Value,4209370,-6762257,7565364,803107
49033,2020-08-15,1368,Capital Call,191,-6762066,7565364,803298
49033,2020-08-15,1368,Distribution,133633,-6762066,7698997,936931
49033,2020-09-30,1368,Value,4093390,-6762066,7698997,936931
49033,2020-11-15,1368,Capital Call,-191,-6762257,7698997,936740
49033,2020-11-15,1368,Distribution,178686,-6762257,7877683,1115426
49033,2020-12-31,1368,Value,3653590,-6762257,7877683,1115426
49033,2021-04-01,1368,Capital Call,259,-6761998,7877683,1115685
49033,2021-04-01,1368,Distribution,615389,-6761998,8493072,1731074
49033,2021-06-30,1368,Value,3424950,-6761998,8493072,1731074
49033,2021-08-15,1368,Capital Call,-67,-6762065,8493072,1731007
49033,2021-08-15,1368,Distribution,209778,-6762065,8702850,1940785
49033,2021-09-30,1368,Value,3406530,-6762065,8702850,1940785
49058,2020-02-15,6657,Capital Call,-11674,-8514076,413287,-8100789
49058,2020-02-15,6657,Distribution,129075,-8514076,542362,-7971714
49058,2020-03-31,6657,Value,8526820,-8514076,542362,-7971714
49058,2020-05-16,6657,Capital Call,-88682,-8602758,542362,-8060396
49058,2020-06-30,6657,Value,8226910,-8602758,542362,-8060396
49058,2020-08-15,6657,Capital Call,-38490,-8641248,542362,-8098886
49058,2020-09-30,6657,Value,8126090,-8641248,542362,-8098886
49058,2020-11-15,6657,Capital Call,-26630,-8667878,542362,-8125516
49058,2020-11-15,6657,Distribution,58489,-8667878,600851,-8067027
49058,2020-12-31,6657,Value,9563530,-8667878,600851,-8067027
49058,2021-02-14,6657,Capital Call,-30114,-8697992,600851,-8097141
49058,2021-03-31,6657,Value,9631420,-8697992,600851,-8097141
49058,2021-05-16,6657,Capital Call,-14767,-8712759,600851,-8111908
49058,2021-05-16,6657,Distribution,72532,-8712759,673383,-8039376
49058,2021-06-30,6657,Value,11285900,-8712759,673383,-8039376
49070,2020-03-31,104974,Value,19900000,-10000000,5000,-9995000
49070,2020-05-16,104974,Distribution,-50,-10000000,4950,-9995050
49070,2020-06-30,104974,Value,21300000,-10000000,4950,-9995050
49070,2020-08-15,104974,Distribution,50,-10000000,5000,-9995000
49070,2020-09-30,104974,Value,22400000,-10000000,5000,-9995000
49070,2020-11-15,104974,Distribution,36000,-10000000,41000,-9959000
49070,2020-12-31,104974,Value,19500000,-10000000,41000,-9959000
49070,2021-02-14,104974,Distribution,-406,-10000000,40594,-9959406
49070,2021-03-31,104974,Value,20200000,-10000000,40594,-9959406
49070,2021-06-30,104974,Value,20600000,-10000000,40594,-9959406
49070,2021-08-15,104974,Distribution,48406,-10000000,89000,-9911000
49070,2021-09-30,104974,Value,24200000,-10000000,89000,-9911000
49070,2021-12-31,104974,Value,21000000,-10000000,89000,-9911000
49129,2020-01-15,8837,Capital Call,-1668937,-8180014,2783104,-5396910
49129,2020-01-15,8837,Distribution,714869,-8180014,3497973,-4682041
49129,2020-02-29,8837,Value,7766180,-8180014,3497973,-4682041
49129,2020-04-15,8837,Capital Call,-548787,-8728801,3497973,-5230828
49129,2020-04-15,8837,Distribution,4345,-8728801,3502318,-5226483
49129,2020-05-31,8837,Value,8003840,-8728801,3502318,-5226483
49129,2020-08-31,8837,Value,9543790,-8728801,3502318,-5226483
49129,2020-10-16,8837,Capital Call,-1714992,-10443793,3502318,-6941475
49129,2020-10-16,8837,Distribution,489755,-10443793,3992073,-6451720
49129,2020-11-30,8837,Value,10823000,-10443793,3992073,-6451720
49129,2021-01-14,8837,Capital Call,-1477184,-11920977,3992073,-7928904
49129,2021-01-14,8837,Distribution,2053047,-11920977,6045120,-5875857
49129,2021-02-28,8837,Value,10824100,-11920977,6045120,-5875857
49129,2021-04-15,8837,Capital Call,-14564,-11935541,6045120,-5890421
49129,2021-04-15,8837,Distribution,2335482,-11935541,8380602,-3554939
49129,2021-05-31,8837,Value,9774410,-11935541,8380602,-3554939
49129,2021-07-16,8837,Capital Call,-1190239,-13125780,8380602,-4745178
49129,2021-07-16,8837,Distribution,1120934,-13125780,9501536,-3624244
49129,2021-08-31,8837,Value,10584010,-13125780,9501536,-3624244
49129,2021-11-30,8837,Value,10687560,-13125780,9501536,-3624244
49247,2020-02-15,146600,Capital Call,-485548,-5582221,4716358,-865863
49247,2020-03-31,146600,Value,5123480,-5582221,4716358,-865863
49247,2020-07-01,146600,Capital Call,-1073570,-6655791,4716358,-1939433
49247,2020-07-01,146600,Distribution,197535,-6655791,4913893,-1741898
49247,2020-09-30,146600,Value,6125720,-6655791,4913893,-1741898
49247,2020-11-15,146600,Capital Call,524541,-6131250,4913893,-1217357
49247,2020-11-15,146600,Distribution,83110,-6131250,4997003,-1134247
49247,2020-12-31,146600,Value,5640870,-6131250,4997003,-1134247
49247,2021-03-31,146600,Value,5781960,-6131250,4997003,-1134247
49247,2021-06-30,146600,Value,5736520,-6131250,4997003,-1134247
49304,2020-02-15,9110,Capital Call,-18178,-10228180,15359922,5131742
49304,2020-02-15,9110,Distribution,1834848,-10228180,17194770,6966590
49304,2020-03-31,9110,Value,11465240,-10228180,17194770,6966590
49304,2020-05-16,9110,Capital Call,-16822,-10245002,17194770,6949768
49304,2020-05-16,9110,Distribution,2303512,-10245002,19498282,9253280
49304,2020-06-30,9110,Value,10032920,-10245002,19498282,9253280
49304,2020-08-15,9110,Capital Call,-8000,-10253002,19498282,9245280
49304,2020-08-15,9110,Distribution,885705,-10253002,20383987,10130985
49304,2020-09-30,9110,Value,9196940,-10253002,20383987,10130985
49304,2020-11-15,9110,Capital Call,-8000,-10261002,20383987,10122985
49304,2020-11-15,9110,Distribution,368883,-10261002,20752870,10491868
49304,2020-12-31,9110,Value,9446270,-10261002,20752870,10491868
49304,2021-02-14,9110,Capital Call,-28000,-10289002,20752870,10463868
49304,2021-02-14,9110,Distribution,1062894,-10289002,21815764,11526762
49304,2021-03-31,9110,Value,19982260,-10289002,21815764,11526762
49304,2021-06-30,9110,Value,16859550,-10289002,21815764,11526762
49304,2021-08-15,9110,Capital Call,-2000,-10291002,21815764,11524762
49304,2021-08-15,9110,Distribution,497180,-10291002,22312944,12021942
49304,2021-09-30,9110,Value,9346280,-10291002,22312944,12021942
49305,2020-02-15,9110,Capital Call,-5000,-12308002,13614500,1306498
49305,2020-02-15,9110,Distribution,89643,-12308002,13704143,1396141
49305,2020-03-31,9110,Value,3872880,-12308002,13704143,1396141
49305,2020-05-16,9110,Capital Call,-11000,-12319002,13704143,1385141
49305,2020-05-16,9110,Distribution,539085,-12319002,14243228,1924226
49305,2020-06-30,9110,Value,3403730,-12319002,14243228,1924226
49305,2020-08-15,9110,Capital Call,-12000,-12331002,14243228,1912226
49305,2020-08-15,9110,Distribution,246930,-12331002,14490158,2159156
49305,2020-09-30,9110,Value,3358960,-12331002,14490158,2159156
49305,2020-11-15,9110,Capital Call,131,-12330871,14490158,2159287
49305,2020-11-15,9110,Distribution,6,-12330871,14490164,2159293
49305,2020-12-31,9110,Value,3913670,-12330871,14490164,2159293
49305,2021-02-14,9110,Capital Call,-12833,-12343704,14490164,2146460
49305,2021-02-14,9110,Distribution,787365,-12343704,15277529,2933825
49305,2021-03-31,9110,Value,3375790,-12343704,15277529,2933825
49305,2021-05-16,9110,Capital Call,-299,-12344003,15277529,2933526
49305,2021-05-16,9110,Distribution,1046177,-12344003,16323706,3979703
49305,2021-06-30,9110,Value,2505830,-12344003,16323706,3979703
49305,2021-08-15,9110,Capital Call,-27000,-12371003,16323706,3952703
49305,2021-08-15,9110,Distribution,14674,-12371003,16338380,3967377
49305,2021-09-30,9110,Value,2611510,-12371003,16338380,3967377
49306,2020-02-15,9110,Capital Call,-27789,-12569790,11057027,-1512763
49306,2020-02-15,9110,Distribution,910824,-12569790,11967851,-601939
49306,2020-03-31,9110,Value,14074540,-12569790,11967851,-601939
49306,2020-05-16,9110,Distribution,356827,-12569790,12324678,-245112
49306,2020-06-30,9110,Value,15506090,-12569790,12324678,-245112
49306,2020-08-15,9110,Capital Call,-16211,-12586001,12324678,-261323
49306,2020-08-15,9110,Distribution,1229185,-12586001,13553863,967862
49306,2020-09-30,9110,Value,14767150,-12586001,13553863,967862
49306,2020-11-15,9110,Capital Call,250,-12585751,13553863,968112
49306,2020-11-15,9110,Distribution,640974,-12585751,14194837,1609086
49306,2020-12-31,9110,Value,15240970,-12585751,14194837,1609086
49306,2021-02-14,9110,Capital Call,-49352,-12635103,14194837,1559734
49306,2021-02-14,9110,Distribution,1488945,-12635103,15683782,3048679
49306,2021-03-31,9110,Value,25966470,-12635103,15683782,3048679
49306,2021-05-16,9110,Capital Call,102,-12635001,15683782,3048781
49306,2021-05-16,9110,Distribution,43,-12635001,15683825,3048824
49306,2021-06-30,9110,Value,23407600,-12635001,15683825,3048824
49306,2021-08-15,9110,Capital Call,-9000,-12644001,15683825,3039824
49306,2021-08-15,9110,Distribution,863377,-12644001,16547202,3903201
49306,2021-09-30,9110,Value,15725340,-12644001,16547202,3903201
49307,2020-02-15,9110,Capital Call,-451837,-12990838,4708396,-8282442
49307,2020-02-15,9110,Distribution,437933,-12990838,5146329,-7844509
49307,2020-03-31,9110,Value,12146020,-12990838,5146329,-7844509
49307,2020-05-16,9110,Capital Call,-163,-12991001,5146329,-7844672
49307,2020-05-16,9110,Distribution,707,-12991001,5147036,-7843965
49307,2020-06-30,9110,Value,12577880,-12991001,5147036,-7843965
49307,2020-08-15,9110,Capital Call,-12000,-13003001,5147036,-7855965
49307,2020-08-15,9110,Distribution,181595,-13003001,5328631,-7674370
49307,2020-09-30,9110,Value,13434690,-13003001,5328631,-7674370
49307,2020-11-15,9110,Capital Call,-69000,-13072001,5328631,-7743370
49307,2020-11-15,9110,Distribution,553771,-13072001,5882402,-7189599
49307,2020-12-31,9110,Value,13505990,-13072001,5882402,-7189599
49307,2021-02-14,9110,Capital Call,-32000,-13104001,5882402,-7221599
49307,2021-02-14,9110,Distribution,512352,-13104001,6394754,-6709247
49307,2021-03-31,9110,Value,15876800,-13104001,6394754,-6709247
49307,2021-05-16,9110,Capital Call,-10000,-13114001,6394754,-6719247
49307,2021-05-16,9110,Distribution,4880,-13114001,6399634,-6714367
49307,2021-06-30,9110,Value,16741330,-13114001,6399634,-6714367
49307,2021-08-15,9110,Capital Call,10000,-13104001,6399634,-6704367
49307,2021-08-15,9110,Distribution,562523,-13104001,6962157,-6141844
49307,2021-09-30,9110,Value,15618650,-13104001,6962157,-6141844
49451,2020-02-15,8787,Distribution,6300217,-9626000,14064549,4438549
49451,2020-03-31,8787,Value,11445310,-9626000,14064549,4438549
49451,2020-05-16,8787,Capital Call,-16000,-9642000,14064549,4422549
49451,2020-05-16,8787,Distribution,1201,-9642000,14065750,4423750
49451,2020-06-30,8787,Value,11804700,-9642000,14065750,4423750
49451,2020-08-15,8787,Capital Call,-35000,-9677000,14065750,4388750
49451,2020-08-15,8787,Distribution,-1198,-9677000,14064552,4387552
49451,2020-09-30,8787,Value,18329200,-9677000,14064552,4387552
49451,2020-12-31,8787,Value,22215480,-9677000,14064552,4387552
49451,2021-02-14,8787,Capital Call,-17000,-9694000,14064552,4370552
49451,2021-02-14,8787,Distribution,4229965,-9694000,18294517,8600517
49451,2021-03-31,8787,Value,19112690,-9694000,18294517,8600517
49451,2021-05-16,8787,Distribution,1200117,-9694000,19494634,9800634
49451,2021-06-30,8787,Value,22395070,-9694000,19494634,9800634
49451,2021-09-30,8787,Value,29866240,-9694000,19494634,9800634
49597,2020-02-15,6178,Capital Call,-920997,-8816985,0,-8816985
49597,2020-02-15,6178,Distribution,189334,-8816985,189334,-8627651
49597,2020-03-31,6178,Value,10178390,-8816985,189334,-8627651
49597,2020-06-30,6178,Value,10438730,-8816985,189334,-8627651
49597,2020-08-15,6178,Capital Call,-180490,-8997475,189334,-8808141
49597,2020-08-15,6178,Distribution,17870,-8997475,207204,-8790271
49597,2020-09-30,6178,Value,11361790,-8997475,207204,-8790271
49597,2020-11-15,6178,Capital Call,-999389,-9996864,207204,-9789660
49597,2020-12-31,6178,Value,13264870,-9996864,207204,-9789660
49597,2021-02-14,6178,Capital Call,-249717,-10246581,207204,-10039377
49597,2021-02-14,6178,Distribution,531944,-10246581,739148,-9507433
49597,2021-03-31,6178,Value,14588260,-10246581,739148,-9507433
49663,2020-02-15,10770,Capital Call,-390000,-10000000,273529,-9726471
49663,2020-03-31,10770,Value,12735880,-10000000,273529,-9726471
49663,2020-06-30,10770,Value,14831760,-10000000,273529,-9726471
49663,2020-09-30,10770,Value,15087050,-10000000,273529,-9726471
49663,2020-12-31,10770,Value,17313520,-10000000,273529,-9726471
49663,2021-03-31,10770,Value,20337050,-10000000,273529,-9726471
49663,2021-05-16,10770,Distribution,721176,-10000000,994705,-9005295
49663,2021-06-30,10770,Value,20140000,-10000000,994705,-9005295
49769,2020-02-15,106632,Capital Call,-300000,-8300000,0,-8300000
49769,2020-03-31,106632,Value,11669390,-8300000,0,-8300000
49769,2020-05-16,106632,Capital Call,-500000,-8800000,0,-8800000
49769,2020-06-30,106632,Value,12024080,-8800000,0,-8800000
49769,2020-09-30,106632,Capital Call,-300000,-9100000,0,-9100000
49769,2020-12-31,106632,Value,14122760,-9100000,0,-9100000
49769,2021-03-31,106632,Value,15107110,-9100000,0,-9100000
49769,2021-06-30,106632,Value,20849490,-9100000,0,-9100000
49784,2020-01-15,181549,Capital Call,-312444,-9421792,254216,-9167576
49784,2020-01-15,181549,Distribution,0,-9421792,254216,-9167576
49784,2020-02-29,181549,Value,11847510,-9421792,254216,-9167576
49784,2020-04-15,181549,Capital Call,0,-9421792,254216,-9167576
49784,2020-04-15,181549,Distribution,0,-9421792,254216,-9167576
49784,2020-05-31,181549,Value,11123070,-9421792,254216,-9167576
49784,2020-07-16,181549,Capital Call,-93244,-9515036,254216,-9260820
49784,2020-07-16,181549,Distribution,91429,-9515036,345645,-9169391
49784,2020-08-31,181549,Value,13038300,-9515036,345645,-9169391
49784,2020-10-16,181549,Capital Call,-40421,-9555457,345645,-9209812
49784,2020-10-16,181549,Distribution,292857,-9555457,638502,-8916955
49784,2020-11-30,181549,Value,13248160,-9555457,638502,-8916955
49784,2021-01-14,181549,Capital Call,-35034,-9590491,638502,-8951989
49784,2021-01-14,181549,Distribution,431429,-9590491,1069931,-8520560
49784,2021-02-28,181549,Value,13318620,-9590491,1069931,-8520560
49784,2021-04-15,181549,Capital Call,-36658,-9627149,1069931,-8557218
49784,2021-04-15,181549,Distribution,377143,-9627149,1447074,-8180075
49784,2021-05-31,181549,Value,13402300,-9627149,1447074,-8180075
49784,2021-07-16,181549,Capital Call,-38945,-9666094,1447074,-8219020
49784,2021-08-31,181549,Value,13983210,-9666094,1447074,-8219020
49784,2021-10-16,181549,Capital Call,-34523,-9700617,1447074,-8253543
49784,2021-10-16,181549,Distribution,282857,-9700617,1729931,-7970686
49784,2021-11-30,181549,Value,13602670,-9700617,1729931,-7970686
50150,2020-02-15,9048,Capital Call,-190000,-6600000,1566604,-5033396
50150,2020-02-15,9048,Distribution,236,-6600000,1566840,-5033160
50150,2020-03-31,9048,Value,6722100,-6600000,1566840,-5033160
50150,2020-05-16,9048,Capital Call,-160000,-6760000,1566840,-5193160
50150,2020-05-16,9048,Distribution,128,-6760000,1566968,-5193032
50150,2020-06-30,9048,Value,7247390,-6760000,1566968,-5193032
50150,2020-08-15,9048,Capital Call,-360000,-7120000,1566968,-5553032
50150,2020-08-15,9048,Distribution,144,-7120000,1567112,-5552888
50150,2020-09-30,9048,Value,9170560,-7120000,1567112,-5552888
50150,2020-11-15,9048,Capital Call,-610000,-7730000,1567112,-6162888
50150,2020-11-15,9048,Distribution,-241,-7730000,1566871,-6163129
50150,2020-12-31,9048,Value,11235550,-7730000,1566871,-6163129
50150,2021-02-14,9048,Distribution,1258444,-7730000,2825315,-4904685
50150,2021-03-31,9048,Value,13369030,-7730000,2825315,-4904685
50150,2021-05-16,9048,Distribution,1007992,-7730000,3833307,-3896693
50150,2021-06-30,9048,Value,15217270,-7730000,3833307,-3896693
50183,2020-03-31,1973,Capital Call,-334304,-6658001,2011322,-4646679
50183,2020-03-31,1973,Distribution,1127926,-6658001,3139248,-3518753
50183,2020-09-30,1973,Value,3472140,-6658001,3139248,-3518753
50249,2020-03-31,74375,Value,8500000,-8500000,0,-8500000
50257,2020-01-15,151475,Capital Call,-1040064,-8852760,0,-8852760
50257,2020-02-29,151475,Value,10279400,-8852760,0,-8852760
50257,2020-04-15,151475,Capital Call,-59631,-8912391,0,-8912391
50257,2020-05-31,151475,Value,10530850,-8912391,0,-8912391
50257,2020-07-16,151475,Capital Call,-56250,-8968641,0,-8968641
50257,2020-08-31,151475,Value,10528690,-8968641,0,-8968641
50257,2020-10-16,151475,Capital Call,-56250,-9024891,0,-9024891
50257,2020-11-30,151475,Value,11264190,-9024891,0,-9024891
50257,2021-01-14,151475,Capital Call,-87562,-9112453,0,-9112453
50257,2021-02-28,151475,Value,11351750,-9112453,0,-9112453
50257,2021-04-15,151475,Capital Call,-168021,-9280474,0,-9280474
50257,2021-05-31,151475,Value,21483900,-9280474,0,-9280474
50257,2021-07-16,151475,Capital Call,-65308,-9345782,0,-9345782
50257,2021-08-31,151475,Value,21678980,-9345782,0,-9345782
50257,2021-10-16,151475,Capital Call,-50511,-9396293,0,-9396293
50257,2021-11-30,151475,Value,23913450,-9396293,0,-9396293
50271,2020-03-31,2512,Value,6430050,-7489000,4839391,-2649609
50271,2020-05-16,2512,Distribution,862733,-7489000,5702124,-1786876
50271,2020-06-30,2512,Value,5973220,-7489000,5702124,-1786876
50271,2020-09-30,2512,Capital Call,-729000,-8218000,5702124,-2515876
50271,2020-09-30,2512,Distribution,964317,-8218000,6666441,-1551559
50271,2020-12-31,2512,Value,6607270,-8218000,6666441,-1551559
50271,2021-02-14,2512,Capital Call,-250000,-8468000,6666441,-1801559
50271,2021-02-14,2512,Distribution,415,-8468000,6666856,-1801144
50271,2021-03-31,2512,Value,6618580,-8468000,6666856,-1801144
50271,2021-05-16,2512,Capital Call,-333,-8468333,6666856,-1801477
50271,2021-05-16,2512,Distribution,214,-8468333,6667070,-1801263
50271,2021-06-30,2512,Value,6452960,-8468333,6667070,-1801263
50271,2021-08-15,2512,Capital Call,-500000,-8968333,6667070,-2301263
50271,2021-09-30,2512,Value,8974220,-8968333,6667070,-2301263
50323,2020-02-15,376,Capital Call,-713232,-8615449,2031388,-6584061
50323,2020-03-31,376,Value,7430540,-8615449,2031388,-6584061
50323,2020-05-16,376,Capital Call,-62534,-8677983,2031388,-6646595
50323,2020-05-16,376,Distribution,1364288,-8677983,3395676,-5282307
50323,2020-06-30,376,Value,7002300,-8677983,3395676,-5282307
50323,2020-08-15,376,Capital Call,-348466,-9026449,3395676,-5630773
50323,2020-08-15,376,Distribution,951140,-9026449,4346816,-4679633
50323,2020-09-30,376,Value,7958320,-9026449,4346816,-4679633
50323,2020-11-15,376,Capital Call,-667816,-9694265,4346816,-5347449
50323,2020-11-15,376,Distribution,0,-9694265,4346816,-5347449
50323,2020-12-31,376,Value,9833380,-9694265,4346816,-5347449
50323,2021-02-14,376,Capital Call,-30229,-9724494,4346816,-5377678
50323,2021-03-31,376,Value,10780170,-9724494,4346816,-5377678
50434,2020-02-15,1314,Capital Call,-60782,-8409999,872346,-7537653
50434,2020-02-15,1314,Distribution,275619,-8409999,1147965,-7262034
50434,2020-03-31,1314,Value,12832810,-8409999,1147965,-7262034
50434,2020-05-16,1314,Capital Call,-210000,-8619999,1147965,-7472034
50434,2020-05-16,1314,Distribution,209685,-8619999,1357650,-7262349
50434,2020-06-30,1314,Value,14625550,-8619999,1357650,-7262349
50434,2020-09-30,1314,Value,15883210,-8619999,1357650,-7262349
50434,2020-11-15,1314,Capital Call,-200000,-8819999,1357650,-7462349
50434,2020-11-15,1314,Distribution,630,-8819999,1358280,-7461719
50434,2020-12-31,1314,Value,21814500,-8819999,1358280,-7461719
50434,2021-02-14,1314,Capital Call,-198000,-9017999,1358280,-7659719
50434,2021-02-14,1314,Distribution,522875,-9017999,1881155,-7136844
50434,2021-03-31,1314,Value,23971640,-9017999,1881155,-7136844
50434,2021-05-16,1314,Capital Call,-227000,-9244999,1881155,-7363844
50434,2021-05-16,1314,Distribution,716690,-9244999,2597845,-6647154
50434,2021-06-30,1314,Value,26156870,-9244999,2597845,-6647154
50434,2021-08-15,1314,Capital Call,-125000,-9369999,2597845,-6772154
50434,2021-08-15,1314,Distribution,956196,-9369999,3554041,-5815958
50434,2021-09-30,1314,Value,28528830,-9369999,3554041,-5815958
50494,2020-03-31,61398,Capital Call,-1000000,-9300000,1234210,-8065790
50494,2020-03-31,61398,Distribution,830,-9300000,1235040,-8064960
50494,2020-06-30,61398,Value,8144940,-9300000,1235040,-8064960
50494,2020-09-30,61398,Value,10947030,-9300000,1235040,-8064960
50494,2020-12-31,61398,Value,11597100,-9300000,1235040,-8064960
50494,2021-02-14,61398,Capital Call,-400000,-9700000,1235040,-8464960
50494,2021-02-14,61398,Distribution,-230,-9700000,1234810,-8465190
50494,2021-03-31,61398,Value,10931900,-9700000,1234810,-8465190
50494,2021-07-01,61398,Capital Call,-300000,-10000000,1234810,-8765190
50494,2021-07-01,61398,Distribution,190,-10000000,1235000,-8765000
50494,2021-09-30,61398,Value,14018000,-10000000,1235000,-8765000
50594,2020-02-15,643,Capital Call,-109000,-10199000,1395446,-8803554
50594,2020-02-15,643,Distribution,-224,-10199000,1395222,-8803778
50594,2020-03-31,643,Value,10768100,-10199000,1395222,-8803778
50594,2020-05-16,643,Capital Call,-22000,-10221000,1395222,-8825778
50594,2020-05-16,643,Distribution,826822,-10221000,2222044,-7998956
50594,2020-06-30,643,Value,9566850,-10221000,2222044,-7998956
50594,2020-09-30,643,Value,12555470,-10221000,2222044,-7998956
50594,2020-12-31,643,Value,13320000,-10221000,2222044,-7998956
50594,2021-02-14,643,Distribution,895360,-10221000,3117404,-7103596
50594,2021-03-31,643,Value,21071610,-10221000,3117404,-7103596
50594,2021-06-30,643,Value,19727550,-10221000,3117404,-7103596
50594,2021-09-30,643,Value,19727550,-10221000,3117404,-7103596
50594,2021-11-15,643,Distribution,772708,-10221000,3890112,-6330888
50594,2021-12-31,643,Value,11752100,-10221000,3890112,-6330888
50598,2020-02-15,18,Capital Call,323,-6534863,1303114,-5231749
50598,2020-02-15,18,Distribution,-64,-6534863,1303050,-5231813
50598,2020-03-31,18,Value,7928280,-6534863,1303050,-5231813
50598,2020-05-16,18,Capital Call,-750000,-7284863,1303050,-5981813
50598,2020-06-30,18,Value,9511980,-7284863,1303050,-5981813
50598,2020-08-15,18,Distribution,384317,-7284863,1687367,-5597496
50598,2020-09-30,18,Value,10015120,-7284863,1687367,-5597496
50598,2020-11-15,18,Capital Call,-225000,-7509863,1687367,-5822496
50598,2020-12-31,18,Value,12819180,-7509863,1687367,-5822496
50598,2021-03-31,18,Value,14504280,-7509863,1687367,-5822496
50598,2021-05-16,18,Capital Call,-517725,-8027588,1687367,-6340221
50598,2021-05-16,18,Distribution,1066522,-8027588,2753889,-5273699
50598,2021-06-30,18,Value,16113950,-8027588,2753889,-5273699
50598,2021-09-30,18,Value,17529420,-8027588,2753889,-5273699
50610,2020-02-15,11819,Capital Call,-265000,-7461000,230992,-7230008
50610,2020-02-15,11819,Distribution,5522,-7461000,236514,-7224486
50610,2020-03-31,11819,Value,7642300,-7461000,236514,-7224486
50610,2020-06-30,11819,Value,8917380,-7461000,236514,-7224486
50610,2020-08-15,11819,Capital Call,-480000,-7941000,236514,-7704486
50610,2020-08-15,11819,Distribution,128,-7941000,236642,-7704358
50610,2020-09-30,11819,Value,10406680,-7941000,236642,-7704358
50610,2020-12-31,11819,Value,11837640,-7941000,236642,-7704358
50610,2021-02-14,11819,Capital Call,-48000,-7989000,236642,-7752358
50610,2021-02-14,11819,Distribution,2365376,-7989000,2602018,-5386982
50610,2021-03-31,11819,Value,10179580,-7989000,2602018,-5386982
50610,2021-05-16,11819,Capital Call,-582000,-8571000,2602018,-5968982
50610,2021-05-16,11819,Distribution,383262,-8571000,2985280,-5585720
50610,2021-06-30,11819,Value,10318620,-8571000,2985280,-5585720
50610,2021-09-30,11819,Value,10007490,-8571000,2985280,-5585720
50610,2021-11-15,11819,Capital Call,-1051000,-9622000,2985280,-6636720
50610,2021-11-15,11819,Distribution,3047715,-9622000,6032995,-3589005
50610,2021-12-31,11819,Value,8190240,-9622000,6032995,-3589005
50632,2020-02-15,59150,Capital Call,-1300253,-11084040,5499312,-5584728
50632,2020-02-15,59150,Distribution,49296,-11084040,5548608,-5535432
50632,2020-03-31,59150,Value,8239450,-11084040,5548608,-5535432
50632,2020-06-30,59150,Value,8673940,-11084040,5548608,-5535432
50632,2020-08-15,59150,Capital Call,-68102,-11152142,5548608,-5603534
50632,2020-08-15,59150,Distribution,151005,-11152142,5699613,-5452529
50632,2020-09-30,59150,Value,9469410,-11152142,5699613,-5452529
50632,2020-11-15,59150,Capital Call,-30101,-11182243,5699613,-5482630
50632,2020-11-15,59150,Distribution,184401,-11182243,5884014,-5298229
50632,2020-12-31,59150,Value,10156620,-11182243,5884014,-5298229
50632,2021-02-14,59150,Capital Call,-28487,-11210730,5884014,-5326716
50632,2021-02-14,59150,Distribution,459438,-11210730,6343452,-4867278
50632,2021-03-31,59150,Value,9527250,-11210730,6343452,-4867278
50632,2021-05-16,59150,Capital Call,-31292,-11242022,6343452,-4898570
50632,2021-05-16,59150,Distribution,2313670,-11242022,8657122,-2584900
50632,2021-06-30,59150,Value,7654710,-11242022,8657122,-2584900
50661,2020-02-15,23596,Capital Call,-82000,-4727000,0,-4727000
50661,2020-03-31,23596,Value,3824140,-4727000,0,-4727000
50661,2020-06-30,23596,Value,4181970,-4727000,0,-4727000
50661,2020-08-15,23596,Capital Call,-440000,-5167000,0,-5167000
50661,2020-09-30,23596,Value,4722630,-5167000,0,-5167000
50661,2021-04-01,23596,Capital Call,-1939000,-7106000,0,-7106000
50661,2021-09-30,23596,Value,8203870,-7106000,0,-7106000
50680,2020-02-15,77,Distribution,579420,-8025327,7932132,-93195
50680,2020-03-31,77,Value,3302250,-8025327,7932132,-93195
50680,2020-06-30,77,Value,3378890,-8025327,7932132,-93195
50680,2020-08-15,77,Capital Call,-249750,-8275077,7932132,-342945
50680,2020-08-15,77,Distribution,1298701,-8275077,9230833,955756
50680,2020-09-30,77,Value,2560770,-8275077,9230833,955756
50680,2020-12-31,77,Value,3653300,-8275077,9230833,955756
50680,2021-02-14,77,Capital Call,-102398,-8377475,9230833,853358
50680,2021-02-14,77,Distribution,378241,-8377475,9609074,1231599
50680,2021-03-31,77,Value,3402440,-8377475,9609074,1231599
50680,2021-06-30,77,Value,3746480,-8377475,9609074,1231599
50693,2020-02-15,39494,Capital Call,-340021,-9644312,12122619,2478307
50693,2020-02-15,39494,Distribution,341955,-9644312,12464574,2820262
50693,2020-03-31,39494,Value,8982180,-9644312,12464574,2820262
50693,2020-06-30,39494,Value,8160290,-9644312,12464574,2820262
50693,2020-08-15,39494,Capital Call,-101181,-9745493,12464574,2719081
50693,2020-08-15,39494,Distribution,639446,-9745493,13104020,3358527
50693,2020-09-30,39494,Value,7698450,-9745493,13104020,3358527
50693,2020-11-15,39494,Capital Call,-151314,-9896807,13104020,3207213
50693,2020-11-15,39494,Distribution,277760,-9896807,13381780,3484973
50693,2020-12-31,39494,Value,10246800,-9896807,13381780,3484973
50693,2021-02-14,39494,Capital Call,-31469,-9928276,13381780,3453504
50693,2021-02-14,39494,Distribution,1113733,-9928276,14495513,4567237
50693,2021-03-31,39494,Value,9505030,-9928276,14495513,4567237
50693,2021-05-16,39494,Capital Call,-66232,-9994508,14495513,4501005
50693,2021-05-16,39494,Distribution,739258,-9994508,15234771,5240263
50693,2021-06-30,39494,Value,10004760,-9994508,15234771,5240263
50693,2021-09-30,39494,Value,10004760,-9994508,15234771,5240263
50761,2020-03-31,673,Value,15313370,-8882000,0,-8882000
50761,2020-05-16,673,Distribution,777000,-8882000,777000,-8105000
50761,2020-06-30,673,Value,16553850,-8882000,777000,-8105000
50761,2020-08-15,673,Distribution,263625,-8882000,1040625,-7841375
50761,2020-09-30,673,Value,18457430,-8882000,1040625,-7841375
50761,2020-11-15,673,Distribution,166500,-8882000,1207125,-7674875
50761,2020-12-31,673,Value,24941970,-8882000,1207125,-7674875
50761,2021-02-14,673,Distribution,587375,-8882000,1794500,-7087500
50761,2021-03-31,673,Value,26979510,-8882000,1794500,-7087500
50790,2020-02-15,11822,Capital Call,-217000,-8356000,323933,-8032067
50790,2020-02-15,11822,Distribution,179935,-8356000,503868,-7852132
50790,2020-03-31,11822,Value,7882210,-8356000,503868,-7852132
50790,2020-06-30,11822,Value,8112840,-8356000,503868,-7852132
50790,2020-08-15,11822,Capital Call,-407000,-8763000,503868,-8259132
50790,2020-08-15,11822,Distribution,259391,-8763000,763259,-7999741
50790,2020-09-30,11822,Value,8600000,-8763000,763259,-7999741
50790,2020-11-15,11822,Capital Call,-28000,-8791000,763259,-8027741
50790,2020-11-15,11822,Distribution,78920,-8791000,842179,-7948821
50790,2020-12-31,11822,Value,9367680,-8791000,842179,-7948821
50925,2020-01-15,148677,Capital Call,0,-9140720,0,-9140720
50925,2020-01-15,148677,Distribution,2350814,-9140720,2350814,-6789906
50925,2020-02-29,148677,Value,10232340,-9140720,2350814,-6789906
50925,2020-04-15,148677,Capital Call,-2107145,-11247865,2350814,-8897051
50925,2020-04-15,148677,Distribution,0,-11247865,2350814,-8897051
50925,2020-05-31,148677,Value,11908210,-11247865,2350814,-8897051
50925,2020-11-30,148677,Capital Call,1247864,-10000001,2350814,-7649187
50925,2020-11-30,148677,Distribution,1584750,-10000001,3935564,-6064437
50925,2021-05-31,148677,Value,13098200,-10000001,3935564,-6064437
50925,2021-08-31,148677,Value,22275390,-10000001,3935564,-6064437
50925,2021-10-16,148677,Distribution,0,-10000001,3935564,-6064437
50925,2021-11-30,148677,Value,22273420,-10000001,3935564,-6064437
50940,2020-02-15,8787,Capital Call,-621000,-10398000,3676151,-6721849
50940,2020-02-15,8787,Distribution,-459,-10398000,3675692,-6722308
50940,2020-03-31,8787,Value,9824030,-10398000,3675692,-6722308
50940,2020-06-30,8787,Value,11116500,-10398000,3675692,-6722308
50940,2020-08-15,8787,Capital Call,-133000,-10531000,3675692,-6855308
50940,2020-08-15,8787,Distribution,679,-10531000,3676371,-6854629
50940,2020-09-30,8787,Value,12443420,-10531000,3676371,-6854629
50940,2020-11-15,8787,Capital Call,-27000,-10558000,3676371,-6881629
50940,2020-11-15,8787,Distribution,333556,-10558000,4009927,-6548073
50940,2020-12-31,8787,Value,13006400,-10558000,4009927,-6548073
50940,2021-02-14,8787,Capital Call,-29000,-10587000,4009927,-6577073
50940,2021-02-14,8787,Distribution,427,-10587000,4010354,-6576646
50940,2021-03-31,8787,Value,15145760,-10587000,4010354,-6576646
50940,2021-06-30,8787,Value,14701100,-10587000,4010354,-6576646
50940,2021-09-30,8787,Value,15511010,-10587000,4010354,-6576646
50954,2020-02-15,22487,Capital Call,-1210000,-8500000,255150,-8244850
50954,2020-02-15,22487,Distribution,1491600,-8500000,1746750,-6753250
50954,2020-12-31,22487,Value,12750000,-8500000,1746750,-6753250
51010,2020-06-30,1517,Value,11319220,-8000000,350000,-7650000
51020,2020-03-31,302,Value,13043970,-9745000,8007965,-1737035
51020,2020-05-16,302,Distribution,437165,-9745000,8445130,-1299870
51020,2020-06-30,302,Value,12123310,-9745000,8445130,-1299870
51020,2020-09-30,302,Value,14088470,-9745000,8445130,-1299870
51020,2020-11-15,302,Distribution,1265154,-9745000,9710284,-34716
51020,2020-12-31,302,Value,21724760,-9745000,9710284,-34716
51020,2021-04-01,302,Distribution,2611334,-9745000,12321618,2576618
51020,2021-06-30,302,Value,20880440,-9745000,12321618,2576618
51020,2021-08-15,302,Distribution,1155232,-9745000,13476850,3731850
51020,2021-09-30,302,Value,20359050,-9745000,13476850,3731850
51039,2020-02-15,795,Capital Call,-200000,-9605000,943230,-8661770
51039,2020-03-31,795,Value,11182940,-9605000,943230,-8661770
51039,2020-05-16,795,Distribution,227000,-9605000,1170230,-8434770
51039,2020-06-30,795,Value,10473490,-9605000,1170230,-8434770
51039,2020-08-15,795,Capital Call,-100000,-9705000,1170230,-8534770
51039,2020-09-30,795,Value,10876480,-9705000,1170230,-8534770
51076,2020-03-31,1480,Value,19374300,-9900000,1722600,-8177400
51076,2020-05-16,1480,Capital Call,-300000,-10200000,1722600,-8477400
51076,2020-05-16,1480,Distribution,756000,-10200000,2478600,-7721400
51076,2020-06-30,1480,Value,21369000,-10200000,2478600,-7721400
51076,2020-09-30,1480,Distribution,1887000,-10200000,4365600,-5834400
51076,2020-12-31,1480,Value,27703200,-10200000,4365600,-5834400
51076,2021-02-14,1480,Distribution,1142400,-10200000,5508000,-4692000
51076,2021-03-31,1480,Value,29671800,-10200000,5508000,-4692000
51076,2021-07-01,1480,Distribution,1562640,-10200000,7070640,-3129360
51076,2021-09-30,1480,Value,34787100,-10200000,7070640,-3129360
51076,2021-11-15,1480,Capital Call,-400000,-10600000,7070640,-3529360
51076,2021-11-15,1480,Distribution,2760860,-10600000,9831500,-768500
51076,2021-12-31,1480,Value,37177380,-10600000,9831500,-768500
51085,2020-03-31,11324,Value,14899710,-9999807,0,-9999807
51085,2020-09-30,11324,Value,16199680,-9999807,0,-9999807
51085,2020-12-31,11324,Value,16599670,-9999807,0,-9999807
51085,2021-03-31,11324,Value,17199660,-9999807,0,-9999807
51085,2021-06-30,11324,Value,17399660,-9999807,0,-9999807
51127,2020-03-31,140,Value,6402510,-7764387,722782,-7041605
51127,2020-07-01,140,Capital Call,-1764108,-9528495,722782,-8805713
51127,2020-07-01,140,Distribution,61901,-9528495,784683,-8743812
51127,2020-09-30,140,Value,8565400,-9528495,784683,-8743812
51127,2020-11-15,140,Distribution,754181,-9528495,1538864,-7989631
51127,2020-12-31,140,Value,8809820,-9528495,1538864,-7989631
51127,2021-02-14,140,Capital Call,-273044,-9801539,1538864,-8262675
51127,2021-02-14,140,Distribution,176457,-9801539,1715321,-8086218
51127,2021-03-31,140,Value,9820270,-9801539,1715321,-8086218
51127,2021-05-16,140,Capital Call,23891,-9777648,1715321,-8062327
51127,2021-05-16,140,Distribution,405012,-9777648,2120333,-7657315
51127,2021-06-30,140,Value,11440330,-9777648,2120333,-7657315
51146,2020-02-06,81754,Capital Call,-998,-10008,154,-9854
51146,2020-12-31,81754,Value,16260,-10008,154,-9854
51152,2020-02-15,53913,Capital Call,640313,-8270668,0,-8270668
51152,2020-02-15,53913,Distribution,155168,-8270668,155168,-8115500
51152,2020-03-31,53913,Value,3705380,-8270668,155168,-8115500
51152,2020-07-01,53913,Capital Call,-134420,-8405088,155168,-8249920
51152,2020-07-01,53913,Distribution,3427,-8405088,158595,-8246493
51152,2020-09-30,53913,Value,4081510,-8405088,158595,-8246493
51152,2020-11-15,53913,Capital Call,22901,-8382187,158595,-8223592
51152,2020-11-15,53913,Distribution,68071,-8382187,226666,-8155521
51152,2020-12-31,53913,Value,5056360,-8382187,226666,-8155521
51152,2021-02-14,53913,Capital Call,-86420,-8468607,226666,-8241941
51152,2021-02-14,53913,Distribution,26604,-8468607,253270,-8215337
51152,2021-03-31,53913,Value,5015530,-8468607,253270,-8215337
51152,2021-05-16,53913,Capital Call,-140553,-8609160,253270,-8355890
51152,2021-05-16,53913,Distribution,36826,-8609160,290096,-8319064
51152,2021-06-30,53913,Value,5327880,-8609160,290096,-8319064
51173,2020-03-31,58200,Value,12984540,-8725000,0,-8725000
51173,2020-05-16,58200,Capital Call,-400000,-9125000,0,-9125000
51173,2020-06-30,58200,Value,13341660,-9125000,0,-9125000
51173,2020-09-30,58200,Value,10982850,-9125000,0,-9125000
51173,2020-11-15,58200,Capital Call,-275000,-9400000,0,-9400000
51173,2020-12-31,58200,Value,11451080,-9400000,0,-9400000
51173,2021-03-31,58200,Value,11548840,-9400000,0,-9400000
51173,2021-06-30,58200,Value,11442620,-9400000,0,-9400000
51173,2021-09-30,58200,Value,19124300,-9400000,0,-9400000
51188,2020-03-31,588,Value,4967960,-8039448,5475515,-2563933
51188,2020-05-16,588,Capital Call,-301,-8039749,5475515,-2564234
51188,2020-05-16,588,Distribution,200000,-8039749,5675515,-2364234
51188,2020-06-30,588,Value,4277370,-8039749,5675515,-2364234
51188,2020-08-15,588,Capital Call,-5,-8039754,5675515,-2364239
51188,2020-08-15,588,Distribution,520000,-8039754,6195515,-1844239
51188,2020-09-30,588,Value,4205180,-8039754,6195515,-1844239
51188,2020-11-15,588,Capital Call,-15225,-8054979,6195515,-1859464
51188,2020-11-15,588,Distribution,400000,-8054979,6595515,-1459464
51188,2020-12-31,588,Value,4416870,-8054979,6595515,-1459464
51188,2021-02-14,588,Capital Call,-1599,-8056578,6595515,-1461063
51188,2021-02-14,588,Distribution,300000,-8056578,6895515,-1161063
51188,2021-03-31,588,Value,4116870,-8056578,6895515,-1161063
51188,2021-05-16,588,Capital Call,-16931,-8073509,6895515,-1177994
51188,2021-05-16,588,Distribution,300000,-8073509,7195515,-877994
51188,2021-06-30,588,Value,5193890,-8073509,7195515,-877994
51243,2020-02-15,428403,Distribution,271318,-10059238,3759110,-6300128
51243,2020-03-31,428403,Value,10033210,-10059238,3759110,-6300128
51243,2020-07-01,428403,Capital Call,-6839,-10066077,3759110,-6306967
51243,2020-07-01,428403,Distribution,234541,-10066077,3993651,-6072426
51243,2020-09-30,428403,Value,10396490,-10066077,3993651,-6072426
51243,2020-11-15,428403,Capital Call,-3702,-10069779,3993651,-6076128
51243,2020-11-15,428403,Distribution,513834,-10069779,4507485,-5562294
51243,2020-12-31,428403,Value,11835040,-10069779,4507485,-5562294
51243,2021-03-31,428403,Value,12051470,-10069779,4507485,-5562294
51252,2020-02-15,150549,Capital Call,-285715,-8573900,2776620,-5797280
51252,2020-03-31,150549,Value,8850400,-8573900,2776620,-5797280
51252,2020-06-30,150549,Value,8776390,-8573900,2776620,-5797280
51252,2020-08-15,150549,Capital Call,-1243621,-9817521,2776620,-7040901
51252,2020-08-15,150549,Distribution,6929,-9817521,2783549,-7033972
51252,2020-09-30,150549,Value,10250930,-9817521,2783549,-7033972
51252,2020-11-15,150549,Distribution,7779785,-9817521,10563334,745813
51252,2020-12-31,150549,Value,4463330,-9817521,10563334,745813
51252,2021-02-14,150549,Distribution,150571,-9817521,10713905,896384
51252,2021-03-31,150549,Value,6695770,-9817521,10713905,896384
51252,2021-05-16,150549,Distribution,121056,-9817521,10834961,1017440
51252,2021-06-30,150549,Value,6955910,-9817521,10834961,1017440
51252,2021-08-15,150549,Distribution,1587013,-9817521,12421974,2604453
51252,2021-09-30,150549,Value,5925870,-9817521,12421974,2604453
51294,2020-02-15,579,Capital Call,-21000,-9741999,9809461,67462
51294,2020-02-15,579,Distribution,189728,-9741999,9999189,257190
51294,2020-03-31,579,Value,5652300,-9741999,9999189,257190
51294,2020-05-16,579,Capital Call,-18000,-9759999,9999189,239190
51294,2020-05-16,579,Distribution,346411,-9759999,10345600,585601
51294,2020-06-30,579,Value,6334240,-9759999,10345600,585601
51393,2020-02-15,29836,Capital Call,-4963,-9087077,0,-9087077
51393,2020-02-15,29836,Distribution,1177096,-9087077,1177096,-7909981
51393,2020-03-31,29836,Value,9878080,-9087077,1177096,-7909981
51454,2020-01-15,2017,Capital Call,-280038,-9843312,739347,-9103965
51454,2020-02-29,2017,Value,10770010,-9843312,739347,-9103965
51454,2020-04-15,2017,Capital Call,-284163,-10127475,739347,-9388128
51454,2020-05-31,2017,Value,11355940,-10127475,739347,-9388128
51454,2020-07-16,2017,Capital Call,-166164,-10293639,739347,-9554292
51454,2020-07-16,2017,Distribution,1274847,-10293639,2014194,-8279445
51454,2020-08-31,2017,Value,10634240,-10293639,2014194,-8279445
51454,2020-10-16,2017,Capital Call,-363187,-10656826,2014194,-8642632
51454,2020-10-16,2017,Distribution,72965,-10656826,2087159,-8569667
51454,2020-11-30,2017,Value,12328160,-10656826,2087159,-8569667
51454,2021-01-14,2017,Capital Call,-99031,-10755857,2087159,-8668698
51454,2021-01-14,2017,Distribution,159726,-10755857,2246885,-8508972
51454,2021-02-28,2017,Value,12302360,-10755857,2246885,-8508972
51454,2021-04-15,2017,Capital Call,-83421,-10839278,2246885,-8592393
51454,2021-04-15,2017,Distribution,123314,-10839278,2370199,-8469079
51454,2021-05-31,2017,Value,13564660,-10839278,2370199,-8469079
51454,2021-07-16,2017,Capital Call,-161424,-11000702,2370199,-8630503
51454,2021-07-16,2017,Distribution,2405609,-11000702,4775808,-6224894
51454,2021-08-31,2017,Value,14826120,-11000702,4775808,-6224894
51454,2021-10-16,2017,Capital Call,-79066,-11079768,4775808,-6303960
51454,2021-11-30,2017,Value,16853100,-11079768,4775808,-6303960
51466,2020-02-14,9522,Capital Call,-354000,-10354001,4600000,-5754001
51466,2020-02-14,9522,Distribution,59300,-10354001,4659300,-5694701
51466,2020-09-30,9522,Value,10602490,-10354001,4659300,-5694701
51466,2020-12-31,9522,Value,10435790,-10354001,4659300,-5694701
51466,2021-03-31,9522,Value,10867550,-10354001,4659300,-5694701
51466,2021-06-30,9522,Value,12479670,-10354001,4659300,-5694701
51466,2021-09-30,9522,Value,13298670,-10354001,4659300,-5694701
51547,2020-02-15,718,Capital Call,0,-9691515,4116073,-5575442
51547,2020-02-15,718,Distribution,797786,-9691515,4913859,-4777656
51547,2020-03-31,718,Value,11790410,-9691515,4913859,-4777656
51547,2020-05-16,718,Distribution,1258068,-9691515,6171927,-3519588
51547,2020-06-30,718,Value,11963620,-9691515,6171927,-3519588
51547,2020-08-15,718,Distribution,103574,-9691515,6275501,-3416014
51547,2020-09-30,718,Value,13634850,-9691515,6275501,-3416014
51547,2020-11-15,718,Capital Call,-300000,-9991515,6275501,-3716014
51547,2020-11-15,718,Distribution,1494146,-9991515,7769647,-2221868
51547,2020-12-31,718,Value,14372010,-9991515,7769647,-2221868
51582,2021-12-31,554,Value,0,-9400000,1012659,-8387341
51701,2020-02-15,1886,Capital Call,6784,-7922723,1203294,-6719429
51701,2020-02-15,1886,Distribution,31068,-7922723,1234362,-6688361
51701,2020-03-31,1886,Value,8696410,-7922723,1234362,-6688361
51701,2020-05-16,1886,Capital Call,-440277,-8363000,1234362,-7128638
51701,2020-05-16,1886,Distribution,-63541,-8363000,1170821,-7192179
51701,2020-06-30,1886,Value,9581480,-8363000,1170821,-7192179
51701,2020-08-15,1886,Capital Call,-17000,-8380000,1170821,-7209179
51701,2020-08-15,1886,Distribution,52660,-8380000,1223481,-7156519
51701,2020-09-30,1886,Value,10038400,-8380000,1223481,-7156519
51701,2020-11-15,1886,Capital Call,-921000,-9301000,1223481,-8077519
51701,2020-11-15,1886,Distribution,268400,-9301000,1491881,-7809119
51701,2020-12-31,1886,Value,11223510,-9301000,1491881,-7809119
51701,2021-02-14,1886,Capital Call,-548000,-9849000,1491881,-8357119
51701,2021-02-14,1886,Distribution,561636,-9849000,2053517,-7795483
51701,2021-03-31,1886,Value,13112950,-9849000,2053517,-7795483
51701,2021-05-16,1886,Capital Call,-84000,-9933000,2053517,-7879483
51701,2021-05-16,1886,Distribution,-373846,-9933000,1679671,-8253329
51701,2021-06-30,1886,Value,14842880,-9933000,1679671,-8253329
51701,2021-08-15,1886,Capital Call,1000,-9932000,1679671,-8252329
51701,2021-08-15,1886,Distribution,107096,-9932000,1786767,-8145233
51701,2021-09-30,1886,Value,15771020,-9932000,1786767,-8145233
51727,2020-03-31,1480,Value,19381120,-9599368,2803015,-6796353
51727,2020-05-16,1480,Distribution,1612985,-9599368,4416000,-5183368
51727,2020-06-30,1480,Value,19966680,-9599368,4416000,-5183368
51727,2020-09-30,1480,Capital Call,-632,-9600000,4416000,-5184000
51727,2020-09-30,1480,Distribution,2995200,-9600000,7411200,-2188800
51727,2020-12-31,1480,Value,26947200,-9600000,7411200,-2188800
51727,2021-02-14,1480,Distribution,2476800,-9600000,9888000,288000
51727,2021-03-31,1480,Value,26841600,-9600000,9888000,288000
51727,2021-07-01,1480,Distribution,2617920,-9600000,12505920,2905920
51727,2021-09-30,1480,Value,26285760,-9600000,12505920,2905920
51727,2021-11-15,1480,Capital Call,-700000,-10300000,12505920,2205920
51727,2021-11-15,1480,Distribution,3059440,-10300000,15565360,5265360
51727,2021-12-31,1480,Value,29056300,-10300000,15565360,5265360
51745,2020-02-15,733,Capital Call,-465000,-10280000,5395000,-4885000
51745,2020-02-15,733,Distribution,75000,-10280000,5470000,-4810000
51745,2020-03-31,733,Value,7944990,-10280000,5470000,-4810000
51745,2020-05-16,733,Capital Call,-60000,-10340000,5470000,-4870000
51745,2020-05-16,733,Distribution,225000,-10340000,5695000,-4645000
51745,2020-06-30,733,Value,8105000,-10340000,5695000,-4645000
51745,2020-08-15,733,Capital Call,-55000,-10395000,5695000,-4700000
51745,2020-09-30,733,Value,8584990,-10395000,5695000,-4700000
51745,2020-11-15,733,Capital Call,-125000,-10520000,5695000,-4825000
51745,2020-11-15,733,Distribution,1450000,-10520000,7145000,-3375000
51745,2020-12-31,733,Value,11144990,-10520000,7145000,-3375000
51745,2021-02-14,733,Capital Call,-80000,-10600000,7145000,-3455000
51745,2021-02-14,733,Distribution,455000,-10600000,7600000,-3000000
51745,2021-03-31,733,Value,10314990,-10600000,7600000,-3000000
51745,2021-05-16,733,Capital Call,-60000,-10660000,7600000,-3060000
51745,2021-05-16,733,Distribution,985000,-10660000,8585000,-2075000
51745,2021-06-30,733,Value,10794990,-10660000,8585000,-2075000
51745,2021-08-15,733,Capital Call,-245000,-10905000,8585000,-2320000
51745,2021-08-15,733,Distribution,230000,-10905000,8815000,-2090000
51745,2021-09-30,733,Value,10949990,-10905000,8815000,-2090000
51782,2020-02-15,634,Distribution,-5150,-5149999,1241150,-3908849
51782,2020-03-31,634,Value,4686500,-5149999,1241150,-3908849
51782,2020-05-16,634,Capital Call,-3590000,-8739999,1241150,-7498849
51782,2020-05-16,634,Distribution,561912,-8739999,1803062,-6936937
51782,2020-06-30,634,Value,9350050,-8739999,1803062,-6936937
51782,2020-09-30,634,Capital Call,-197000,-8936999,1803062,-7133937
51782,2020-09-30,634,Distribution,1216750,-8936999,3019812,-5917187
51782,2020-12-31,634,Value,8758260,-8936999,3019812,-5917187
51782,2021-02-14,634,Capital Call,-1813000,-10749999,3019812,-7730187
51782,2021-02-14,634,Distribution,280438,-10749999,3300250,-7449749
51782,2021-03-31,634,Value,12792500,-10749999,3300250,-7449749
51782,2021-05-16,634,Capital Call,436000,-10313999,3300250,-7013749
51782,2021-05-16,634,Distribution,488082,-10313999,3788332,-6525667
51782,2021-06-30,634,Value,12995640,-10313999,3788332,-6525667
51782,2021-08-15,634,Capital Call,-681000,-10994999,3788332,-7206667
51782,2021-08-15,634,Distribution,572285,-10994999,4360617,-6634382
51782,2021-09-30,634,Value,14073600,-10994999,4360617,-6634382
51798,2020-03-31,51673,Capital Call,-2000000,-9000000,140000,-8860000
51798,2020-03-31,51673,Distribution,40000,-9000000,180000,-8820000
51798,2020-06-30,51673,Value,13500000,-9000000,180000,-8820000
51798,2020-12-31,51673,Value,13230000,-9000000,180000,-8820000
51798,2021-03-31,51673,Value,13230000,-9000000,180000,-8820000
51800,2020-02-15,12267,Capital Call,-290450,-8563921,2995913,-5568008
51800,2020-02-15,12267,Distribution,1434940,-8563921,4430853,-4133068
51800,2020-03-31,12267,Value,5514030,-8563921,4430853,-4133068
51800,2020-05-16,12267,Capital Call,-22789,-8586710,4430853,-4155857
51800,2020-05-16,12267,Distribution,0,-8586710,4430853,-4155857
51800,2020-06-30,12267,Value,5743500,-8586710,4430853,-4155857
51800,2020-08-15,12267,Capital Call,-420236,-9006946,4430853,-4576093
51800,2020-09-30,12267,Value,5734580,-9006946,4430853,-4576093
51800,2020-11-15,12267,Capital Call,-26655,-9033601,4430853,-4602748
51800,2020-11-15,12267,Distribution,144871,-9033601,4575724,-4457877
51800,2020-12-31,12267,Value,6066630,-9033601,4575724,-4457877
51800,2021-02-14,12267,Capital Call,-116882,-9150483,4575724,-4574759
51800,2021-03-31,12267,Value,6651560,-9150483,4575724,-4574759
51800,2021-05-16,12267,Capital Call,-121550,-9272033,4575724,-4696309
51800,2021-06-30,12267,Value,8994730,-9272033,4575724,-4696309
51800,2021-08-15,12267,Capital Call,-47814,-9319847,4575724,-4744123
51800,2021-08-15,12267,Distribution,2932320,-9319847,7508044,-1811803
51800,2021-09-30,12267,Value,7781880,-9319847,7508044,-1811803
51815,2020-01-15,102023,Distribution,1221822,-9368647,4843150,-4525497
51815,2020-02-29,102023,Value,9145060,-9368647,4843150,-4525497
51815,2020-04-15,102023,Capital Call,-16615,-9385262,4843150,-4542112
51815,2020-05-31,102023,Value,8797820,-9385262,4843150,-4542112
51815,2020-08-31,102023,Value,9613170,-9385262,4843150,-4542112
51815,2020-11-30,102023,Value,10296650,-9385262,4843150,-4542112
51815,2021-01-14,102023,Capital Call,-36315,-9421577,4843150,-4578427
51815,2021-02-28,102023,Value,10332970,-9421577,4843150,-4578427
51815,2021-04-15,102023,Distribution,2336025,-9421577,7179175,-2242402
51815,2021-05-31,102023,Value,8844590,-9421577,7179175,-2242402
51815,2021-07-16,102023,Capital Call,-28527,-9450104,7179175,-2270929
51815,2021-08-31,102023,Value,9860900,-9450104,7179175,-2270929
51815,2021-10-16,102023,Capital Call,-28636,-9478740,7179175,-2299565
51815,2021-10-16,102023,Distribution,2899306,-9478740,10078481,599741
51815,2021-11-30,102023,Value,9947610,-9478740,10078481,599741
51841,2020-03-31,2515,Value,24391460,-9294387,54871,-9239516
51851,2020-03-31,9004,Value,16756500,-9700000,162500,-9537500
51851,2020-06-30,9004,Value,16984000,-9700000,162500,-9537500
51851,2020-09-30,9004,Value,16992000,-9700000,162500,-9537500
51851,2020-12-31,9004,Value,25614000,-9700000,162500,-9537500
51851,2021-03-31,9004,Value,26781000,-9700000,162500,-9537500
51851,2021-06-30,9004,Value,30691000,-9700000,162500,-9537500
51852,2020-03-31,6322,Value,10560490,-7339857,311388,-7028469
51852,2020-06-30,6322,Value,11174370,-7339857,311388,-7028469
51852,2020-09-30,6322,Value,12891450,-7339857,311388,-7028469
51852,2020-11-15,6322,Capital Call,62,-7339795,311388,-7028407
51852,2020-11-15,6322,Distribution,2697250,-7339795,3008638,-4331157
51852,2020-12-31,6322,Value,10959680,-7339795,3008638,-4331157
51852,2021-02-14,6322,Capital Call,-1101828,-8441623,3008638,-5432985
51852,2021-02-14,6322,Distribution,1406177,-8441623,4414815,-4026808
51852,2021-03-31,6322,Value,10737130,-8441623,4414815,-4026808
51852,2021-05-16,6322,Distribution,311584,-8441623,4726399,-3715224
51852,2021-06-30,6322,Value,11210130,-8441623,4726399,-3715224
51859,2020-02-15,1886,Capital Call,-200000,-8690000,1650000,-7040000
51859,2020-03-31,1886,Value,9462190,-8690000,1650000,-7040000
51859,2020-05-16,1886,Capital Call,0,-8690000,1650000,-7040000
51859,2020-05-16,1886,Distribution,231,-8690000,1650231,-7039769
51859,2020-06-30,1886,Value,9854460,-8690000,1650231,-7039769
51859,2020-09-30,1886,Value,10575730,-8690000,1650231,-7039769
51859,2020-11-15,1886,Distribution,699545,-8690000,2349776,-6340224
51859,2020-12-31,1886,Value,10484480,-8690000,2349776,-6340224
51859,2021-02-14,1886,Distribution,299805,-8690000,2649581,-6040419
51859,2021-03-31,1886,Value,11445590,-8690000,2649581,-6040419
51859,2021-05-16,1886,Distribution,500544,-8690000,3150125,-5539875
51859,2021-06-30,1886,Value,11481220,-8690000,3150125,-5539875
51859,2021-08-15,1886,Distribution,579623,-8690000,3729748,-4960252
51859,2021-09-30,1886,Value,10918980,-8690000,3729748,-4960252
51915,2020-02-15,1314,Capital Call,-554000,-7014000,1840456,-5173544
51915,2020-02-15,1314,Distribution,550619,-7014000,2391075,-4622925
51915,2020-03-31,1314,Value,5064100,-7014000,2391075,-4622925
51915,2020-05-16,1314,Capital Call,-175000,-7189000,2391075,-4797925
51915,2020-05-16,1314,Distribution,175400,-7189000,2566475,-4622525
51915,2020-06-30,1314,Value,5456450,-7189000,2566475,-4622525
51915,2020-08-15,1314,Capital Call,-169000,-7358000,2566475,-4791525
51915,2020-08-15,1314,Distribution,-3,-7358000,2566472,-4791528
51915,2020-09-30,1314,Value,5739240,-7358000,2566472,-4791528
51915,2020-11-15,1314,Capital Call,-293000,-7651000,2566472,-5084528
51915,2020-11-15,1314,Distribution,440,-7651000,2566912,-5084088
51915,2020-12-31,1314,Value,6340380,-7651000,2566912,-5084088
51915,2021-02-14,1314,Capital Call,-212000,-7863000,2566912,-5296088
51915,2021-02-14,1314,Distribution,74271,-7863000,2641183,-5221817
51915,2021-03-31,1314,Value,16526450,-7863000,2641183,-5221817
51915,2021-05-16,1314,Capital Call,-1000,-7864000,2641183,-5222817
51915,2021-05-16,1314,Distribution,-450,-7864000,2640733,-5223267
51915,2021-06-30,1314,Value,17411680,-7864000,2640733,-5223267
51961,2020-02-15,58794,Capital Call,-620000,-8186665,6366666,-1819999
51961,2020-02-15,58794,Distribution,813333,-8186665,7179999,-1006666
51961,2020-03-31,58794,Value,3293330,-8186665,7179999,-1006666
51961,2020-05-16,58794,Capital Call,-213333,-8399998,7179999,-1219999
51961,2020-05-16,58794,Distribution,286667,-8399998,7466666,-933332
51961,2020-06-30,58794,Value,2766660,-8399998,7466666,-933332
51961,2020-08-15,58794,Capital Call,-546667,-8946665,7466666,-1479999
51961,2020-08-15,58794,Distribution,226667,-8946665,7693333,-1253332
51961,2020-09-30,58794,Value,3046660,-8946665,7693333,-1253332
51961,2020-11-15,58794,Capital Call,-73333,-9019998,7693333,-1326665
51961,2020-11-15,58794,Distribution,500000,-9019998,8193333,-826665
51961,2020-12-31,58794,Value,2780000,-9019998,8193333,-826665
51961,2021-02-14,58794,Capital Call,-80000,-9099998,8193333,-906665
51961,2021-02-14,58794,Distribution,173333,-9099998,8366666,-733332
51961,2021-03-31,58794,Value,2826660,-9099998,8366666,-733332
51961,2021-05-16,58794,Capital Call,-146667,-9246665,8366666,-879999
51961,2021-05-16,58794,Distribution,86667,-9246665,8453333,-793332
51961,2021-06-30,58794,Value,3259990,-9246665,8453333,-793332
51961,2021-08-15,58794,Capital Call,-200000,-9446665,8453333,-993332
51961,2021-08-15,58794,Distribution,373333,-9446665,8826666,-619999
51961,2021-09-30,58794,Value,3186660,-9446665,8826666,-619999
51996,2020-02-15,8441,Capital Call,-1543197,-5977784,462421,-5515363
51996,2020-02-15,8441,Distribution,14960,-5977784,477381,-5500403
51996,2020-03-31,8441,Value,5263020,-5977784,477381,-5500403
51996,2020-05-16,8441,Capital Call,5861,-5971923,477381,-5494542
51996,2020-05-16,8441,Distribution,28881,-5971923,506262,-5465661
51996,2020-06-30,8441,Value,6637700,-5971923,506262,-5465661
51996,2020-08-15,8441,Capital Call,-221371,-6193294,506262,-5687032
51996,2020-08-15,8441,Distribution,1002232,-6193294,1508494,-4684800
51996,2020-09-30,8441,Value,6899270,-6193294,1508494,-4684800
52012,2020-01-15,45418,Capital Call,-80094,-8540699,18190,-8522509
52012,2020-01-15,45418,Distribution,331411,-8540699,349601,-8191098
52012,2020-02-29,45418,Value,10146550,-8540699,349601,-8191098
52012,2020-04-15,45418,Capital Call,-48951,-8589650,349601,-8240049
52012,2020-04-15,45418,Distribution,67400,-8589650,417001,-8172649
52012,2020-05-31,45418,Value,10466230,-8589650,417001,-8172649
52012,2020-07-16,45418,Capital Call,-79094,-8668744,417001,-8251743
52012,2020-07-16,45418,Distribution,15122,-8668744,432123,-8236621
52012,2020-08-31,45418,Value,10545330,-8668744,432123,-8236621
52012,2020-11-30,45418,Value,10305690,-8668744,432123,-8236621
52012,2021-01-14,45418,Capital Call,-88742,-8757486,432123,-8325363
52012,2021-01-14,45418,Distribution,360900,-8757486,793023,-7964463
52012,2021-02-28,45418,Value,10033540,-8757486,793023,-7964463
52012,2021-05-31,45418,Value,11199830,-8757486,793023,-7964463
52012,2021-07-16,45418,Capital Call,-87848,-8845334,793023,-8052311
52012,2021-07-16,45418,Distribution,393835,-8845334,1186858,-7658476
52012,2021-08-31,45418,Value,13602840,-8845334,1186858,-7658476
52012,2021-10-16,45418,Capital Call,-2151,-8847485,1186858,-7660627
52012,2021-10-16,45418,Distribution,171776,-8847485,1358634,-7488851
52012,2021-11-30,45418,Value,15316410,-8847485,1358634,-7488851
52099,2020-03-31,158995,Value,13907000,-10000000,2453000,-7547000
52099,2020-08-16,158995,Distribution,1157000,-10000000,3610000,-6390000
52099,2020-12-31,158995,Value,20720000,-10000000,3610000,-6390000
52099,2021-03-31,158995,Value,19050000,-10000000,3610000,-6390000
52099,2021-06-30,158995,Value,21466000,-10000000,3610000,-6390000
52099,2021-08-15,158995,Distribution,-1027000,-10000000,2583000,-7417000
52099,2021-09-30,158995,Value,23904000,-10000000,2583000,-7417000
52099,2021-11-15,158995,Distribution,300000,-10000000,2883000,-7117000
52099,2021-12-31,158995,Value,25285000,-10000000,2883000,-7117000
52105,2020-03-31,375,Value,11720350,-8827000,0,-8827000
52105,2020-09-30,375,Capital Call,-593000,-9420000,0,-9420000
52105,2021-03-31,375,Value,17829640,-9420000,0,-9420000
52105,2021-05-16,375,Capital Call,-122000,-9542000,0,-9542000
52105,2021-05-16,375,Distribution,694227,-9542000,694227,-8847773
52105,2021-06-30,375,Value,24584280,-9542000,694227,-8847773
52107,2020-02-15,52720,Capital Call,-500000,-6114000,99368,-6014632
52107,2020-02-15,52720,Distribution,-321,-6114000,99047,-6014953
52107,2020-03-31,52720,Value,4730400,-6114000,99047,-6014953
52107,2020-06-30,52720,Value,4734680,-6114000,99047,-6014953
52173,2020-02-15,9110,Capital Call,-722508,-11360507,1818036,-9542471
52173,2020-02-15,9110,Distribution,820348,-11360507,2638384,-8722123
52173,2020-03-31,9110,Value,12300400,-11360507,2638384,-8722123
52173,2020-05-16,9110,Capital Call,-492,-11360999,2638384,-8722615
52173,2020-05-16,9110,Distribution,-358,-11360999,2638026,-8722973
52173,2020-06-30,9110,Value,12812930,-11360999,2638026,-8722973
52173,2020-08-15,9110,Capital Call,-236000,-11596999,2638026,-8958973
52173,2020-08-15,9110,Distribution,267024,-11596999,2905050,-8691949
52173,2020-09-30,9110,Value,13534850,-11596999,2905050,-8691949
52173,2020-11-15,9110,Capital Call,-168000,-11764999,2905050,-8859949
52173,2020-11-15,9110,Distribution,400917,-11764999,3305967,-8459032
52173,2020-12-31,9110,Value,15021550,-11764999,3305967,-8459032
52173,2021-02-14,9110,Capital Call,-2000,-11766999,3305967,-8461032
52173,2021-02-14,9110,Distribution,109995,-11766999,3415962,-8351037
52173,2021-03-31,9110,Value,16604410,-11766999,3415962,-8351037
52173,2021-05-16,9110,Capital Call,-207000,-11973999,3415962,-8558037
52173,2021-05-16,9110,Distribution,444458,-11973999,3860420,-8113579
52173,2021-06-30,9110,Value,17708340,-11973999,3860420,-8113579
52173,2021-08-15,9110,Capital Call,-154000,-12127999,3860420,-8267579
52173,2021-08-15,9110,Distribution,498386,-12127999,4358806,-7769193
52173,2021-09-30,9110,Value,17355160,-12127999,4358806,-7769193
52268,2020-03-31,2562,Value,13709250,-7499999,2156250,-5343749
52268,2020-06-30,2562,Value,13854750,-7499999,2156250,-5343749
52268,2020-08-15,2562,Distribution,468750,-7499999,2625000,-4874999
52268,2020-09-30,2562,Value,13582500,-7499999,2625000,-4874999
52268,2021-02-14,2562,Distribution,2152500,-7499999,4777500,-2722499
52268,2021-06-30,2562,Value,15517500,-7499999,4777500,-2722499
52268,2021-09-30,2562,Distribution,2947500,-7499999,7725000,225001
52268,2021-12-31,2562,Value,15997500,-7499999,7725000,225001
52274,2020-02-15,2562,Capital Call,-500000,-8999998,0,-8999998
52274,2020-03-31,2562,Value,12690000,-8999998,0,-8999998
52274,2020-06-30,2562,Value,12398400,-8999998,0,-8999998
52274,2020-09-30,2562,Value,12933000,-8999998,0,-8999998
52274,2021-02-14,2562,Capital Call,-1000000,-9999998,0,-9999998
52274,2021-02-14,2562,Distribution,3320000,-9999998,3320000,-6679998
52274,2021-06-30,2562,Value,16660000,-9999998,3320000,-6679998
52274,2021-09-30,2562,Distribution,3080000,-9999998,6400000,-3599998
52274,2021-12-31,2562,Value,15040000,-9999998,6400000,-3599998
52289,2020-02-15,15307,Capital Call,-289446,-8628526,270115,-8358411
52289,2020-03-31,15307,Value,11201670,-8628526,270115,-8358411
52289,2020-05-16,15307,Capital Call,-652038,-9280564,270115,-9010449
52289,2020-06-30,15307,Value,11970210,-9280564,270115,-9010449
52289,2020-08-15,15307,Capital Call,-85162,-9365726,270115,-9095611
52289,2020-08-15,15307,Distribution,33438,-9365726,303553,-9062173
52289,2020-09-30,15307,Value,12395500,-9365726,303553,-9062173
52289,2020-11-15,15307,Capital Call,-71055,-9436781,303553,-9133228
52289,2020-12-31,15307,Value,12732490,-9436781,303553,-9133228
52289,2021-02-14,15307,Capital Call,-278474,-9715255,303553,-9411702
52289,2021-03-31,15307,Value,14881920,-9715255,303553,-9411702
52289,2021-05-16,15307,Capital Call,-124869,-9840124,303553,-9536571
52289,2021-05-16,15307,Distribution,225705,-9840124,529258,-9310866
52289,2021-06-30,15307,Value,17331760,-9840124,529258,-9310866
52339,2020-02-15,2210,Capital Call,-32890,-6293474,0,-6293474
52339,2020-02-15,2210,Distribution,654702,-6293474,654702,-5638772
52339,2020-03-31,2210,Value,6691610,-6293474,654702,-5638772
52339,2020-05-16,2210,Capital Call,-30665,-6324139,654702,-5669437
52339,2020-06-30,2210,Value,5252810,-6324139,654702,-5669437
52342,2020-02-15,11324,Capital Call,-70000,-10870000,2446200,-8423800
52342,2020-02-15,11324,Distribution,-450,-10870000,2445750,-8424250
52342,2020-03-31,11324,Value,13640760,-10870000,2445750,-8424250
52342,2020-05-16,11324,Capital Call,-186000,-11056000,2445750,-8610250
52342,2020-05-16,11324,Distribution,100447,-11056000,2546197,-8509803
52342,2020-06-30,11324,Value,14696740,-11056000,2546197,-8509803
52342,2020-08-15,11324,Capital Call,-75000,-11131000,2546197,-8584803
52342,2020-08-15,11324,Distribution,1287320,-11131000,3833517,-7297483
52342,2020-09-30,11324,Value,15583400,-11131000,3833517,-7297483
52342,2020-11-15,11324,Capital Call,-75980,-11206980,3833517,-7373463
52342,2020-11-15,11324,Distribution,2321357,-11206980,6154874,-5052106
52342,2020-12-31,11324,Value,13719580,-11206980,6154874,-5052106
52342,2021-02-14,11324,Capital Call,-2020,-11209000,6154874,-5054126
52342,2021-02-14,11324,Distribution,14560,-11209000,6169434,-5039566
52342,2021-03-31,11324,Value,14430460,-11209000,6169434,-5039566
52342,2021-05-16,11324,Capital Call,-320000,-11529000,6169434,-5359566
52342,2021-05-16,11324,Distribution,347910,-11529000,6517344,-5011656
52342,2021-06-30,11324,Value,15296670,-11529000,6517344,-5011656
52342,2021-08-15,11324,Capital Call,-81000,-11610000,6517344,-5092656
52342,2021-08-15,11324,Distribution,1567860,-11610000,8085204,-3524796
52342,2021-09-30,11324,Value,15393690,-11610000,8085204,-3524796
52453,2020-06-30,29928,Value,11984250,-9250000,0,-9250000
52453,2020-12-30,29928,Distribution,2500000,-9250000,2500000,-6750000
52453,2021-06-30,29928,Value,18183910,-9250000,2500000,-6750000
52453,2021-08-15,29928,Distribution,3950025,-9250000,6450025,-2799975
52453,2021-09-30,29928,Value,17000570,-9250000,6450025,-2799975
52548,2020-02-15,2129,Capital Call,-60567,-9387018,1236409,-8150609
52548,2020-02-15,2129,Distribution,848233,-9387018,2084642,-7302376
52548,2020-03-31,2129,Value,13473120,-9387018,2084642,-7302376
52548,2020-05-16,2129,Capital Call,-374898,-9761916,2084642,-7677274
52548,2020-06-30,2129,Value,16331610,-9761916,2084642,-7677274
52548,2020-08-15,2129,Capital Call,-181083,-9942999,2084642,-7858357
52548,2020-08-15,2129,Distribution,533350,-9942999,2617992,-7325007
52548,2020-09-30,2129,Value,17556350,-9942999,2617992,-7325007
52548,2020-11-15,2129,Capital Call,-135000,-10077999,2617992,-7460007
52548,2020-11-15,2129,Distribution,3703938,-10077999,6321930,-3756069
52548,2020-12-31,2129,Value,16035100,-10077999,6321930,-3756069
52548,2021-02-14,2129,Capital Call,-122000,-10199999,6321930,-3878069
52548,2021-02-14,2129,Distribution,2071,-10199999,6324001,-3875998
52548,2021-03-31,2129,Value,17911200,-10199999,6324001,-3875998
52548,2021-05-16,2129,Capital Call,-934634,-11134633,6324001,-4810632
52548,2021-05-16,2129,Distribution,14568,-11134633,6338569,-4796064
52548,2021-06-30,2129,Value,21340520,-11134633,6338569,-4796064
52548,2021-08-15,2129,Capital Call,-221579,-11356212,6338569,-5017643
52548,2021-08-15,2129,Distribution,3272688,-11356212,9611257,-1744955
52548,2021-09-30,2129,Value,19056160,-11356212,9611257,-1744955
52586,2020-03-31,656,Value,9508650,-9350000,3622454,-5727546
52734,2020-02-15,350,Distribution,140556,-9952423,10308083,355660
52734,2020-03-31,350,Value,15504460,-9952423,10308083,355660
52734,2020-05-16,350,Distribution,186752,-9952423,10494835,542412
52734,2020-06-30,350,Value,15317720,-9952423,10494835,542412
52734,2020-08-15,350,Distribution,378157,-9952423,10872992,920569
52734,2020-09-30,350,Value,16082270,-9952423,10872992,920569
52734,2020-11-15,350,Distribution,340505,-9952423,11213497,1261074
52734,2020-12-31,350,Value,15205220,-9952423,11213497,1261074
52734,2021-02-14,350,Capital Call,-90184,-10042607,11213497,1170890
52734,2021-02-14,350,Distribution,1518000,-10042607,12731497,2688890
52734,2021-03-31,350,Value,13172230,-10042607,12731497,2688890
52734,2021-05-16,350,Distribution,477834,-10042607,13209331,3166724
52734,2021-06-30,350,Value,16549030,-10042607,13209331,3166724
52735,2020-02-15,350,Distribution,682972,-9810403,9651219,-159184
52735,2020-03-31,350,Value,17116150,-9810403,9651219,-159184
52735,2020-05-16,350,Distribution,636896,-9810403,10288115,477712
52735,2020-06-30,350,Value,16479260,-9810403,10288115,477712
52735,2020-08-15,350,Distribution,346874,-9810403,10634989,824586
52735,2020-09-30,350,Value,17759970,-9810403,10634989,824586
52735,2020-11-15,350,Distribution,185385,-9810403,10820374,1009971
52735,2020-12-31,350,Value,17422430,-9810403,10820374,1009971
52735,2021-02-14,350,Capital Call,-1144,-9811547,10820374,1008827
52735,2021-02-14,350,Distribution,461921,-9811547,11282295,1470748
52735,2021-03-31,350,Value,20825980,-9811547,11282295,1470748
52735,2021-05-16,350,Capital Call,1144,-9810403,11282295,1471892
52735,2021-05-16,350,Distribution,2765615,-9810403,14047910,4237507
52735,2021-06-30,350,Value,20140790,-9810403,14047910,4237507
52736,2020-03-31,350,Value,18030690,-8146181,1906139,-6240042
52736,2020-06-30,350,Value,18030690,-8146181,1906139,-6240042
52736,2020-09-30,350,Value,19825100,-8146181,1906139,-6240042
52736,2020-11-15,350,Capital Call,-1534573,-9680754,1906139,-7774615
52736,2020-11-15,350,Distribution,2854636,-9680754,4760775,-4919979
52736,2020-12-31,350,Value,19414780,-9680754,4760775,-4919979
52736,2021-02-14,350,Distribution,1269281,-9680754,6030056,-3650698
52736,2021-03-31,350,Value,21833050,-9680754,6030056,-3650698
52736,2021-05-16,350,Distribution,791154,-9680754,6821210,-2859544
52736,2021-06-30,350,Value,23572690,-9680754,6821210,-2859544
52944,2020-02-15,1632,Capital Call,-161000,-10407000,9016481,-1390519
52944,2020-02-15,1632,Distribution,145,-10407000,9016626,-1390374
52944,2020-03-31,1632,Value,11596520,-10407000,9016626,-1390374
52944,2020-06-30,1632,Value,13448960,-10407000,9016626,-1390374
52944,2020-09-30,1632,Value,14190980,-10407000,9016626,-1390374
52944,2020-11-15,1632,Capital Call,55000,-10352000,9016626,-1335374
52944,2020-11-15,1632,Distribution,461666,-10352000,9478292,-873708
52944,2020-12-31,1632,Value,13673950,-10352000,9478292,-873708
52944,2021-02-14,1632,Distribution,937891,-10352000,10416183,64183
52944,2021-03-31,1632,Value,14266090,-10352000,10416183,64183
52944,2021-05-16,1632,Distribution,0,-10352000,10416183,64183
52944,2021-06-30,1632,Value,13732960,-10352000,10416183,64183
52944,2021-08-15,1632,Distribution,0,-10352000,10416183,64183
52944,2021-09-30,1632,Value,13247450,-10352000,10416183,64183
52963,2020-02-15,317,Capital Call,-44348,-12976958,9046956,-3930002
52963,2020-02-15,317,Distribution,1662174,-12976958,10709130,-2267828
52963,2020-03-31,317,Value,10495210,-12976958,10709130,-2267828
52963,2020-05-16,317,Capital Call,-27826,-13004784,10709130,-2295654
52963,2020-06-30,317,Value,11197820,-13004784,10709130,-2295654
52963,2020-08-15,317,Capital Call,-27391,-13032175,10709130,-2323045
52963,2020-09-30,317,Value,12578690,-13032175,10709130,-2323045
52963,2020-11-15,317,Capital Call,-27826,-13060001,10709130,-2350871
52963,2020-11-15,317,Distribution,33913,-13060001,10743043,-2316958
52963,2020-12-31,317,Value,13937390,-13060001,10743043,-2316958
52963,2021-02-14,317,Capital Call,-98261,-13158262,10743043,-2415219
52963,2021-02-14,317,Distribution,2942609,-13158262,13685652,527390
52963,2021-03-31,317,Value,12578260,-13158262,13685652,527390
52963,2021-05-16,317,Capital Call,-35217,-13193479,13685652,492173
52963,2021-05-16,317,Distribution,252174,-13193479,13937826,744347
52963,2021-06-30,317,Value,15607390,-13193479,13937826,744347
52989,2020-02-15,2238,Distribution,480000,-8760000,1180000,-7580000
52989,2020-03-31,2238,Value,11420000,-8760000,1180000,-7580000
52989,2020-05-16,2238,Capital Call,-340000,-9100000,1180000,-7920000
52989,2020-05-16,2238,Distribution,540000,-9100000,1720000,-7380000
52989,2020-06-30,2238,Value,12440000,-9100000,1720000,-7380000
52989,2020-08-15,2238,Distribution,80000,-9100000,1800000,-7300000
52989,2020-09-30,2238,Value,13680000,-9100000,1800000,-7300000
52989,2020-11-15,2238,Capital Call,-460000,-9560000,1800000,-7760000
52989,2020-12-31,2238,Value,16720000,-9560000,1800000,-7760000
52989,2021-02-14,2238,Distribution,860000,-9560000,2660000,-6900000
52989,2021-03-31,2238,Value,16660000,-9560000,2660000,-6900000
52989,2021-06-30,2238,Value,15000000,-9560000,2660000,-6900000
52989,2021-08-15,2238,Distribution,640000,-9560000,3300000,-6260000
52989,2021-09-30,2238,Value,13100000,-9560000,3300000,-6260000
52994,2020-03-31,395,Value,13207080,-10000000,1935070,-8064930
52994,2020-05-16,395,Distribution,131854,-10000000,2066924,-7933076
52994,2020-06-30,395,Value,14173050,-10000000,2066924,-7933076
52994,2020-08-15,395,Distribution,67703,-10000000,2134627,-7865373
52994,2020-09-30,395,Value,14962520,-10000000,2134627,-7865373
52994,2020-11-15,395,Distribution,120207,-10000000,2254834,-7745166
52994,2020-12-31,395,Value,17975510,-10000000,2254834,-7745166
53016,2020-05-16,22829,Capital Call,-177000,-9071250,399193,-8672057
53016,2020-05-16,22829,Distribution,78959,-9071250,478152,-8593098
53016,2020-09-30,22829,Value,14015430,-9071250,478152,-8593098
53016,2020-11-15,22829,Capital Call,-221250,-9292500,478152,-8814348
53016,2020-11-15,22829,Distribution,115834,-9292500,593986,-8698514
53016,2020-12-31,22829,Value,18348940,-9292500,593986,-8698514
53016,2021-02-14,22829,Capital Call,-180951,-9473451,593986,-8879465
53016,2021-02-14,22829,Distribution,523793,-9473451,1117779,-8355672
53016,2021-03-31,22829,Value,20718020,-9473451,1117779,-8355672
53163,2020-05-04,81754,Distribution,4348,-17587,12105,-5482
53163,2020-08-03,81754,Capital Call,-6820,-24407,12105,-12302
53163,2020-12-31,81754,Value,7980,-24407,12105,-12302
53185,2020-02-15,80,Capital Call,-1292593,-9037037,3822222,-5214815
53185,2020-03-31,80,Value,5774070,-9037037,3822222,-5214815
53185,2020-05-16,80,Capital Call,-1322222,-10359259,3822222,-6537037
53185,2020-06-30,80,Value,8555550,-10359259,3822222,-6537037
53185,2020-08-15,80,Capital Call,-51852,-10411111,3822222,-6588889
53185,2020-08-15,80,Distribution,992593,-10411111,4814815,-5596296
53185,2020-09-30,80,Value,10181480,-10411111,4814815,-5596296
53185,2020-11-15,80,Capital Call,-700000,-11111111,4814815,-6296296
53185,2020-12-31,80,Value,14400000,-11111111,4814815,-6296296
53185,2021-02-14,80,Capital Call,-22222,-11133333,4814815,-6318518
53185,2021-02-14,80,Distribution,2055556,-11133333,6870371,-4262962
53185,2021-03-31,80,Value,11851850,-11133333,6870371,-4262962
53185,2021-05-16,80,Capital Call,-177778,-11311111,6870371,-4440740
53185,2021-05-16,80,Distribution,100000,-11311111,6970371,-4340740
53185,2021-06-30,80,Value,12485180,-11311111,6970371,-4340740
53185,2021-08-15,80,Capital Call,1852,-11309259,6970371,-4338888
53185,2021-09-30,80,Value,11215550,-11309259,6970371,-4338888
53189,2020-02-15,3652,Capital Call,-236000,-1511000,0,-1511000
53189,2020-03-31,3652,Value,1499510,-1511000,0,-1511000
53189,2020-05-16,3652,Capital Call,-2470000,-3981000,0,-3981000
53189,2020-06-30,3652,Value,3943970,-3981000,0,-3981000
53189,2020-08-15,3652,Capital Call,-144000,-4125000,0,-4125000
53189,2020-09-30,3652,Value,4070550,-4125000,0,-4125000
53189,2020-11-15,3652,Capital Call,-53000,-4178000,0,-4178000
53189,2020-12-31,3652,Value,5423870,-4178000,0,-4178000
53189,2021-03-31,3652,Value,5410920,-4178000,0,-4178000
53189,2021-06-30,3652,Value,5306470,-4178000,0,-4178000
53189,2021-09-30,3652,Value,5306470,-4178000,0,-4178000
53189,2021-12-31,3652,Value,6521020,-4178000,0,-4178000
53197,2020-03-31,7,Value,7955580,-8370000,1770000,-6600000
53197,2020-05-16,7,Capital Call,-440000,-8810000,1770000,-7040000
53197,2020-05-16,7,Distribution,110000,-8810000,1880000,-6930000
53197,2020-06-30,7,Value,9061880,-8810000,1880000,-6930000
53197,2020-08-15,7,Capital Call,-150000,-8960000,1880000,-7080000
53197,2020-09-30,7,Value,10102790,-8960000,1880000,-7080000
53197,2020-11-15,7,Capital Call,-160000,-9120000,1880000,-7240000
53197,2020-12-31,7,Value,12313780,-9120000,1880000,-7240000
53197,2021-03-31,7,Value,13530810,-9120000,1880000,-7240000
53239,2020-02-15,1360,Capital Call,-384896,-5065129,850628,-4214501
53239,2020-03-31,1360,Value,4634720,-5065129,850628,-4214501
53239,2020-06-30,1360,Value,5630690,-5065129,850628,-4214501
53239,2020-09-30,1360,Value,6046060,-5065129,850628,-4214501
53239,2020-11-15,1360,Capital Call,-201612,-5266741,850628,-4416113
53239,2020-11-15,1360,Distribution,201612,-5266741,1052240,-4214501
53239,2020-12-31,1360,Value,6623630,-5266741,1052240,-4214501
53239,2021-03-31,1360,Value,7196590,-5266741,1052240,-4214501
53239,2021-05-16,1360,Capital Call,-200000,-5466741,1052240,-4414501
53239,2021-05-16,1360,Distribution,400000,-5466741,1452240,-4014501
53239,2021-06-30,1360,Value,7789130,-5466741,1452240,-4014501
53311,2020-06-30,20411,Value,4392000,-6100000,1037000,-5063000
53311,2020-09-30,20411,Capital Call,-300000,-6400000,1037000,-5363000
53311,2020-09-30,20411,Distribution,1331000,-6400000,2368000,-4032000
53311,2020-12-31,20411,Value,3200000,-6400000,2368000,-4032000
53311,2021-06-30,20411,Value,4800000,-6400000,2368000,-4032000
53315,2020-02-15,164017,Distribution,1807724,-10655018,16560418,5905400
53315,2020-03-31,164017,Value,2086720,-10655018,16560418,5905400
53315,2020-06-30,164017,Value,2424450,-10655018,16560418,5905400
53315,2020-09-30,164017,Value,2619990,-10655018,16560418,5905400
53315,2020-12-31,164017,Value,2778910,-10655018,16560418,5905400
53315,2021-03-31,164017,Value,3165320,-10655018,16560418,5905400
53315,2021-05-16,164017,Capital Call,-66446,-10721464,16560418,5838954
53315,2021-05-16,164017,Distribution,1086098,-10721464,17646516,6925052
53315,2021-06-30,164017,Value,3490400,-10721464,17646516,6925052
53315,2021-09-30,164017,Value,4958200,-10721464,17646516,6925052
53315,2021-12-31,164017,Value,4954480,-10721464,17646516,6925052
53427,2020-06-30,164416,Value,7486110,-7005178,17700,-6987478
53457,2020-02-15,14429,Capital Call,-600000,-5100000,0,-5100000
53457,2020-03-31,14429,Value,2528070,-5100000,0,-5100000
53457,2020-07-01,14429,Capital Call,-200000,-5300000,0,-5300000
53457,2020-09-30,14429,Value,3069760,-5300000,0,-5300000
53457,2020-11-15,14429,Capital Call,-500000,-5800000,0,-5800000
53457,2020-12-31,14429,Value,3625000,-5800000,0,-5800000
53457,2021-03-31,14429,Value,5157940,-5800000,0,-5800000
53503,2020-02-15,42,Capital Call,-16477,-10251533,1476870,-8774663
53503,2020-02-15,42,Distribution,837398,-10251533,2314268,-7937265
53503,2020-03-31,42,Value,9828050,-10251533,2314268,-7937265
53503,2020-05-16,42,Capital Call,-624953,-10876486,2314268,-8562218
53503,2020-05-16,42,Distribution,5151,-10876486,2319419,-8557067
53503,2020-06-30,42,Value,10736120,-10876486,2319419,-8557067
53503,2020-08-15,42,Capital Call,-36291,-10912777,2319419,-8593358
53503,2020-08-15,42,Distribution,96869,-10912777,2416288,-8496489
53503,2020-09-30,42,Value,11046910,-10912777,2416288,-8496489
53503,2020-11-15,42,Capital Call,-38933,-10951710,2416288,-8535422
53503,2020-12-31,42,Value,13059000,-10951710,2416288,-8535422
53503,2021-02-14,42,Capital Call,-34664,-10986374,2416288,-8570086
53503,2021-02-14,42,Distribution,2226605,-10986374,4642893,-6343481
53503,2021-03-31,42,Value,11431150,-10986374,4642893,-6343481
53503,2021-05-16,42,Capital Call,-32317,-11018691,4642893,-6375798
53503,2021-05-16,42,Distribution,467641,-11018691,5110534,-5908157
53503,2021-06-30,42,Value,11650230,-11018691,5110534,-5908157
53503,2021-08-15,42,Capital Call,-28634,-11047325,5110534,-5936791
53503,2021-08-15,42,Distribution,253009,-11047325,5363543,-5683782
53503,2021-09-30,42,Value,12500760,-11047325,5363543,-5683782
53534,2020-03-31,384,Value,5141000,-9700000,10282000,582000
53534,2020-06-30,384,Value,6208000,-9700000,10282000,582000
53534,2020-08-15,384,Distribution,1843000,-9700000,12125000,2425000
53534,2020-09-30,384,Value,4656000,-9700000,12125000,2425000
53534,2020-12-31,384,Value,5044000,-9700000,12125000,2425000
53534,2021-02-14,384,Distribution,1552000,-9700000,13677000,3977000
53534,2021-03-31,384,Value,3201000,-9700000,13677000,3977000
53534,2021-06-30,384,Value,3201000,-9700000,13677000,3977000
53534,2021-09-30,384,Value,3007000,-9700000,13677000,3977000
53534,2021-12-31,384,Value,3007000,-9700000,13677000,3977000
53563,2020-02-15,355,Capital Call,-350000,-4500000,1452985,-3047015
53563,2020-03-31,355,Value,4283010,-4500000,1452985,-3047015
53563,2020-05-16,355,Capital Call,-700000,-5200000,1452985,-3747015
53563,2020-06-30,355,Value,5554780,-5200000,1452985,-3747015
53563,2020-09-30,355,Value,6114120,-5200000,1452985,-3747015
53563,2020-11-15,355,Capital Call,-350000,-5550000,1452985,-4097015
53563,2020-11-15,355,Distribution,200746,-5550000,1653731,-3896269
53563,2020-12-31,355,Value,6937950,-5550000,1653731,-3896269
53563,2021-02-14,355,Capital Call,-200000,-5750000,1653731,-4096269
53563,2021-02-14,355,Distribution,254279,-5750000,1908010,-3841990
53563,2021-03-31,355,Value,7662980,-5750000,1908010,-3841990
53563,2021-05-16,355,Capital Call,-150000,-5900000,1908010,-3991990
53563,2021-05-16,355,Distribution,602239,-5900000,2510249,-3389751
53563,2021-06-30,355,Value,8218580,-5900000,2510249,-3389751
53564,2020-03-31,355,Value,9009930,-6425000,899434,-5525566
53564,2020-05-16,355,Capital Call,-300000,-6725000,899434,-5825566
53564,2020-06-30,355,Value,10057390,-6725000,899434,-5825566
53564,2020-09-30,355,Value,11068100,-6725000,899434,-5825566
53564,2020-11-15,355,Capital Call,-950000,-7675000,899434,-6775566
53564,2020-11-15,355,Distribution,571207,-7675000,1470641,-6204359
53564,2020-12-31,355,Value,14231940,-7675000,1470641,-6204359
53564,2021-02-14,355,Capital Call,-350000,-8025000,1470641,-6554359
53564,2021-02-14,355,Distribution,428400,-8025000,1899041,-6125959
53564,2021-03-31,355,Value,17240590,-8025000,1899041,-6125959
53564,2021-05-16,355,Distribution,761603,-8025000,2660644,-5364356
53564,2021-06-30,355,Value,20026540,-8025000,2660644,-5364356
53565,2020-03-31,355,Value,6433330,-5099998,1333333,-3766665
53565,2020-05-16,355,Capital Call,-1000000,-6099998,1333333,-4766665
53565,2020-06-30,355,Value,8000000,-6099998,1333333,-4766665
53565,2020-09-30,355,Value,9533330,-6099998,1333333,-4766665
53565,2020-11-15,355,Capital Call,-633333,-6733331,1333333,-5399998
53565,2020-11-15,355,Distribution,433333,-6733331,1766666,-4966665
53565,2020-12-31,355,Value,9700000,-6733331,1766666,-4966665
53565,2021-03-31,355,Value,12633330,-6733331,1766666,-4966665
53565,2021-05-16,355,Distribution,1233333,-6733331,2999999,-3733332
53565,2021-06-30,355,Value,11366660,-6733331,2999999,-3733332
53565,2021-08-15,355,Capital Call,-663333,-7396664,2999999,-4396665
53565,2021-08-15,355,Distribution,423333,-7396664,3423332,-3973332
53565,2021-09-30,355,Value,13936660,-7396664,3423332,-3973332
53582,2020-02-15,6629,Capital Call,-60000,-6200000,356000,-5844000
53582,2020-02-15,6629,Distribution,276000,-6200000,632000,-5568000
53582,2020-03-31,6629,Value,3504000,-6200000,632000,-5568000
53582,2020-05-16,6629,Capital Call,-668000,-6868000,632000,-6236000
53582,2020-06-30,6629,Value,4623990,-6868000,632000,-6236000
53582,2020-09-30,6629,Value,4844000,-6868000,632000,-6236000
53582,2020-11-15,6629,Capital Call,-52000,-6920000,632000,-6288000
53582,2020-12-31,6629,Value,6056000,-6920000,632000,-6288000
53582,2021-02-14,6629,Capital Call,-432000,-7352000,632000,-6720000
53582,2021-02-14,6629,Distribution,1580000,-7352000,2212000,-5140000
53582,2021-03-31,6629,Value,5700000,-7352000,2212000,-5140000
53582,2021-05-16,6629,Capital Call,-1056000,-8408000,2212000,-6196000
53582,2021-06-30,6629,Value,7275990,-8408000,2212000,-6196000
53582,2021-08-15,6629,Capital Call,-329200,-8737200,2212000,-6525200
53582,2021-08-15,6629,Distribution,1058400,-8737200,3270400,-5466800
53582,2021-09-30,6629,Value,6159190,-8737200,3270400,-5466800
53593,2020-01-15,147,Capital Call,0,-8611640,50049,-8561591
53593,2020-02-29,147,Value,11922690,-8611640,50049,-8561591
53593,2020-04-15,147,Capital Call,-134987,-8746627,50049,-8696578
53593,2020-05-31,147,Value,10092140,-8746627,50049,-8696578
53593,2020-07-16,147,Capital Call,-24624,-8771251,50049,-8721202
53593,2020-08-31,147,Value,10773080,-8771251,50049,-8721202
53593,2020-10-16,147,Capital Call,-33182,-8804433,50049,-8754384
53593,2020-10-16,147,Distribution,224274,-8804433,274323,-8530110
53593,2020-11-30,147,Value,10926500,-8804433,274323,-8530110
53593,2021-01-14,147,Distribution,3843556,-8804433,4117879,-4686554
53593,2021-02-28,147,Value,8413640,-8804433,4117879,-4686554
53593,2021-04-15,147,Capital Call,-115507,-8919940,4117879,-4802061
53593,2021-04-15,147,Distribution,775539,-8919940,4893418,-4026522
53593,2021-05-31,147,Value,7158740,-8919940,4893418,-4026522
53593,2021-07-16,147,Capital Call,-240238,-9160178,4893418,-4266760
53593,2021-08-31,147,Value,7526360,-9160178,4893418,-4266760
53593,2021-10-16,147,Capital Call,-278048,-9438226,4893418,-4544808
53593,2021-11-30,147,Value,7787900,-9438226,4893418,-4544808
53608,2020-02-15,5777,Capital Call,-40000,-10480000,533333,-9946667
53608,2020-02-15,5777,Distribution,13333,-10480000,546666,-9933334
53608,2020-03-31,5777,Value,10173330,-10480000,546666,-9933334
53608,2020-05-16,5777,Distribution,-13333,-10480000,533333,-9946667
53608,2020-06-30,5777,Value,10666660,-10480000,533333,-9946667
53608,2020-08-15,5777,Capital Call,-280000,-10760000,533333,-10226667
53608,2020-08-15,5777,Distribution,480000,-10760000,1013333,-9746667
53608,2020-09-30,5777,Value,12226660,-10760000,1013333,-9746667
53608,2020-11-15,5777,Capital Call,-13333,-10773333,1013333,-9760000
53608,2020-11-15,5777,Distribution,706667,-10773333,1720000,-9053333
53608,2020-12-31,5777,Value,11800000,-10773333,1720000,-9053333
53608,2021-02-14,5777,Capital Call,-53333,-10826666,1720000,-9106666
53608,2021-02-14,5777,Distribution,1520000,-10826666,3240000,-7586666
53608,2021-03-31,5777,Value,11720000,-10826666,3240000,-7586666
53608,2021-05-16,5777,Capital Call,-53333,-10879999,3240000,-7639999
53608,2021-05-16,5777,Distribution,1053333,-10879999,4293333,-6586666
53608,2021-06-30,5777,Value,11186660,-10879999,4293333,-6586666
53608,2021-08-15,5777,Capital Call,-5333,-10885332,4293333,-6591999
53608,2021-08-15,5777,Distribution,-5333,-10885332,4288000,-6597332
53608,2021-09-30,5777,Value,12729330,-10885332,4288000,-6597332
53646,2020-02-15,9110,Capital Call,-421023,-9867023,2031835,-7835188
53646,2020-02-15,9110,Distribution,2113266,-9867023,4145101,-5721922
53646,2020-03-31,9110,Value,9272720,-9867023,4145101,-5721922
53646,2020-05-16,9110,Capital Call,-58977,-9926000,4145101,-5780899
53646,2020-05-16,9110,Distribution,116131,-9926000,4261232,-5664768
53646,2020-06-30,9110,Value,9740380,-9926000,4261232,-5664768
53646,2020-08-15,9110,Capital Call,-308000,-10234000,4261232,-5972768
53646,2020-08-15,9110,Distribution,469946,-10234000,4731178,-5502822
53646,2020-09-30,9110,Value,10110160,-10234000,4731178,-5502822
53646,2020-11-15,9110,Capital Call,-100857,-10334857,4731178,-5603679
53646,2020-11-15,9110,Distribution,43485,-10334857,4774663,-5560194
53646,2020-12-31,9110,Value,11829800,-10334857,4774663,-5560194
53646,2021-02-14,9110,Capital Call,-392970,-10727827,4774663,-5953164
53646,2021-02-14,9110,Distribution,351758,-10727827,5126421,-5601406
53646,2021-03-31,9110,Value,12633960,-10727827,5126421,-5601406
53646,2021-05-16,9110,Capital Call,-14173,-10742000,5126421,-5615579
53646,2021-05-16,9110,Distribution,3422063,-10742000,8548484,-2193516
53646,2021-06-30,9110,Value,10337020,-10742000,8548484,-2193516
53646,2021-09-30,9110,Value,10421880,-10742000,8548484,-2193516
53651,2020-02-15,7626,Capital Call,-101059,-10869593,2141002,-8728591
53651,2020-03-31,7626,Value,10601950,-10869593,2141002,-8728591
53651,2020-06-30,7626,Value,10040110,-10869593,2141002,-8728591
53651,2020-08-15,7626,Capital Call,-101058,-10970651,2141002,-8829649
53651,2020-09-30,7626,Value,11592080,-10970651,2141002,-8829649
53651,2020-11-15,7626,Distribution,4123038,-10970651,6264040,-4706611
53651,2020-12-31,7626,Value,10048410,-10970651,6264040,-4706611
53651,2021-02-14,7626,Distribution,402341,-10970651,6666381,-4304270
53651,2021-03-31,7626,Value,12587040,-10970651,6666381,-4304270
53651,2021-05-16,7626,Distribution,3864464,-10970651,10530845,-439806
53651,2021-06-30,7626,Value,11354570,-10970651,10530845,-439806
53670,2020-02-15,1759,Capital Call,-202638,-8435101,932463,-7502638
53670,2020-02-15,1759,Distribution,202583,-8435101,1135046,-7300055
53670,2020-03-31,1759,Value,7730640,-8435101,1135046,-7300055
53670,2020-06-30,1759,Value,8409200,-8435101,1135046,-7300055
53670,2020-08-15,1759,Capital Call,-500000,-8935101,1135046,-7800055
53670,2020-09-30,1759,Value,9642190,-8935101,1135046,-7800055
53670,2020-11-15,1759,Capital Call,-408934,-9344035,1135046,-8208989
53670,2020-11-15,1759,Distribution,766802,-9344035,1901848,-7442187
53670,2020-12-31,1759,Value,10405060,-9344035,1901848,-7442187
53670,2021-02-14,1759,Capital Call,-580825,-9924860,1901848,-8023012
53670,2021-02-14,1759,Distribution,500918,-9924860,2402766,-7522094
53670,2021-03-31,1759,Value,11640180,-9924860,2402766,-7522094
53671,2020-02-15,710,Capital Call,-1110000,-10563000,2785200,-7777800
53671,2020-03-31,710,Value,11469800,-10563000,2785200,-7777800
53671,2020-05-16,710,Capital Call,-479000,-11042000,2785200,-8256800
53671,2020-05-16,710,Distribution,499400,-11042000,3284600,-7757400
53671,2020-06-30,710,Value,12150600,-11042000,3284600,-7757400
53671,2020-09-30,710,Value,14040800,-11042000,3284600,-7757400
53671,2020-11-15,710,Capital Call,-16000,-11058000,3284600,-7773400
53671,2020-11-15,710,Distribution,151200,-11058000,3435800,-7622200
53671,2020-12-31,710,Value,15869800,-11058000,3435800,-7622200
53671,2021-02-14,710,Capital Call,-23000,-11081000,3435800,-7645200
53671,2021-02-14,710,Distribution,69000,-11081000,3504800,-7576200
53671,2021-03-31,710,Value,18695600,-11081000,3504800,-7576200
53671,2021-05-16,710,Capital Call,-507000,-11588000,3504800,-8083200
53671,2021-05-16,710,Distribution,1244400,-11588000,4749200,-6838800
53671,2021-06-30,710,Value,21888600,-11588000,4749200,-6838800
53672,2020-02-15,710,Capital Call,-210000,-6573400,5728600,-844800
53672,2020-03-31,710,Value,4978200,-6573400,5728600,-844800
53672,2020-05-16,710,Capital Call,-1534000,-8107400,5728600,-2378800
53672,2020-06-30,710,Value,7545000,-8107400,5728600,-2378800
53672,2020-08-15,710,Capital Call,-418000,-8525400,5728600,-2796800
53672,2020-09-30,710,Value,8194400,-8525400,5728600,-2796800
53672,2020-12-31,710,Value,9981200,-8525400,5728600,-2796800
53672,2021-02-14,710,Capital Call,-1014000,-9539400,5728600,-3810800
53672,2021-02-14,710,Distribution,2124400,-9539400,7853000,-1686400
53672,2021-03-31,710,Value,12213800,-9539400,7853000,-1686400
53672,2021-05-16,710,Capital Call,-306000,-9845400,7853000,-1992400
53672,2021-06-30,710,Value,14124600,-9845400,7853000,-1992400
53682,2020-03-31,1465,Value,7014330,-8300000,4956760,-3343240
53682,2020-05-16,1465,Distribution,128650,-8300000,5085410,-3214590
53682,2020-06-30,1465,Value,6859120,-8300000,5085410,-3214590
53682,2020-09-30,1465,Value,6943780,-8300000,5085410,-3214590
53682,2020-11-15,1465,Capital Call,-500000,-8800000,5085410,-3714590
53682,2020-11-15,1465,Distribution,100430,-8800000,5185840,-3614160
53682,2020-12-31,1465,Value,7323360,-8800000,5185840,-3614160
53682,2021-05-17,1465,Capital Call,-200000,-9000000,5185840,-3814160
53682,2021-05-17,1465,Distribution,2851160,-9000000,8037000,-963000
53682,2021-09-30,1465,Value,6984000,-9000000,8037000,-963000
53785,2020-03-31,537,Value,8496970,-9325000,7321147,-2003853
53785,2020-05-16,537,Capital Call,-325000,-9650000,7321147,-2328853
53785,2020-05-16,537,Distribution,108576,-9650000,7429723,-2220277
53785,2020-06-30,537,Value,9044130,-9650000,7429723,-2220277
53785,2020-08-15,537,Capital Call,-125000,-9775000,7429723,-2345277
53785,2020-09-30,537,Value,9975560,-9775000,7429723,-2345277
53785,2020-11-15,537,Capital Call,-100000,-9875000,7429723,-2445277
53785,2020-12-31,537,Value,14547950,-9875000,7429723,-2445277
53785,2021-03-31,537,Value,24968300,-9875000,7429723,-2445277
53785,2021-06-30,537,Value,26979730,-9875000,7429723,-2445277
53785,2021-09-30,537,Value,25834050,-9875000,7429723,-2445277
53791,2020-02-15,10775,Capital Call,-1100000,-7060000,0,-7060000
53791,2020-03-31,10775,Value,8381960,-7060000,0,-7060000
53791,2020-05-16,10775,Distribution,296305,-7060000,296305,-6763695
53791,2020-06-30,10775,Value,8109460,-7060000,296305,-6763695
53791,2020-08-15,10775,Capital Call,-100000,-7160000,296305,-6863695
53791,2020-09-30,10775,Value,8281070,-7160000,296305,-6863695
53791,2020-11-15,10775,Capital Call,-365000,-7525000,296305,-7228695
53791,2020-12-31,10775,Value,14121920,-7525000,296305,-7228695
53791,2021-03-31,10775,Value,15504310,-7525000,296305,-7228695
53791,2021-05-16,10775,Capital Call,-605000,-8130000,296305,-7833695
53791,2021-06-30,10775,Value,17017160,-8130000,296305,-7833695
53803,2020-02-15,54,Capital Call,-6667,-8615556,920001,-7695555
53803,2020-02-15,54,Distribution,133333,-8615556,1053334,-7562222
53803,2020-03-31,54,Value,7539990,-8615556,1053334,-7562222
53803,2020-05-16,54,Capital Call,-484444,-9100000,1053334,-8046666
53803,2020-05-16,54,Distribution,264444,-9100000,1317778,-7782222
53803,2020-06-30,54,Value,6773330,-9100000,1317778,-7782222
53803,2020-08-15,54,Capital Call,-124444,-9224444,1317778,-7906666
53803,2020-08-15,54,Distribution,348889,-9224444,1666667,-7557777
53803,2020-09-30,54,Value,6862220,-9224444,1666667,-7557777
53803,2020-11-15,54,Capital Call,-477778,-9702222,1666667,-8035555
53803,2020-11-15,54,Distribution,180000,-9702222,1846667,-7855555
53803,2020-12-31,54,Value,7606660,-9702222,1846667,-7855555
53803,2021-02-14,54,Capital Call,-228889,-9931111,1846667,-8084444
53803,2021-02-14,54,Distribution,353333,-9931111,2200000,-7731111
53803,2021-03-31,54,Value,8573330,-9931111,2200000,-7731111
53803,2021-05-16,54,Capital Call,-122222,-10053333,2200000,-7853333
53803,2021-05-16,54,Distribution,515556,-10053333,2715556,-7337777
53803,2021-06-30,54,Value,9242220,-10053333,2715556,-7337777
53803,2021-08-15,54,Capital Call,-443556,-10496889,2715556,-7781333
53803,2021-08-15,54,Distribution,335778,-10496889,3051334,-7445555
53803,2021-09-30,54,Value,10058440,-10496889,3051334,-7445555
53834,2020-03-31,515145,Value,5854720,-5335930,535540,-4800390
53859,2020-02-15,355,Capital Call,-375000,-7675000,2106923,-5568077
53859,2020-02-15,355,Distribution,252675,-7675000,2359598,-5315402
53859,2020-03-31,355,Value,8007420,-7675000,2359598,-5315402
53859,2020-05-16,355,Capital Call,-350000,-8025000,2359598,-5665402
53859,2020-06-30,355,Value,9243660,-8025000,2359598,-5665402
53859,2020-09-30,355,Value,10055950,-8025000,2359598,-5665402
53859,2020-11-15,355,Capital Call,-350000,-8375000,2359598,-6015402
53859,2020-11-15,355,Distribution,621969,-8375000,2981567,-5393433
53859,2020-12-31,355,Value,11972380,-8375000,2981567,-5393433
53859,2021-02-14,355,Distribution,573378,-8375000,3554945,-4820055
53859,2021-03-31,355,Value,12864300,-8375000,3554945,-4820055
53859,2021-05-16,355,Capital Call,-75000,-8450000,3554945,-4895055
53859,2021-05-16,355,Distribution,680279,-8450000,4235224,-4214776
53859,2021-06-30,355,Value,13542610,-8450000,4235224,-4214776
53864,2020-02-15,96,Capital Call,-2128000,-8509334,133333,-8376001
53864,2020-02-15,96,Distribution,37333,-8509334,170666,-8338668
53864,2020-03-31,96,Value,8677330,-8509334,170666,-8338668
53864,2020-06-30,96,Value,9695990,-8509334,170666,-8338668
53864,2020-08-15,96,Capital Call,-250667,-8760001,170666,-8589335
53864,2020-08-15,96,Distribution,2690667,-8760001,2861333,-5898668
53864,2020-09-30,96,Value,6607990,-8760001,2861333,-5898668
53864,2020-11-15,96,Distribution,130667,-8760001,2992000,-5768001
53864,2020-12-31,96,Value,7573330,-8760001,2992000,-5768001
53864,2021-03-31,96,Value,8095990,-8760001,2992000,-5768001
53864,2021-05-16,96,Distribution,133333,-8760001,3125333,-5634668
53864,2021-06-30,96,Value,8271990,-8760001,3125333,-5634668
53864,2021-08-15,96,Capital Call,800,-8759201,3125333,-5633868
53864,2021-08-15,96,Distribution,-533,-8759201,3124800,-5634401
53864,2021-09-30,96,Value,8665060,-8759201,3124800,-5634401
53865,2020-03-31,174,Value,7131780,-7455954,549682,-6906272
53865,2020-05-16,174,Capital Call,-613108,-8069062,549682,-7519380
53865,2020-06-30,174,Value,8703310,-8069062,549682,-7519380
53865,2020-08-15,174,Capital Call,-718816,-8787878,549682,-8238196
53865,2020-09-30,174,Value,11874550,-8787878,549682,-8238196
53865,2020-11-15,174,Capital Call,-972516,-9760394,549682,-9210712
53865,2020-11-15,174,Distribution,894996,-9760394,1444678,-8315716
53865,2020-12-31,174,Value,15933750,-9760394,1444678,-8315716
53865,2021-03-31,174,Value,14291750,-9760394,1444678,-8315716
53865,2021-05-16,174,Capital Call,-49331,-9809725,1444678,-8365047
53865,2021-05-16,174,Distribution,1169838,-9809725,2614516,-7195209
53865,2021-06-30,174,Value,15503870,-9809725,2614516,-7195209
53865,2021-09-30,174,Value,15193790,-9809725,2614516,-7195209
53866,2020-02-15,23,Capital Call,-375000,-9270000,0,-9270000
53866,2020-03-31,23,Value,9762700,-9270000,0,-9270000
53866,2020-05-16,23,Capital Call,-100000,-9370000,0,-9370000
53866,2020-06-30,23,Value,12605970,-9370000,0,-9370000
53866,2020-08-15,23,Capital Call,-120000,-9490000,0,-9490000
53866,2020-09-30,23,Value,14649990,-9490000,0,-9490000
53866,2020-12-31,23,Value,18486760,-9490000,0,-9490000
53866,2021-02-14,23,Distribution,3065155,-9490000,3065155,-6424845
53866,2021-03-31,23,Value,16844220,-9490000,3065155,-6424845
53866,2021-05-16,23,Distribution,415733,-9490000,3480888,-6009112
53866,2021-06-30,23,Value,17806740,-9490000,3480888,-6009112
53873,2020-02-15,10551,Capital Call,-64000,-6364000,76229,-6287771
53873,2020-02-15,10551,Distribution,138,-6364000,76367,-6287633
53873,2020-03-31,10551,Value,5788690,-6364000,76367,-6287633
53873,2020-05-16,10551,Capital Call,-188000,-6552000,76367,-6475633
53873,2020-05-16,10551,Distribution,41568,-6552000,117935,-6434065
53873,2020-06-30,10551,Value,5615060,-6552000,117935,-6434065
53873,2020-08-15,10551,Capital Call,-235000,-6787000,117935,-6669065
53873,2020-08-15,10551,Distribution,11017,-6787000,128952,-6658048
53873,2020-09-30,10551,Value,5748580,-6787000,128952,-6658048
53873,2020-11-15,10551,Capital Call,-292000,-7079000,128952,-6950048
53873,2020-11-15,10551,Distribution,55101,-7079000,184053,-6894947
53873,2020-12-31,10551,Value,5918040,-7079000,184053,-6894947
53873,2021-02-14,10551,Capital Call,-310000,-7389000,184053,-7204947
53873,2021-02-14,10551,Distribution,52394,-7389000,236447,-7152553
53873,2021-03-31,10551,Value,7728890,-7389000,236447,-7152553
53873,2021-05-16,10551,Capital Call,-229000,-7618000,236447,-7381553
53873,2021-05-16,10551,Distribution,3519226,-7618000,3755673,-3862327
53873,2021-06-30,10551,Value,8539770,-7618000,3755673,-3862327
53873,2021-08-15,10551,Capital Call,-135000,-7753000,3755673,-3997327
53873,2021-08-15,10551,Distribution,-3222,-7753000,3752451,-4000549
53873,2021-09-30,10551,Value,8427510,-7753000,3752451,-4000549
53873,2021-11-15,10551,Capital Call,-910000,-8663000,3752451,-4910549
53873,2021-11-15,10551,Distribution,137235,-8663000,3889686,-4773314
53873,2021-12-31,10551,Value,8550380,-8663000,3889686,-4773314
53883,2020-03-31,165025,Value,9182910,-8411227,348269,-8062958
53883,2020-06-30,165025,Value,9960680,-8411227,348269,-8062958
53883,2020-08-15,165025,Capital Call,11227,-8400000,348269,-8051731
53883,2020-08-15,165025,Distribution,491731,-8400000,840000,-7560000
53883,2020-09-30,165025,Value,9576000,-8400000,840000,-7560000
53883,2020-12-31,165025,Value,9996000,-8400000,840000,-7560000
53883,2021-02-14,165025,Distribution,446294,-8400000,1286294,-7113706
53883,2021-03-31,165025,Value,9587450,-8400000,1286294,-7113706
53883,2021-05-16,165025,Distribution,-26294,-8400000,1260000,-7140000
53883,2021-06-30,165025,Value,10248000,-8400000,1260000,-7140000
53883,2021-08-15,165025,Distribution,1914780,-8400000,3174780,-5225220
53883,2021-09-30,165025,Value,8569800,-8400000,3174780,-5225220
53905,2020-03-31,88791,Value,1249830,-9047732,2328792,-6718940
53905,2020-05-16,88791,Distribution,158416,-9047732,2487208,-6560524
53905,2020-06-30,88791,Value,1048880,-9047732,2487208,-6560524
53905,2020-08-15,88791,Distribution,173267,-9047732,2660475,-6387257
53905,2020-09-30,88791,Value,1016840,-9047732,2660475,-6387257
53905,2020-12-31,88791,Value,1018240,-9047732,2660475,-6387257
53905,2021-03-31,88791,Value,1075940,-9047732,2660475,-6387257
53905,2021-06-30,88791,Value,1060740,-9047732,2660475,-6387257
53910,2020-03-31,9110,Value,10941910,-10800752,2415504,-8385248
53910,2020-05-16,9110,Capital Call,-204248,-11005000,2415504,-8589496
53910,2020-05-16,9110,Distribution,50717,-11005000,2466221,-8538779
53910,2020-06-30,9110,Value,11582760,-11005000,2466221,-8538779
53910,2020-08-15,9110,Capital Call,-114000,-11119000,2466221,-8652779
53910,2020-08-15,9110,Distribution,213459,-11119000,2679680,-8439320
53910,2020-09-30,9110,Value,12365430,-11119000,2679680,-8439320
53910,2020-12-31,9110,Value,13973240,-11119000,2679680,-8439320
53910,2021-02-14,9110,Capital Call,-474000,-11593000,2679680,-8913320
53910,2021-02-14,9110,Distribution,685769,-11593000,3365449,-8227551
53910,2021-03-31,9110,Value,14985110,-11593000,3365449,-8227551
53910,2021-05-16,9110,Capital Call,-15000,-11608000,3365449,-8242551
53910,2021-05-16,9110,Distribution,231871,-11608000,3597320,-8010680
53910,2021-06-30,9110,Value,15892510,-11608000,3597320,-8010680
53910,2021-08-15,9110,Capital Call,-167000,-11775000,3597320,-8177680
53910,2021-08-15,9110,Distribution,470943,-11775000,4068263,-7706737
53910,2021-09-30,9110,Value,15961010,-11775000,4068263,-7706737
53912,2020-02-15,9110,Capital Call,-396000,-10893001,1662726,-9230275
53912,2020-02-15,9110,Distribution,532215,-10893001,2194941,-8698060
53912,2020-03-31,9110,Value,10498670,-10893001,2194941,-8698060
53912,2020-05-16,9110,Capital Call,-278000,-11171001,2194941,-8976060
53912,2020-05-16,9110,Distribution,133097,-11171001,2328038,-8842963
53912,2020-06-30,9110,Value,11121840,-11171001,2328038,-8842963
53912,2020-08-15,9110,Capital Call,-356000,-11527001,2328038,-9198963
53912,2020-08-15,9110,Distribution,204446,-11527001,2532484,-8994517
53912,2020-09-30,9110,Value,12141380,-11527001,2532484,-8994517
53912,2020-11-15,9110,Capital Call,267,-11526734,2532484,-8994250
53912,2020-11-15,9110,Distribution,-484,-11526734,2532000,-8994734
53912,2020-12-31,9110,Value,13894410,-11526734,2532000,-8994734
53912,2021-02-14,9110,Capital Call,-1003267,-12530001,2532000,-9998001
53912,2021-02-14,9110,Distribution,690719,-12530001,3222719,-9307282
53912,2021-03-31,9110,Value,14943270,-12530001,3222719,-9307282
53912,2021-06-30,9110,Value,16079740,-12530001,3222719,-9307282
53912,2021-09-30,9110,Value,16220080,-12530001,3222719,-9307282
53913,2020-02-15,9110,Capital Call,-641392,-10290393,1216738,-9073655
53913,2020-02-15,9110,Distribution,843004,-10290393,2059742,-8230651
53913,2020-03-31,9110,Value,10000770,-10290393,2059742,-8230651
53913,2020-05-16,9110,Capital Call,-101608,-10392001,2059742,-8332259
53913,2020-05-16,9110,Distribution,52951,-10392001,2112693,-8279308
53913,2020-06-30,9110,Value,10564500,-10392001,2112693,-8279308
53913,2020-08-15,9110,Capital Call,-294000,-10686001,2112693,-8573308
53913,2020-08-15,9110,Distribution,204031,-10686001,2316724,-8369277
53913,2020-09-30,9110,Value,11503470,-10686001,2316724,-8369277
53913,2020-11-15,9110,Capital Call,-316043,-11002044,2316724,-8685320
53913,2020-11-15,9110,Distribution,366907,-11002044,2683631,-8318413
53913,2020-12-31,9110,Value,13087030,-11002044,2683631,-8318413
53913,2021-02-14,9110,Capital Call,-509727,-11511771,2683631,-8828140
53913,2021-02-14,9110,Distribution,305242,-11511771,2988873,-8522898
53913,2021-03-31,9110,Value,14150800,-11511771,2988873,-8522898
53913,2021-05-16,9110,Capital Call,-257231,-11769002,2988873,-8780129
53913,2021-05-16,9110,Distribution,452,-11769002,2989325,-8779677
53913,2021-06-30,9110,Value,15615100,-11769002,2989325,-8779677
53913,2021-08-15,9110,Capital Call,-366000,-12135002,2989325,-9145677
53913,2021-08-15,9110,Distribution,694860,-12135002,3684185,-8450817
53913,2021-09-30,9110,Value,15457560,-12135002,3684185,-8450817
53915,2020-02-15,9110,Capital Call,-481959,-9865962,1416048,-8449914
53915,2020-02-15,9110,Distribution,635129,-9865962,2051177,-7814785
53915,2020-03-31,9110,Value,9803080,-9865962,2051177,-7814785
53915,2020-06-30,9110,Value,10279340,-9865962,2051177,-7814785
53915,2020-08-15,9110,Capital Call,-384041,-10250003,2051177,-8198826
53915,2020-08-15,9110,Distribution,258151,-10250003,2309328,-7940675
53915,2020-09-30,9110,Value,11291400,-10250003,2309328,-7940675
53915,2020-11-15,9110,Capital Call,-349838,-10599841,2309328,-8290513
53915,2020-11-15,9110,Distribution,261354,-10599841,2570682,-8029159
53915,2020-12-31,9110,Value,13071830,-10599841,2570682,-8029159
53915,2021-02-14,9110,Capital Call,-227009,-10826850,2570682,-8256168
53915,2021-02-14,9110,Distribution,166155,-10826850,2736837,-8090013
53915,2021-03-31,9110,Value,13970290,-10826850,2736837,-8090013
53915,2021-05-16,9110,Capital Call,-152,-10827002,2736837,-8090165
53915,2021-05-16,9110,Distribution,232,-10827002,2737069,-8089933
53915,2021-06-30,9110,Value,15040860,-10827002,2737069,-8089933
53915,2021-08-15,9110,Capital Call,-515000,-11342002,2737069,-8604933
53915,2021-08-15,9110,Distribution,766478,-11342002,3503547,-7838455
53915,2021-09-30,9110,Value,14924930,-11342002,3503547,-7838455
53986,2020-03-31,436,Value,5072030,-4910000,63905,-4846095
53986,2020-05-16,436,Capital Call,-340000,-5250000,63905,-5186095
53986,2020-05-16,436,Distribution,4425,-5250000,68330,-5181670
53986,2020-06-30,436,Value,6137250,-5250000,68330,-5181670
53986,2020-08-15,436,Capital Call,-350000,-5600000,68330,-5531670
53986,2020-08-15,436,Distribution,77441,-5600000,145771,-5454229
53986,2020-09-30,436,Value,7806400,-5600000,145771,-5454229
53986,2020-11-15,436,Capital Call,-680000,-6280000,145771,-6134229
53986,2020-11-15,436,Distribution,130548,-6280000,276319,-6003681
53986,2020-12-31,436,Value,9049480,-6280000,276319,-6003681
53986,2021-04-01,436,Capital Call,-1260000,-7540000,276319,-7263681
53986,2021-04-01,436,Distribution,545540,-7540000,821859,-6718141
53986,2021-06-30,436,Value,15012140,-7540000,821859,-6718141
53986,2021-08-15,436,Capital Call,9000,-7531000,821859,-6709141
53986,2021-08-15,436,Distribution,1481120,-7531000,2302979,-5228021
53986,2021-09-30,436,Value,13954180,-7531000,2302979,-5228021
53986,2021-11-15,436,Capital Call,-1457000,-8988000,2302979,-6685021
53986,2021-11-15,436,Distribution,550710,-8988000,2853689,-6134311
53986,2021-12-31,436,Value,16902830,-8988000,2853689,-6134311
53995,2020-02-15,607,Capital Call,-97075,-3214618,0,-3214618
53995,2020-03-31,607,Value,2857330,-3214618,0,-3214618
53995,2020-05-16,607,Capital Call,-1162057,-4376675,0,-4376675
53995,2020-06-30,607,Value,4917070,-4376675,0,-4376675
53995,2020-08-15,607,Capital Call,-96558,-4473233,0,-4473233
53995,2020-09-30,607,Value,5685460,-4473233,0,-4473233
53995,2020-11-15,607,Capital Call,-562025,-5035258,0,-5035258
53995,2020-11-15,607,Distribution,2809024,-5035258,2809024,-2226234
53995,2020-12-31,607,Value,4210830,-5035258,2809024,-2226234
53995,2021-02-14,607,Capital Call,210257,-4825001,2809024,-2015977
53995,2021-02-14,607,Distribution,-117157,-4825001,2691867,-2133134
53995,2021-03-31,607,Value,4299070,-4825001,2691867,-2133134
54012,2020-03-31,66152,Value,7345780,-7504854,1957662,-5547192
54012,2020-06-30,66152,Value,6626630,-7504854,1957662,-5547192
54012,2020-09-30,66152,Value,7286280,-7504854,1957662,-5547192
54012,2020-11-15,66152,Capital Call,-628060,-8132914,1957662,-6175252
54012,2020-12-31,66152,Value,9341210,-8132914,1957662,-6175252
54012,2021-02-14,66152,Capital Call,-892038,-9024952,1957662,-7067290
54012,2021-02-14,66152,Distribution,316,-9024952,1957978,-7066974
54012,2021-03-31,66152,Value,10781400,-9024952,1957978,-7066974
54012,2021-05-16,66152,Distribution,1544122,-9024952,3502100,-5522852
54012,2021-06-30,66152,Value,9774120,-9024952,3502100,-5522852
54133,2020-02-15,20331,Capital Call,-396000,-7716000,2715720,-5000280
54133,2020-02-15,20331,Distribution,14201,-7716000,2729921,-4986079
54133,2020-03-31,20331,Value,5850270,-7716000,2729921,-4986079
54133,2020-05-16,20331,Capital Call,-274000,-7990000,2729921,-5260079
54133,2020-05-16,20331,Distribution,2659,-7990000,2732580,-5257420
54133,2020-06-30,20331,Value,6439940,-7990000,2732580,-5257420
54133,2020-09-30,20331,Value,6192250,-7990000,2732580,-5257420
54133,2020-11-15,20331,Capital Call,-60000,-8050000,2732580,-5317420
54133,2020-11-15,20331,Distribution,-3630,-8050000,2728950,-5321050
54133,2020-12-31,20331,Value,6471390,-8050000,2728950,-5321050
54133,2021-02-14,20331,Capital Call,-70000,-8120000,2728950,-5391050
54133,2021-02-14,20331,Distribution,23730,-8120000,2752680,-5367320
54133,2021-03-31,20331,Value,6690880,-8120000,2752680,-5367320
54133,2021-05-16,20331,Capital Call,-102000,-8222000,2752680,-5469320
54133,2021-05-16,20331,Distribution,718648,-8222000,3471328,-4750672
54133,2021-06-30,20331,Value,6174720,-8222000,3471328,-4750672
54133,2021-08-15,20331,Distribution,549230,-8222000,4020558,-4201442
54133,2021-09-30,20331,Value,5755400,-8222000,4020558,-4201442
54133,2021-11-15,20331,Capital Call,-203000,-8425000,4020558,-4404442
54133,2021-11-15,20331,Distribution,-5203,-8425000,4015355,-4409645
54133,2021-12-31,20331,Value,6641420,-8425000,4015355,-4409645
54135,2020-02-29,102023,Value,11508390,-9867374,3708300,-6159074
54135,2020-05-31,102023,Value,10474000,-9867374,3708300,-6159074
54135,2020-08-31,102023,Value,11444000,-9867374,3708300,-6159074
54135,2020-11-30,102023,Value,12522010,-9867374,3708300,-6159074
54135,2021-01-14,102023,Distribution,5345159,-9867374,9053459,-813915
54135,2021-02-28,102023,Value,9110700,-9867374,9053459,-813915
54135,2021-04-15,102023,Capital Call,-5000,-9872374,9053459,-818915
54135,2021-04-15,102023,Distribution,3833158,-9872374,12886617,3014243
54135,2021-05-31,102023,Value,6164780,-9872374,12886617,3014243
54135,2021-08-31,102023,Value,6455280,-9872374,12886617,3014243
54135,2021-10-16,102023,Distribution,0,-9872374,12886617,3014243
54135,2021-11-30,102023,Value,6457370,-9872374,12886617,3014243
54148,2020-02-15,280,Capital Call,-17766,-9368852,789386,-8579466
54148,2020-02-15,280,Distribution,643315,-9368852,1432701,-7936151
54148,2020-03-31,280,Value,10301370,-9368852,1432701,-7936151
54148,2020-05-16,280,Capital Call,-9500,-9378352,1432701,-7945651
54148,2020-06-30,280,Value,11084630,-9378352,1432701,-7945651
54148,2020-08-15,280,Capital Call,-453592,-9831944,1432701,-8399243
54148,2020-09-30,280,Value,12247230,-9831944,1432701,-8399243
54148,2020-11-15,280,Capital Call,-204011,-10035955,1432701,-8603254
54148,2020-11-15,280,Distribution,50491,-10035955,1483192,-8552763
54148,2020-12-31,280,Value,13663260,-10035955,1483192,-8552763
54148,2021-02-14,280,Capital Call,-18893,-10054848,1483192,-8571656
54148,2021-03-31,280,Value,13682160,-10054848,1483192,-8571656
54151,2020-06-30,30179,Value,12923240,-10000000,5200000,-4800000
54151,2020-12-30,30179,Distribution,1200000,-10000000,6400000,-3600000
54151,2021-06-30,30179,Value,13343320,-10000000,6400000,-3600000
54168,2020-03-31,1317,Value,4593800,-5122800,31400,-5091400
54168,2020-05-16,1317,Capital Call,-778600,-5901400,31400,-5870000
54168,2020-05-16,1317,Distribution,5600,-5901400,37000,-5864400
54168,2020-06-30,1317,Value,5453200,-5901400,37000,-5864400
54168,2020-09-30,1317,Value,5509800,-5901400,37000,-5864400
54168,2020-11-15,1317,Capital Call,-1116600,-7018000,37000,-6981000
54168,2020-11-15,1317,Distribution,84200,-7018000,121200,-6896800
54168,2020-12-31,1317,Value,6885400,-7018000,121200,-6896800
54168,2021-02-14,1317,Capital Call,-2338400,-9356400,121200,-9235200
54168,2021-02-14,1317,Distribution,14000,-9356400,135200,-9221200
54168,2021-03-31,1317,Value,9749400,-9356400,135200,-9221200
54168,2021-06-30,1317,Value,10125600,-9356400,135200,-9221200
54234,2020-02-15,77,Capital Call,-1321549,-5802760,975120,-4827640
54234,2020-02-15,77,Distribution,120013,-5802760,1095133,-4707627
54234,2020-03-31,77,Value,5777280,-5802760,1095133,-4707627
54234,2020-05-16,77,Capital Call,133348,-5669412,1095133,-4574279
54234,2020-06-30,77,Value,5571450,-5669412,1095133,-4574279
54234,2020-08-15,77,Distribution,53717,-5669412,1148850,-4520562
54234,2020-09-30,77,Value,5913940,-5669412,1148850,-4520562
54234,2020-11-15,77,Capital Call,-73341,-5742753,1148850,-4593903
54234,2020-11-15,77,Distribution,226691,-5742753,1375541,-4367212
54234,2020-12-31,77,Value,6420170,-5742753,1375541,-4367212
54234,2021-02-14,77,Distribution,1604807,-5742753,2980348,-2762405
54234,2021-03-31,77,Value,5338490,-5742753,2980348,-2762405
54291,2020-02-15,167718,Capital Call,-167084,-9494329,11465824,1971495
54291,2020-02-15,167718,Distribution,9125,-9494329,11474949,1980620
54291,2020-03-31,167718,Value,4668330,-9494329,11474949,1980620
54291,2020-05-16,167718,Capital Call,-67854,-9562183,11474949,1912766
54291,2020-05-16,167718,Distribution,31344,-9562183,11506293,1944110
54291,2020-06-30,167718,Value,4982220,-9562183,11506293,1944110
54291,2020-09-30,167718,Capital Call,-337947,-9900130,11506293,1606163
54291,2020-09-30,167718,Distribution,1463794,-9900130,12970087,3069957
54291,2020-12-31,167718,Value,4427480,-9900130,12970087,3069957
54291,2021-02-14,167718,Distribution,138632,-9900130,13108719,3208589
54291,2021-03-31,167718,Value,4359190,-9900130,13108719,3208589
54291,2021-05-16,167718,Capital Call,-31689,-9931819,13108719,3176900
54291,2021-05-16,167718,Distribution,78007,-9931819,13186726,3254907
54291,2021-06-30,167718,Value,5264510,-9931819,13186726,3254907
54318,2020-01-15,9022,Distribution,0,-10000000,7920119,-2079881
54318,2020-02-29,9022,Value,13546260,-10000000,7920119,-2079881
54318,2020-04-15,9022,Distribution,6330526,-10000000,14250645,4250645
54318,2020-05-31,9022,Value,8821830,-10000000,14250645,4250645
54318,2020-08-31,9022,Value,14641930,-10000000,14250645,4250645
54318,2020-10-16,9022,Distribution,16776169,-10000000,31026814,21026814
54318,2020-11-30,9022,Value,3849960,-10000000,31026814,21026814
54318,2021-02-28,9022,Value,3849960,-10000000,31026814,21026814
54318,2021-04-15,9022,Distribution,2077600,-10000000,33104414,23104414
54318,2021-05-31,9022,Value,5432260,-10000000,33104414,23104414
54318,2021-08-31,9022,Value,6659620,-10000000,33104414,23104414
54318,2021-10-16,9022,Distribution,125440,-10000000,33229854,23229854
54318,2021-11-30,9022,Value,4985260,-10000000,33229854,23229854
54391,2020-02-15,18,Capital Call,0,-6460122,1131139,-5328983
54391,2020-02-15,18,Distribution,5392,-6460122,1136531,-5323591
54391,2020-03-31,18,Value,8465750,-6460122,1136531,-5323591
54391,2020-05-16,18,Capital Call,-800015,-7260137,1136531,-6123606
54391,2020-06-30,18,Value,10198860,-7260137,1136531,-6123606
54391,2020-08-15,18,Distribution,399069,-7260137,1535600,-5724537
54391,2020-09-30,18,Value,10974850,-7260137,1535600,-5724537
54391,2020-11-15,18,Capital Call,-250005,-7510142,1535600,-5974542
54391,2020-12-31,18,Value,14575510,-7510142,1535600,-5974542
54391,2021-02-14,18,Distribution,3507,-7510142,1539107,-5971035
54391,2021-03-31,18,Value,16300660,-7510142,1539107,-5971035
54391,2021-05-16,18,Capital Call,-449861,-7960003,1539107,-6420896
54391,2021-05-16,18,Distribution,1400012,-7960003,2939119,-5020884
54391,2021-06-30,18,Value,18433030,-7960003,2939119,-5020884
54391,2021-09-30,18,Value,19689080,-7960003,2939119,-5020884
54456,2020-02-15,814,Capital Call,-57000,-8856000,4967915,-3888085
54456,2020-02-15,814,Distribution,-585,-8856000,4967330,-3888670
54456,2020-03-31,814,Value,6750040,-8856000,4967330,-3888670
54456,2020-05-16,814,Capital Call,-284000,-9140000,4967330,-4172670
54456,2020-05-16,814,Distribution,260,-9140000,4967590,-4172410
54456,2020-06-30,814,Value,7169410,-9140000,4967590,-4172410
54456,2020-08-15,814,Capital Call,-13000,-9153000,4967590,-4185410
54456,2020-08-15,814,Distribution,-257,-9153000,4967333,-4185667
54456,2020-09-30,814,Value,7855100,-9153000,4967333,-4185667
54456,2020-11-15,814,Capital Call,-445000,-9598000,4967333,-4630667
54456,2020-11-15,814,Distribution,592,-9598000,4967925,-4630075
54456,2020-12-31,814,Value,8863750,-9598000,4967925,-4630075
54456,2021-02-14,814,Capital Call,-54000,-9652000,4967925,-4684075
54456,2021-02-14,814,Distribution,-40,-9652000,4967885,-4684115
54456,2021-03-31,814,Value,9538100,-9652000,4967885,-4684115
54456,2021-06-30,814,Value,12822680,-9652000,4967885,-4684115
54456,2021-08-15,814,Distribution,2995016,-9652000,7962901,-1689099
54456,2021-09-30,814,Value,10709850,-9652000,7962901,-1689099
54457,2020-03-31,25,Capital Call,-26585,-9365264,0,-9365264
54457,2020-06-30,25,Value,11256660,-9365264,0,-9365264
54457,2020-08-15,25,Capital Call,-53124,-9418388,0,-9418388
54457,2020-09-30,25,Value,11531290,-9418388,0,-9418388
54457,2020-11-15,25,Capital Call,-18917,-9437305,0,-9437305
54457,2020-12-31,25,Value,14028820,-9437305,0,-9437305
54457,2021-02-14,25,Capital Call,324256,-9113049,0,-9113049
54457,2021-02-14,25,Distribution,1937341,-9113049,1937341,-7175708
54457,2021-03-31,25,Value,11750590,-9113049,1937341,-7175708
54458,2020-02-15,2204,Capital Call,-122485,-9627427,2083648,-7543779
54458,2020-03-31,2204,Value,11369220,-9627427,2083648,-7543779
54458,2020-05-16,2204,Capital Call,-31731,-9659158,2083648,-7575510
54458,2020-06-30,2204,Value,11387630,-9659158,2083648,-7575510
54458,2020-08-15,2204,Capital Call,-35460,-9694618,2083648,-7610970
54458,2020-09-30,2204,Value,11807050,-9694618,2083648,-7610970
54458,2020-11-15,2204,Capital Call,-567091,-10261709,2083648,-8178061
54458,2020-11-15,2204,Distribution,1787015,-10261709,3870663,-6391046
54458,2020-12-31,2204,Value,11414330,-10261709,3870663,-6391046
54458,2021-02-14,2204,Distribution,3231513,-10261709,7102176,-3159533
54458,2021-03-31,2204,Value,9810750,-10261709,7102176,-3159533
54458,2021-05-16,2204,Capital Call,-185792,-10447501,7102176,-3345325
54458,2021-06-30,2204,Value,11799050,-10447501,7102176,-3345325
54458,2021-08-15,2204,Capital Call,-30695,-10478196,7102176,-3376020
54458,2021-08-15,2204,Distribution,828483,-10478196,7930659,-2547537
54458,2021-09-30,2204,Value,12195820,-10478196,7930659,-2547537
54568,2020-02-15,13158,Capital Call,-400000,-9300000,0,-9300000
54568,2020-03-31,13158,Value,13631840,-9300000,0,-9300000
54568,2020-05-16,13158,Distribution,200000,-9300000,200000,-9100000
54568,2020-06-30,13158,Value,15146680,-9300000,200000,-9100000
54568,2020-09-30,13158,Value,16370420,-9300000,200000,-9100000
54568,2020-12-31,13158,Value,22446000,-9300000,200000,-9100000
54568,2021-02-14,13158,Distribution,652391,-9300000,852391,-8447609
54568,2021-03-31,13158,Value,25683640,-9300000,852391,-8447609
54568,2021-07-01,13158,Capital Call,200000,-9100000,852391,-8247609
54568,2021-07-01,13158,Distribution,3060609,-9100000,3913000,-5187000
54568,2021-09-30,13158,Value,30485000,-9100000,3913000,-5187000
54596,2020-02-15,202,Capital Call,-729046,-8626795,344827,-8281968
54596,2020-02-15,202,Distribution,134181,-8626795,479008,-8147787
54596,2020-03-31,202,Value,9657080,-8626795,479008,-8147787
54596,2020-05-16,202,Capital Call,-135633,-8762428,479008,-8283420
54596,2020-06-30,202,Value,7915850,-8762428,479008,-8283420
54596,2020-08-15,202,Capital Call,-378877,-9141305,479008,-8662297
54596,2020-09-30,202,Value,8234120,-9141305,479008,-8662297
54596,2020-11-15,202,Capital Call,-248661,-9389966,479008,-8910958
54596,2020-11-15,202,Distribution,46726,-9389966,525734,-8864232
54596,2020-12-31,202,Value,10270850,-9389966,525734,-8864232
54596,2021-02-14,202,Capital Call,-49114,-9439080,525734,-8913346
54596,2021-02-14,202,Distribution,50357,-9439080,576091,-8862989
54596,2021-03-31,202,Value,10221080,-9439080,576091,-8862989
54598,2020-02-15,872,Capital Call,-590000,-5880000,3090000,-2790000
54598,2020-03-31,872,Value,4990000,-5880000,3090000,-2790000
54598,2020-05-16,872,Capital Call,-400000,-6280000,3090000,-3190000
54598,2020-05-16,872,Distribution,10000,-6280000,3100000,-3180000
54598,2020-06-30,872,Value,5390000,-6280000,3100000,-3180000
54598,2020-08-15,872,Capital Call,-1160000,-7440000,3100000,-4340000
54598,2020-09-30,872,Value,6619990,-7440000,3100000,-4340000
54598,2020-11-15,872,Capital Call,-670000,-8110000,3100000,-5010000
54598,2020-12-31,872,Value,7559990,-8110000,3100000,-5010000
54598,2021-02-14,872,Capital Call,-990000,-9100000,3100000,-6000000
54598,2021-02-14,872,Distribution,200000,-9100000,3300000,-5800000
54598,2021-03-31,872,Value,12040000,-9100000,3300000,-5800000
54598,2021-05-16,872,Capital Call,-200000,-9300000,3300000,-6000000
54598,2021-05-16,872,Distribution,2900000,-9300000,6200000,-3100000
54598,2021-06-30,872,Value,10149990,-9300000,6200000,-3100000
54598,2021-08-15,872,Capital Call,3000,-9297000,6200000,-3097000
54598,2021-08-15,872,Distribution,1000,-9297000,6201000,-3096000
54598,2021-09-30,872,Value,11112990,-9297000,6201000,-3096000
54650,2020-03-31,67055,Value,7600000,-10000000,4400000,-5600000
54650,2020-05-16,67055,Distribution,600000,-10000000,5000000,-5000000
54650,2020-06-30,67055,Value,7300000,-10000000,5000000,-5000000
54650,2020-08-15,67055,Distribution,-48000,-10000000,4952000,-5048000
54650,2020-09-30,67055,Value,7683000,-10000000,4952000,-5048000
54650,2020-11-15,67055,Distribution,2048000,-10000000,7000000,-3000000
54650,2020-12-31,67055,Value,6500000,-10000000,7000000,-3000000
54677,2020-02-15,157772,Capital Call,-494221,-4128108,1529345,-2598763
54677,2020-02-15,157772,Distribution,0,-4128108,1529345,-2598763
54677,2020-03-31,157772,Value,2805980,-4128108,1529345,-2598763
54677,2020-06-30,157772,Value,3029280,-4128108,1529345,-2598763
54677,2020-09-30,157772,Value,3357210,-4128108,1529345,-2598763
54677,2020-11-15,157772,Capital Call,0,-4128108,1529345,-2598763
54677,2020-11-15,157772,Distribution,0,-4128108,1529345,-2598763
54677,2020-12-31,157772,Value,4020200,-4128108,1529345,-2598763
54717,2020-02-15,367,Capital Call,-1790833,-5988499,1834,-5986665
54717,2020-03-31,367,Value,5517330,-5988499,1834,-5986665
54717,2020-06-30,367,Value,5180660,-5988499,1834,-5986665
54717,2020-09-30,367,Value,5656000,-5988499,1834,-5986665
54717,2020-12-31,367,Value,7636500,-5988499,1834,-5986665
54717,2021-02-14,367,Capital Call,-1456500,-7444999,1834,-7443165
54717,2021-03-31,367,Value,9463000,-7444999,1834,-7443165
54717,2021-05-16,367,Capital Call,-357667,-7802666,1834,-7800832
54717,2021-05-16,367,Distribution,777167,-7802666,779001,-7023665
54717,2021-06-30,367,Value,13262830,-7802666,779001,-7023665
54718,2020-01-15,1697,Capital Call,-176670,-8268159,437210,-7830949
54718,2020-01-15,1697,Distribution,0,-8268159,437210,-7830949
54718,2020-02-29,1697,Value,11460320,-8268159,437210,-7830949
54718,2020-04-15,1697,Capital Call,-517773,-8785932,437210,-8348722
54718,2020-04-15,1697,Distribution,1008379,-8785932,1445589,-7340343
54718,2020-05-31,1697,Value,9318550,-8785932,1445589,-7340343
54718,2020-08-31,1697,Value,10219880,-8785932,1445589,-7340343
54718,2020-10-16,1697,Capital Call,-99511,-8885443,1445589,-7439854
54718,2020-11-30,1697,Value,9847640,-8885443,1445589,-7439854
54718,2021-01-14,1697,Capital Call,-117842,-9003285,1445589,-7557696
54718,2021-02-28,1697,Value,8875140,-9003285,1445589,-7557696
54718,2021-05-31,1697,Value,9332200,-9003285,1445589,-7557696
54718,2021-07-16,1697,Capital Call,-70146,-9073431,1445589,-7627842
54718,2021-08-31,1697,Value,10220040,-9073431,1445589,-7627842
54718,2021-10-16,1697,Capital Call,0,-9073431,1445589,-7627842
54718,2021-10-16,1697,Distribution,0,-9073431,1445589,-7627842
54718,2021-11-30,1697,Value,11142790,-9073431,1445589,-7627842
54789,2020-03-31,19241,Capital Call,-104000,-3240000,0,-3240000
54789,2020-06-30,19241,Value,2260870,-3240000,0,-3240000
54789,2020-09-30,19241,Capital Call,-1790000,-5030000,0,-5030000
54789,2020-12-31,19241,Value,4527000,-5030000,0,-5030000
54804,2020-02-15,6963,Capital Call,-300000,-5800000,0,-5800000
54804,2020-03-31,6963,Value,7482000,-5800000,0,-5800000
54804,2020-05-16,6963,Capital Call,-600000,-6400000,0,-6400000
54804,2020-06-30,6963,Value,9472000,-6400000,0,-6400000
54804,2020-09-30,6963,Capital Call,-400000,-6800000,0,-6800000
54804,2020-12-31,6963,Value,12784000,-6800000,0,-6800000
54804,2021-02-14,6963,Capital Call,-400000,-7200000,0,-7200000
54804,2021-03-31,6963,Value,13320000,-7200000,0,-7200000
54804,2021-05-16,6963,Capital Call,-1000000,-8200000,0,-8200000
54804,2021-06-30,6963,Value,20664000,-8200000,0,-8200000
54804,2021-08-15,6963,Capital Call,-400000,-8600000,0,-8600000
54804,2021-08-15,6963,Distribution,2580,-8600000,2580,-8597420
54804,2021-09-30,6963,Value,22876000,-8600000,2580,-8597420
54937,2020-03-31,47993,Value,8581330,-9582326,4278829,-5303497
54937,2020-05-16,47993,Capital Call,-103854,-9686180,4278829,-5407351
54937,2020-06-30,47993,Value,9721230,-9686180,4278829,-5407351
54937,2020-08-15,47993,Distribution,1231312,-9686180,5510141,-4176039
54937,2020-09-30,47993,Value,8903720,-9686180,5510141,-4176039
54937,2020-12-31,47993,Value,9119150,-9686180,5510141,-4176039
54937,2021-02-14,47993,Distribution,1433859,-9686180,6944000,-2742180
54937,2021-03-31,47993,Value,8344040,-9686180,6944000,-2742180
54956,2020-02-29,5011,Value,4194610,-3575000,209516,-3365484
54956,2020-04-15,5011,Capital Call,-1700000,-5275000,209516,-5065484
54956,2020-05-31,5011,Value,5603360,-5275000,209516,-5065484
54956,2020-08-31,5011,Value,5075600,-5275000,209516,-5065484
54956,2020-11-30,5011,Value,6466150,-5275000,209516,-5065484
54956,2021-01-14,5011,Capital Call,-925000,-6200000,209516,-5990484
54956,2021-02-28,5011,Value,9462770,-6200000,209516,-5990484
54956,2021-04-15,5011,Distribution,101538,-6200000,311054,-5888946
54956,2021-05-31,5011,Value,10630980,-6200000,311054,-5888946
54956,2021-08-31,5011,Value,12370040,-6200000,311054,-5888946
54956,2021-11-30,5011,Value,13549780,-6200000,311054,-5888946
54988,2020-03-31,355,Value,3553020,-3457959,89983,-3367976
54991,2020-02-15,6387,Capital Call,-1650000,-8190000,0,-8190000
54991,2020-03-31,6387,Value,7944300,-8190000,0,-8190000
54991,2020-05-16,6387,Capital Call,-174000,-8364000,0,-8364000
54991,2020-06-30,6387,Value,8447640,-8364000,0,-8364000
54991,2020-09-30,6387,Value,8865840,-8364000,0,-8364000
54991,2020-12-31,6387,Value,9953160,-8364000,0,-8364000
54991,2021-03-31,6387,Value,10287720,-8364000,0,-8364000
54991,2021-06-30,6387,Value,10873200,-8364000,0,-8364000
54991,2021-09-30,6387,Value,13131480,-8364000,0,-8364000
54991,2021-11-15,6387,Capital Call,-234000,-8598000,0,-8598000
54991,2021-12-31,6387,Value,14272680,-8598000,0,-8598000
55028,2020-02-15,475912,Capital Call,-468000,-8916000,1836595,-7079405
55028,2020-02-15,475912,Distribution,162372,-8916000,1998967,-6917033
55028,2020-03-31,475912,Value,8874980,-8916000,1998967,-6917033
55028,2020-06-30,475912,Value,9724680,-8916000,1998967,-6917033
55028,2020-09-30,475912,Value,10722380,-8916000,1998967,-6917033
55028,2020-11-15,475912,Capital Call,-984000,-9900000,1998967,-7901033
55028,2020-11-15,475912,Distribution,1268033,-9900000,3267000,-6633000
55028,2020-12-31,475912,Value,11880000,-9900000,3267000,-6633000
55028,2021-02-14,475912,Capital Call,-500000,-10400000,3267000,-7133000
55028,2021-02-14,475912,Distribution,893000,-10400000,4160000,-6240000
55028,2021-03-31,475912,Value,13000000,-10400000,4160000,-6240000
55050,2020-03-31,554,Value,3329310,-2891402,255588,-2635814
55050,2020-05-16,554,Capital Call,-4990,-2896392,255588,-2640804
55050,2020-06-30,554,Value,2413450,-2896392,255588,-2640804
55050,2020-08-15,554,Capital Call,-144710,-3041102,255588,-2785514
55050,2020-09-30,554,Value,2833190,-3041102,255588,-2785514
55050,2020-11-15,554,Capital Call,-20000,-3061102,255588,-2805514
55050,2020-11-15,554,Distribution,10000,-3061102,265588,-2795514
55050,2020-12-31,554,Value,2865150,-3061102,265588,-2795514
55050,2021-03-31,554,Value,2813790,-3061102,265588,-2795514
55050,2021-07-01,554,Capital Call,-44162,-3105264,265588,-2839676
55050,2021-09-30,554,Value,2542430,-3105264,265588,-2839676
55071,2020-01-15,8935,Capital Call,-51299,-5967073,73535,-5893538
55071,2020-01-15,8935,Distribution,8036,-5967073,81571,-5885502
55071,2020-02-29,8935,Value,5672000,-5967073,81571,-5885502
55071,2020-04-15,8935,Capital Call,-48628,-6015701,81571,-5934130
55071,2020-04-15,8935,Distribution,-3,-6015701,81568,-5934133
55071,2020-05-31,8935,Value,5114240,-6015701,81568,-5934133
55071,2020-07-16,8935,Capital Call,-51907,-6067608,81568,-5986040
55071,2020-07-16,8935,Distribution,7586,-6067608,89154,-5978454
55071,2020-08-31,8935,Value,5107790,-6067608,89154,-5978454
55071,2020-10-16,8935,Capital Call,-49558,-6117166,89154,-6028012
55071,2020-10-16,8935,Distribution,10867,-6117166,100021,-6017145
55071,2020-11-30,8935,Value,5109530,-6117166,100021,-6017145
55071,2021-01-14,8935,Capital Call,-53107,-6170273,100021,-6070252
55071,2021-01-14,8935,Distribution,12104,-6170273,112125,-6058148
55071,2021-02-28,8935,Value,5150540,-6170273,112125,-6058148
55071,2021-04-15,8935,Capital Call,-135046,-6305319,112125,-6193194
55071,2021-04-15,8935,Distribution,8292,-6305319,120417,-6184902
55071,2021-05-31,8935,Value,5148190,-6305319,120417,-6184902
55071,2021-07-16,8935,Capital Call,-51218,-6356537,120417,-6236120
55071,2021-07-16,8935,Distribution,7253,-6356537,127670,-6228867
55071,2021-08-31,8935,Value,5662860,-6356537,127670,-6228867
55071,2021-10-16,8935,Capital Call,-2489193,-8845730,127670,-8718060
55071,2021-10-16,8935,Distribution,7501,-8845730,135171,-8710559
55071,2021-11-30,8935,Value,7858380,-8845730,135171,-8710559
55083,2020-03-31,483,Value,6989790,-7811229,0,-7811229
55083,2020-05-16,483,Capital Call,-1079227,-8890456,0,-8890456
55083,2020-06-30,483,Value,7933050,-8890456,0,-8890456
55083,2020-09-30,483,Value,9620030,-8890456,0,-8890456
55088,2020-02-15,6649,Capital Call,-80000,-7850000,460000,-7390000
55088,2020-03-31,6649,Value,8490000,-7850000,460000,-7390000
55088,2020-05-16,6649,Capital Call,-15000,-7865000,460000,-7405000
55088,2020-05-16,6649,Distribution,35000,-7865000,495000,-7370000
55088,2020-06-30,6649,Value,8695000,-7865000,495000,-7370000
55088,2020-08-15,6649,Capital Call,-625000,-8490000,495000,-7995000
55088,2020-09-30,6649,Value,10279990,-8490000,495000,-7995000
55088,2020-11-15,6649,Capital Call,-340000,-8830000,495000,-8335000
55088,2020-12-31,6649,Value,11670000,-8830000,495000,-8335000
55088,2021-02-14,6649,Capital Call,-20000,-8850000,495000,-8355000
55088,2021-02-14,6649,Distribution,465000,-8850000,960000,-7890000
55088,2021-03-31,6649,Value,12714990,-8850000,960000,-7890000
55088,2021-05-16,6649,Capital Call,-195000,-9045000,960000,-8085000
55088,2021-06-30,6649,Value,14279990,-9045000,960000,-8085000
55088,2021-08-15,6649,Capital Call,-879000,-9924000,960000,-8964000
55088,2021-08-15,6649,Distribution,-2000,-9924000,958000,-8966000
55088,2021-09-30,6649,Value,17849990,-9924000,958000,-8966000
55113,2020-03-31,18,Capital Call,-1150000,-6450000,0,-6450000
55113,2020-06-30,18,Value,6671880,-6450000,0,-6450000
55113,2020-08-15,18,Capital Call,-500000,-6950000,0,-6950000
55113,2020-09-30,18,Value,8073120,-6950000,0,-6950000
55113,2020-12-31,18,Value,9313690,-6950000,0,-6950000
55113,2021-02-14,18,Capital Call,-500000,-7450000,0,-7450000
55113,2021-03-31,18,Value,11701710,-7450000,0,-7450000
55113,2021-06-30,18,Value,13350400,-7450000,0,-7450000
55132,2020-02-15,154,Capital Call,-149133,-5130765,235192,-4895573
55132,2020-02-15,154,Distribution,2792070,-5130765,3027262,-2103503
55132,2020-03-31,154,Value,2713350,-5130765,3027262,-2103503
55132,2020-05-16,154,Capital Call,-584838,-5715603,3027262,-2688341
55132,2020-06-30,154,Value,3200350,-5715603,3027262,-2688341
55132,2020-08-15,154,Capital Call,-1169676,-6885279,3027262,-3858017
55132,2020-09-30,154,Value,4497510,-6885279,3027262,-3858017
55132,2020-11-15,154,Capital Call,-2087872,-8973151,3027262,-5945889
55132,2020-12-31,154,Value,7020520,-8973151,3027262,-5945889
55132,2021-02-14,154,Distribution,763432,-8973151,3790694,-5182457
55132,2021-03-31,154,Value,7206450,-8973151,3790694,-5182457
55132,2021-06-30,154,Value,8022370,-8973151,3790694,-5182457
55264,2020-02-15,24,Capital Call,-350000,-7400000,1267590,-6132410
55264,2020-02-15,24,Distribution,30,-7400000,1267620,-6132380
55264,2020-03-31,24,Value,7542080,-7400000,1267620,-6132380
55264,2020-05-16,24,Capital Call,-100000,-7500000,1267620,-6232380
55264,2020-05-16,24,Distribution,-120,-7500000,1267500,-6232500
55264,2020-06-30,24,Value,7836000,-7500000,1267500,-6232500
55264,2020-09-30,24,Value,8411250,-7500000,1267500,-6232500
55264,2020-11-15,24,Capital Call,-290000,-7790000,1267500,-6522500
55264,2020-11-15,24,Distribution,14734,-7790000,1282234,-6507766
55264,2020-12-31,24,Value,9839540,-7790000,1282234,-6507766
55264,2021-02-14,24,Capital Call,90000,-7700000,1282234,-6417766
55264,2021-02-14,24,Distribution,-14814,-7700000,1267420,-6432580
55264,2021-03-31,24,Value,10723020,-7700000,1267420,-6432580
55264,2021-05-16,24,Capital Call,-150000,-7850000,1267420,-6582580
55264,2021-05-16,24,Distribution,1604110,-7850000,2871530,-4978470
55264,2021-06-30,24,Value,9941240,-7850000,2871530,-4978470
55264,2021-08-15,24,Capital Call,-150000,-8000000,2871530,-5128470
55264,2021-08-15,24,Distribution,320470,-8000000,3192000,-4808000
55264,2021-09-30,24,Value,10496800,-8000000,3192000,-4808000
55265,2020-02-15,1314,Capital Call,-302000,-7147999,853011,-6294988
55265,2020-02-15,1314,Distribution,112683,-7147999,965694,-6182305
55265,2020-03-31,1314,Value,8055080,-7147999,965694,-6182305
55265,2020-05-16,1314,Capital Call,-95000,-7242999,965694,-6277305
55265,2020-05-16,1314,Distribution,90335,-7242999,1056029,-6186970
55265,2020-06-30,1314,Value,9016080,-7242999,1056029,-6186970
55265,2020-08-15,1314,Capital Call,-493000,-7735999,1056029,-6679970
55265,2020-08-15,1314,Distribution,33199,-7735999,1089228,-6646771
55265,2020-09-30,1314,Value,10305890,-7735999,1089228,-6646771
55265,2020-11-15,1314,Capital Call,-218000,-7953999,1089228,-6864771
55265,2020-11-15,1314,Distribution,210455,-7953999,1299683,-6654316
55265,2020-12-31,1314,Value,12282560,-7953999,1299683,-6654316
55265,2021-02-14,1314,Capital Call,-125000,-8078999,1299683,-6779316
55265,2021-02-14,1314,Distribution,377517,-8078999,1677200,-6401799
55265,2021-03-31,1314,Value,12886810,-8078999,1677200,-6401799
55265,2021-06-30,1314,Value,14425860,-8078999,1677200,-6401799
55265,2021-08-15,1314,Capital Call,-325000,-8403999,1677200,-6726799
55265,2021-08-15,1314,Distribution,634740,-8403999,2311940,-6092059
55265,2021-09-30,1314,Value,14875080,-8403999,2311940,-6092059
55266,2020-02-15,24,Capital Call,-200000,-8250001,2669308,-5580693
55266,2020-03-31,24,Value,8110240,-8250001,2669308,-5580693
55266,2020-05-16,24,Capital Call,-301000,-8551001,2669308,-5881693
55266,2020-05-16,24,Distribution,115135,-8551001,2784443,-5766558
55266,2020-06-30,24,Value,9471080,-8551001,2784443,-5766558
55266,2020-08-15,24,Capital Call,1000,-8550001,2784443,-5765558
55266,2020-08-15,24,Distribution,35347,-8550001,2819790,-5730211
55266,2020-09-30,24,Value,11197930,-8550001,2819790,-5730211
55266,2020-11-15,24,Capital Call,-150000,-8700001,2819790,-5880211
55266,2020-11-15,24,Distribution,2482598,-8700001,5302388,-3397613
55266,2020-12-31,24,Value,9501380,-8700001,5302388,-3397613
55266,2021-02-14,24,Capital Call,0,-8700001,5302388,-3397613
55266,2021-02-14,24,Distribution,262,-8700001,5302650,-3397351
55266,2021-03-31,24,Value,10603560,-8700001,5302650,-3397351
55266,2021-05-16,24,Distribution,110490,-8700001,5413140,-3286861
55266,2021-06-30,24,Value,11754570,-8700001,5413140,-3286861
55266,2021-08-15,24,Distribution,1588620,-8700001,7001760,-1698241
55266,2021-09-30,24,Value,10998540,-8700001,7001760,-1698241
55301,2020-02-15,14497,Capital Call,0,-9375000,0,-9375000
55301,2020-03-31,14497,Value,6815640,-9375000,0,-9375000
55301,2020-05-16,14497,Capital Call,-212500,-9587500,0,-9587500
55301,2020-06-30,14497,Value,6949750,-9587500,0,-9587500
55301,2020-08-15,14497,Capital Call,-300000,-9887500,0,-9887500
55301,2020-09-30,14497,Value,6803680,-9887500,0,-9887500
55301,2020-12-31,14497,Value,7512560,-9887500,0,-9887500
55301,2021-02-14,14497,Distribution,776000,-9887500,776000,-9111500
55301,2021-03-31,14497,Value,7735990,-9887500,776000,-9111500
55301,2021-06-30,14497,Value,10077910,-9887500,776000,-9111500
55301,2021-08-15,14497,Capital Call,-112500,-10000000,776000,-9224000
55301,2021-09-30,14497,Value,9749970,-10000000,776000,-9224000
55306,2020-01-15,10504,Capital Call,0,-3565398,100000,-3465398
55306,2020-02-29,10504,Value,4873130,-3565398,100000,-3465398
55306,2020-04-15,10504,Capital Call,-370186,-3935584,100000,-3835584
55306,2020-05-31,10504,Value,3244650,-3935584,100000,-3835584
55306,2020-08-31,10504,Value,3936320,-3935584,100000,-3835584
55306,2020-11-30,10504,Value,4013610,-3935584,100000,-3835584
55306,2021-02-28,10504,Value,7185640,-3935584,100000,-3835584
55306,2021-04-15,10504,Distribution,1612332,-3935584,1712332,-2223252
55306,2021-05-31,10504,Value,3173470,-3935584,1712332,-2223252
55306,2021-07-16,10504,Capital Call,-989529,-4925113,1712332,-3212781
55306,2021-07-16,10504,Distribution,742795,-4925113,2455127,-2469986
55306,2021-08-31,10504,Value,5637550,-4925113,2455127,-2469986
55306,2021-10-16,10504,Capital Call,-863823,-5788936,2455127,-3333809
55306,2021-10-16,10504,Distribution,0,-5788936,2455127,-3333809
55306,2021-11-30,10504,Value,5895020,-5788936,2455127,-3333809
55354,2020-03-31,1878,Value,7560000,-7200000,504000,-6696000
55354,2020-05-16,1878,Capital Call,-900000,-8100000,504000,-7596000
55354,2020-05-16,1878,Distribution,-18000,-8100000,486000,-7614000
55354,2020-06-30,1878,Value,8829000,-8100000,486000,-7614000
55354,2020-09-30,1878,Value,9153000,-8100000,486000,-7614000
55354,2020-11-15,1878,Distribution,729000,-8100000,1215000,-6885000
55354,2020-12-31,1878,Value,8991000,-8100000,1215000,-6885000
55354,2021-03-31,1878,Value,10044000,-8100000,1215000,-6885000
55354,2021-05-16,1878,Distribution,729000,-8100000,1944000,-6156000
55354,2021-06-30,1878,Value,10368000,-8100000,1944000,-6156000
55354,2021-09-30,1878,Value,11664000,-8100000,1944000,-6156000
55356,2020-03-31,558,Value,12783330,-9800001,1700000,-8100001
55356,2020-06-30,558,Value,15883330,-9800001,1700000,-8100001
55356,2020-08-15,558,Capital Call,-1850000,-11650001,1700000,-9950001
55356,2020-08-15,558,Distribution,2266667,-11650001,3966667,-7683334
55356,2020-09-30,558,Value,19016660,-11650001,3966667,-7683334
55356,2020-12-31,558,Value,29983330,-11650001,3966667,-7683334
55356,2021-02-14,558,Capital Call,-1066667,-12716668,3966667,-8750001
55356,2021-02-14,558,Distribution,4400000,-12716668,8366667,-4350001
55356,2021-03-31,558,Value,26433330,-12716668,8366667,-4350001
55356,2021-06-30,558,Value,21700000,-12716668,8366667,-4350001
55356,2021-09-30,558,Value,18750000,-12716668,8366667,-4350001
55449,2020-01-15,70992,Distribution,3998761,-5000000,3998761,-1001239
55449,2020-02-29,70992,Value,10157480,-5000000,3998761,-1001239
55449,2020-05-31,70992,Value,9608610,-5000000,3998761,-1001239
55449,2020-08-31,70992,Value,10582770,-5000000,3998761,-1001239
55449,2020-11-30,70992,Value,21027290,-5000000,3998761,-1001239
55449,2021-01-14,70992,Distribution,13797661,-5000000,17796422,12796422
55449,2021-02-28,70992,Value,7227290,-5000000,17796422,12796422
55449,2021-05-31,70992,Value,10293980,-5000000,17796422,12796422
55449,2021-07-16,70992,Capital Call,-750000,-5750000,17796422,12046422
55449,2021-08-31,70992,Value,12255810,-5750000,17796422,12046422
55449,2021-10-16,70992,Distribution,2838000,-5750000,20634422,14884422
55449,2021-11-30,70992,Value,9717000,-5750000,20634422,14884422
55468,2020-11-15,12679,Capital Call,-500000,-9530000,514710,-9015290
55468,2020-11-15,12679,Distribution,3506950,-9530000,4021660,-5508340
55468,2021-09-30,12679,Value,8367340,-9530000,4021660,-5508340
55475,2020-02-15,171187,Capital Call,-440000,-8457114,626818,-7830296
55475,2020-02-15,171187,Distribution,0,-8457114,626818,-7830296
55475,2020-03-31,171187,Value,14982980,-8457114,626818,-7830296
55475,2020-05-16,171187,Capital Call,-500000,-8957114,626818,-8330296
55475,2020-05-16,171187,Distribution,0,-8957114,626818,-8330296
55475,2020-06-30,171187,Value,16655910,-8957114,626818,-8330296
55475,2020-08-15,171187,Capital Call,-220000,-9177114,626818,-8550296
55475,2020-09-30,171187,Value,20454370,-9177114,626818,-8550296
55475,2020-12-31,171187,Value,21995900,-9177114,626818,-8550296
55475,2021-03-31,171187,Value,31445420,-9177114,626818,-8550296
55475,2021-05-16,171187,Distribution,2500000,-9177114,3126818,-6050296
55475,2021-06-30,171187,Value,30645540,-9177114,3126818,-6050296
55475,2021-08-15,171187,Capital Call,-140000,-9317114,3126818,-6190296
55475,2021-09-30,171187,Value,30774030,-9317114,3126818,-6190296
55529,2020-02-15,147,Capital Call,-755556,-7255555,0,-7255555
55529,2020-03-31,147,Value,8131110,-7255555,0,-7255555
55529,2020-05-16,147,Capital Call,-242222,-7497777,0,-7497777
55529,2020-06-30,147,Value,8895550,-7497777,0,-7497777
55529,2020-08-15,147,Capital Call,-320000,-7817777,0,-7817777
55529,2020-09-30,147,Value,11640000,-7817777,0,-7817777
55529,2020-11-15,147,Capital Call,684444,-7133333,0,-7133333
55529,2020-11-15,147,Distribution,1302222,-7133333,1302222,-5831111
55529,2020-12-31,147,Value,11620000,-7133333,1302222,-5831111
55569,2020-02-15,10859,Capital Call,-1173531,-6288886,1030519,-5258367
55569,2020-03-31,10859,Value,6147420,-6288886,1030519,-5258367
55569,2020-06-30,10859,Value,6302380,-6288886,1030519,-5258367
55569,2020-09-30,10859,Value,6917880,-6288886,1030519,-5258367
55569,2020-11-15,10859,Distribution,96000,-6288886,1126519,-5162367
55569,2020-12-31,10859,Value,7541700,-6288886,1126519,-5162367
55569,2021-02-14,10859,Capital Call,-953855,-7242741,1126519,-6116222
55569,2021-03-31,10859,Value,9217270,-7242741,1126519,-6116222
55570,2020-01-15,54294,Capital Call,-600000,-7600000,0,-7600000
55570,2020-02-29,54294,Value,9478100,-7600000,0,-7600000
55570,2020-04-15,54294,Capital Call,0,-7600000,0,-7600000
55570,2020-05-31,54294,Value,9081510,-7600000,0,-7600000
55570,2020-08-31,54294,Value,9459700,-7600000,0,-7600000
55570,2020-10-16,54294,Capital Call,-500000,-8100000,0,-8100000
55570,2020-11-30,54294,Value,10475070,-8100000,0,-8100000
55570,2021-03-01,54294,Capital Call,-900000,-9000000,0,-9000000
55570,2021-05-31,54294,Value,15993340,-9000000,0,-9000000
55570,2021-07-16,54294,Capital Call,-500000,-9500000,0,-9500000
55570,2021-08-31,54294,Value,21179390,-9500000,0,-9500000
55570,2021-10-16,54294,Capital Call,0,-9500000,0,-9500000
55570,2021-11-30,54294,Value,23773760,-9500000,0,-9500000
55663,2020-02-15,673,Capital Call,-90000,-9679998,646021,-9033977
55663,2020-03-31,673,Value,15799680,-9679998,646021,-9033977
55663,2020-05-16,673,Distribution,6398692,-9679998,7044713,-2635285
55663,2020-06-30,673,Value,13880450,-9679998,7044713,-2635285
55663,2020-09-30,673,Value,16856690,-9679998,7044713,-2635285
55663,2020-11-15,673,Distribution,1858416,-9679998,8903129,-776869
55663,2020-12-31,673,Value,16203400,-9679998,8903129,-776869
55663,2021-03-31,673,Value,17966310,-9679998,8903129,-776869
55671,2020-03-31,8117,Value,9600000,-6000000,600000,-5400000
55671,2020-05-16,8117,Capital Call,-500000,-6500000,600000,-5900000
55671,2020-05-16,8117,Distribution,50000,-6500000,650000,-5850000
55671,2020-06-30,8117,Value,10400000,-6500000,650000,-5850000
55671,2020-08-15,8117,Capital Call,-1000000,-7500000,650000,-6850000
55671,2020-08-15,8117,Distribution,625000,-7500000,1275000,-6225000
55671,2020-09-30,8117,Value,12000000,-7500000,1275000,-6225000
55671,2020-11-15,8117,Capital Call,-1300000,-8800000,1275000,-7525000
55671,2020-11-15,8117,Distribution,45000,-8800000,1320000,-7480000
55671,2020-12-31,8117,Value,14520000,-8800000,1320000,-7480000
55671,2021-02-14,8117,Capital Call,-300000,-9100000,1320000,-7780000
55671,2021-02-14,8117,Distribution,45000,-9100000,1365000,-7735000
55671,2021-03-31,8117,Value,15015000,-9100000,1365000,-7735000
55671,2021-06-30,8117,Value,15015000,-9100000,1365000,-7735000
55798,2020-02-15,107175,Capital Call,-500000,-6300000,0,-6300000
55798,2020-03-31,107175,Value,6704170,-6300000,0,-6300000
55798,2020-06-30,107175,Value,7138930,-6300000,0,-6300000
55798,2020-09-30,107175,Value,7777480,-6300000,0,-6300000
55798,2020-11-15,107175,Capital Call,-1000000,-7300000,0,-7300000
55798,2020-12-31,107175,Value,10030310,-7300000,0,-7300000
55798,2021-02-14,107175,Capital Call,-400000,-7700000,0,-7700000
55798,2021-03-31,107175,Value,10550960,-7700000,0,-7700000
55798,2021-05-16,107175,Capital Call,-800000,-8500000,0,-8500000
55798,2021-06-30,107175,Value,12079280,-8500000,0,-8500000
55798,2021-09-30,107175,Value,13878940,-8500000,0,-8500000
55861,2020-03-31,66836,Value,5817040,-6536000,5686319,-849681
55861,2020-05-16,66836,Capital Call,-1658000,-8194000,5686319,-2507681
55861,2020-05-16,66836,Distribution,1442460,-8194000,7128779,-1065221
55861,2020-06-30,66836,Value,8521760,-8194000,7128779,-1065221
55861,2020-09-30,66836,Value,8439820,-8194000,7128779,-1065221
55861,2020-11-15,66836,Distribution,4424760,-8194000,11553539,3359539
55861,2020-12-31,66836,Value,3933120,-8194000,11553539,3359539
55861,2021-03-31,66836,Value,3605360,-8194000,11553539,3359539
55885,2020-02-15,191881,Distribution,26545,-7478212,5005797,-2472415
55885,2020-03-31,191881,Value,6972200,-7478212,5005797,-2472415
55885,2020-05-16,191881,Distribution,11241,-7478212,5017038,-2461174
55885,2020-06-30,191881,Value,7469560,-7478212,5017038,-2461174
55885,2020-08-15,191881,Capital Call,-418793,-7897005,5017038,-2879967
55885,2020-08-15,191881,Distribution,549115,-7897005,5566153,-2330852
55885,2020-09-30,191881,Value,9145800,-7897005,5566153,-2330852
55885,2020-12-31,191881,Value,9743960,-7897005,5566153,-2330852
55904,2020-02-15,20278,Capital Call,-200000,-1180000,0,-1180000
55904,2020-03-31,20278,Value,896800,-1180000,0,-1180000
55904,2020-05-16,20278,Capital Call,-128000,-1308000,0,-1308000
55904,2020-06-30,20278,Value,928680,-1308000,0,-1308000
55904,2020-08-15,20278,Capital Call,-104000,-1412000,0,-1412000
55904,2020-09-30,20278,Value,971310,-1412000,0,-1412000
55904,2020-11-15,20278,Capital Call,-161000,-1573000,0,-1573000
55904,2020-12-31,20278,Value,1148290,-1573000,0,-1573000
55904,2021-02-14,20278,Capital Call,-302000,-1875000,0,-1875000
55904,2021-03-31,20278,Value,1387500,-1875000,0,-1875000
55904,2021-05-16,20278,Capital Call,-425000,-2300000,0,-2300000
55904,2021-06-30,20278,Value,1771000,-2300000,0,-2300000
55929,2020-02-15,70,Capital Call,-1084260,-8806533,3015726,-5790807
55929,2020-02-15,70,Distribution,115678,-8806533,3131404,-5675129
55929,2020-03-31,70,Value,7998500,-8806533,3131404,-5675129
55929,2020-06-30,70,Value,8447170,-8806533,3131404,-5675129
55929,2020-09-30,70,Value,9326030,-8806533,3131404,-5675129
55929,2020-11-15,70,Capital Call,-76191,-8882724,3131404,-5751320
55929,2020-11-15,70,Distribution,1199446,-8882724,4330850,-4551874
55929,2020-12-31,70,Value,9349620,-8882724,4330850,-4551874
55929,2021-02-14,70,Capital Call,-4677,-8887401,4330850,-4556551
55929,2021-02-14,70,Distribution,1331524,-8887401,5662374,-3225027
55929,2021-03-31,70,Value,9018960,-8887401,5662374,-3225027
55929,2021-05-16,70,Capital Call,-45958,-8933359,5662374,-3270985
55929,2021-05-16,70,Distribution,1145011,-8933359,6807385,-2125974
55929,2021-06-30,70,Value,8700280,-8933359,6807385,-2125974
55961,2020-03-31,148681,Value,9149210,-7125000,35625,-7089375
55961,2020-06-30,148681,Value,9538950,-7125000,35625,-7089375
55961,2020-09-30,148681,Value,10329110,-7125000,35625,-7089375
55961,2020-11-15,148681,Capital Call,-234000,-7359000,35625,-7323375
55961,2020-11-15,148681,Distribution,1906,-7359000,37531,-7321469
55961,2020-12-31,148681,Value,10777250,-7359000,37531,-7321469
55961,2021-03-31,148681,Value,10379130,-7359000,37531,-7321469
55961,2021-05-16,148681,Capital Call,-5000,-7364000,37531,-7326469
55961,2021-05-16,148681,Distribution,26536,-7364000,64067,-7299933
55961,2021-06-30,148681,Value,10119600,-7364000,64067,-7299933
55961,2021-08-15,148681,Capital Call,-985000,-8349000,64067,-8284933
55961,2021-08-15,148681,Distribution,579641,-8349000,643708,-7705292
55961,2021-09-30,148681,Value,10544780,-8349000,643708,-7705292
55961,2021-12-31,148681,Value,11270310,-8349000,643708,-7705292
55971,2020-03-31,10869,Value,9420600,-9500000,2172200,-7327800
55971,2020-06-30,10869,Value,10257600,-9500000,2172200,-7327800
55971,2020-09-30,10869,Value,11509800,-9500000,2172200,-7327800
55971,2020-11-15,10869,Capital Call,-200000,-9700000,2172200,-7527800
55971,2020-12-31,10869,Value,12667200,-9700000,2172200,-7527800
55971,2021-03-31,10869,Value,13600400,-9700000,2172200,-7527800
55971,2021-06-30,10869,Value,15537400,-9700000,2172200,-7527800
55975,2020-03-31,132289,Value,8690630,-9893655,0,-9893655
55975,2020-06-30,132289,Value,8666210,-9893655,0,-9893655
55975,2020-12-31,132289,Value,6992050,-9893655,0,-9893655
55975,2021-03-31,132289,Value,6877500,-9893655,0,-9893655
55975,2021-06-30,132289,Value,6872220,-9893655,0,-9893655
55998,2020-03-31,1360,Value,13018400,-10562732,0,-10562732
55998,2020-06-30,1360,Value,15119920,-10562732,0,-10562732
55998,2020-09-30,1360,Value,16780080,-10562732,0,-10562732
56020,2020-03-31,6923,Value,8883860,-7770290,0,-7770290
56020,2020-05-16,6923,Capital Call,-561604,-8331894,0,-8331894
56020,2020-06-30,6923,Value,10110750,-8331894,0,-8331894
56020,2020-09-30,6923,Value,10446010,-8331894,0,-8331894
56020,2020-11-15,6923,Capital Call,-429050,-8760944,0,-8760944
56020,2020-11-15,6923,Distribution,283195,-8760944,283195,-8477749
56020,2020-12-31,6923,Value,11680210,-8760944,283195,-8477749
56020,2021-03-31,6923,Value,12118700,-8760944,283195,-8477749
56021,2020-05-16,6923,Capital Call,-145263,-6543109,1914088,-4629021
56021,2020-05-16,6923,Distribution,45,-6543109,1914133,-4628976
56021,2020-09-30,6923,Value,6012770,-6543109,1914133,-4628976
56021,2020-11-15,6923,Capital Call,-1853306,-8396415,1914133,-6482282
56021,2020-11-15,6923,Distribution,60,-8396415,1914193,-6482222
56021,2020-12-31,6923,Value,8144650,-8396415,1914193,-6482222
56021,2021-04-01,6923,Capital Call,414,-8396001,1914193,-6481808
56021,2021-04-01,6923,Distribution,801912,-8396001,2716105,-5679896
56021,2021-06-30,6923,Value,7879640,-8396001,2716105,-5679896
56088,2020-03-31,454,Capital Call,-906042,-8474896,89582,-8385314
56088,2020-06-30,454,Value,11378020,-8474896,89582,-8385314
56088,2020-08-15,454,Capital Call,-540104,-9015000,89582,-8925418
56088,2020-08-15,454,Distribution,7779,-9015000,97361,-8917639
56088,2020-09-30,454,Value,13736150,-9015000,97361,-8917639
56088,2020-11-15,454,Capital Call,8542,-9006458,97361,-8909097
56088,2020-11-15,454,Distribution,939096,-9006458,1036457,-7970001
56088,2020-12-31,454,Value,15718950,-9006458,1036457,-7970001
56088,2021-04-01,454,Capital Call,-4375,-9010833,1036457,-7974376
56088,2021-04-01,454,Distribution,1407604,-9010833,2444061,-6566772
56088,2021-06-30,454,Value,19411450,-9010833,2444061,-6566772
56088,2021-08-15,454,Capital Call,5521,-9005312,2444061,-6561251
56088,2021-08-15,454,Distribution,2491354,-9005312,4935415,-4069897
56088,2021-09-30,454,Value,18208330,-9005312,4935415,-4069897
56143,2020-03-31,451,Value,7864150,-7084973,1245680,-5839293
56143,2020-05-16,451,Capital Call,-2532355,-9617328,1245680,-8371648
56143,2020-05-16,451,Distribution,1706957,-9617328,2952637,-6664691
56143,2020-06-30,451,Value,8855160,-9617328,2952637,-6664691
56143,2020-08-15,451,Capital Call,-141577,-9758905,2952637,-6806268
56143,2020-08-15,451,Distribution,952589,-9758905,3905226,-5853679
56143,2020-09-30,451,Value,8875090,-9758905,3905226,-5853679
56143,2020-11-15,451,Capital Call,-83568,-9842473,3905226,-5937247
56143,2020-11-15,451,Distribution,1146762,-9842473,5051988,-4790485
56143,2020-12-31,451,Value,7737980,-9842473,5051988,-4790485
56143,2021-02-14,451,Capital Call,-54895,-9897368,5051988,-4845380
56143,2021-02-14,451,Distribution,267486,-9897368,5319474,-4577894
56143,2021-03-31,451,Value,8576980,-9897368,5319474,-4577894
56143,2021-05-16,451,Capital Call,-86789,-9984157,5319474,-4664683
56143,2021-05-16,451,Distribution,667178,-9984157,5986652,-3997505
56143,2021-06-30,451,Value,9067610,-9984157,5986652,-3997505
56143,2021-08-15,451,Capital Call,-106127,-10090284,5986652,-4103632
56143,2021-08-15,451,Distribution,977166,-10090284,6963818,-3126466
56143,2021-09-30,451,Value,8090580,-10090284,6963818,-3126466
56181,2020-02-15,8649,Capital Call,-422000,-9064000,2182104,-6881896
56181,2020-02-15,8649,Distribution,506,-9064000,2182610,-6881390
56181,2020-03-31,8649,Value,9903320,-9064000,2182610,-6881390
56181,2020-06-30,8649,Value,10883140,-9064000,2182610,-6881390
56181,2020-08-15,8649,Capital Call,-508000,-9572000,2182610,-7389390
56181,2020-08-15,8649,Distribution,310895,-9572000,2493505,-7078495
56181,2020-09-30,8649,Value,11741010,-9572000,2493505,-7078495
56222,2020-02-15,6330,Capital Call,-400000,-18657753,0,-18657753
56222,2020-03-31,6330,Value,24195380,-18657753,0,-18657753
56222,2020-06-30,6330,Value,24499460,-18657753,0,-18657753
56222,2020-09-30,6330,Value,24569330,-18657753,0,-18657753
56222,2020-12-31,6330,Value,24004120,-18657753,0,-18657753
56222,2021-02-14,6330,Capital Call,-950000,-19607753,0,-19607753
56222,2021-03-31,6330,Value,30050570,-19607753,0,-19607753
56222,2021-05-16,6330,Capital Call,-300000,-19907753,0,-19907753
56222,2021-06-30,6330,Value,31998000,-19907753,0,-19907753
56222,2021-08-15,6330,Distribution,1988024,-19907753,1988024,-17919729
56222,2021-09-30,6330,Value,32971440,-19907753,1988024,-17919729
56230,2020-02-15,18619,Capital Call,-65885,-6466419,1997503,-4468916
56230,2020-02-15,18619,Distribution,281587,-6466419,2279090,-4187329
56230,2020-03-31,18619,Value,6886180,-6466419,2279090,-4187329
56230,2020-05-16,18619,Capital Call,-2899,-6469318,2279090,-4190228
56230,2020-05-16,18619,Distribution,75000,-6469318,2354090,-4115228
56230,2020-06-30,18619,Value,7003890,-6469318,2354090,-4115228
56230,2020-08-15,18619,Capital Call,-145648,-6614966,2354090,-4260876
56230,2020-08-15,18619,Distribution,358828,-6614966,2712918,-3902048
56230,2020-09-30,18619,Value,5698410,-6614966,2712918,-3902048
56230,2020-11-15,18619,Capital Call,-239882,-6854848,2712918,-4141930
56230,2020-11-15,18619,Distribution,550963,-6854848,3263881,-3590967
56230,2020-12-31,18619,Value,5356220,-6854848,3263881,-3590967
56230,2021-02-14,18619,Capital Call,-139432,-6994280,3263881,-3730399
56230,2021-02-14,18619,Distribution,623600,-6994280,3887481,-3106799
56230,2021-03-31,18619,Value,6109850,-6994280,3887481,-3106799
56230,2021-05-16,18619,Capital Call,-100000,-7094280,3887481,-3206799
56230,2021-05-16,18619,Distribution,700666,-7094280,4588147,-2506133
56230,2021-06-30,18619,Value,6582750,-7094280,4588147,-2506133
56230,2021-08-15,18619,Capital Call,-21991,-7116271,4588147,-2528124
56230,2021-08-15,18619,Distribution,522283,-7116271,5110430,-2005841
56230,2021-09-30,18619,Value,7512260,-7116271,5110430,-2005841
56285,2020-02-15,174125,Capital Call,-50690,-5118668,101353,-5017315
56285,2020-02-15,174125,Distribution,9414,-5118668,110767,-5007901
56285,2020-03-31,174125,Value,4240100,-5118668,110767,-5007901
56285,2020-05-16,174125,Capital Call,-345189,-5463857,110767,-5353090
56285,2020-05-16,174125,Distribution,16537,-5463857,127304,-5336553
56285,2020-06-30,174125,Value,5172630,-5463857,127304,-5336553
56285,2020-08-15,174125,Capital Call,-178066,-5641923,127304,-5514619
56285,2020-08-15,174125,Distribution,9655,-5641923,136959,-5504964
56285,2020-09-30,174125,Value,5956310,-5641923,136959,-5504964
56285,2020-11-15,174125,Capital Call,-261613,-5903536,136959,-5766577
56285,2020-11-15,174125,Distribution,29228,-5903536,166187,-5737349
56285,2020-12-31,174125,Value,6918050,-5903536,166187,-5737349
56285,2021-02-14,174125,Capital Call,-53735,-5957271,166187,-5791084
56285,2021-02-14,174125,Distribution,161436,-5957271,327623,-5629648
56285,2021-03-31,174125,Value,7297680,-5957271,327623,-5629648
56285,2021-05-16,174125,Capital Call,-59345,-6016616,327623,-5688993
56285,2021-05-16,174125,Distribution,22343,-6016616,349966,-5666650
56285,2021-06-30,174125,Value,7652130,-6016616,349966,-5666650
56353,2020-03-31,801,Value,3074380,-3421871,0,-3421871
56353,2020-06-30,801,Value,2882180,-3421871,0,-3421871
56353,2020-08-15,801,Capital Call,-647568,-4069439,0,-4069439
56353,2020-09-30,801,Value,3764820,-4069439,0,-4069439
56353,2020-11-15,801,Capital Call,-752626,-4822065,0,-4822065
56353,2020-12-31,801,Value,4921400,-4822065,0,-4822065
56353,2021-02-14,801,Capital Call,-1088875,-5910940,0,-5910940
56353,2021-03-31,801,Value,6584110,-5910940,0,-5910940
56353,2021-05-16,801,Capital Call,-650440,-6561380,0,-6561380
56353,2021-06-30,801,Value,8212670,-6561380,0,-6561380
56353,2021-08-15,801,Capital Call,-1186106,-7747486,0,-7747486
56353,2021-09-30,801,Value,10275400,-7747486,0,-7747486
56391,2020-02-15,741,Capital Call,-87,-9221999,0,-9221999
56391,2020-03-31,741,Value,10955730,-9221999,0,-9221999
56391,2020-06-30,741,Value,11628940,-9221999,0,-9221999
56391,2020-08-15,741,Capital Call,-58000,-9279999,0,-9279999
56391,2020-09-30,741,Value,13298240,-9279999,0,-9279999
56391,2020-11-15,741,Capital Call,3460,-9276539,0,-9276539
56391,2020-12-31,741,Value,14164850,-9276539,0,-9276539
56391,2021-02-14,741,Capital Call,-460,-9276999,0,-9276999
56391,2021-03-31,741,Value,15559380,-9276999,0,-9276999
56391,2021-06-30,741,Value,17227380,-9276999,0,-9276999
56391,2021-09-30,741,Value,17821110,-9276999,0,-9276999
56466,2020-03-31,459,Capital Call,-2743000,-6280000,0,-6280000
56466,2020-03-31,459,Distribution,1399184,-6280000,1399184,-4880816
56466,2020-12-31,459,Value,7922840,-6280000,1399184,-4880816
56466,2021-02-14,459,Capital Call,-151000,-6431000,1399184,-5031816
56466,2021-02-14,459,Distribution,305674,-6431000,1704858,-4726142
56466,2021-03-31,459,Value,9092790,-6431000,1704858,-4726142
56466,2021-05-16,459,Capital Call,-354000,-6785000,1704858,-5080142
56466,2021-05-16,459,Distribution,770988,-6785000,2475846,-4309154
56466,2021-06-30,459,Value,9993620,-6785000,2475846,-4309154
56466,2021-09-30,459,Capital Call,-452000,-7237000,2475846,-4761154
56466,2021-09-30,459,Distribution,2459788,-7237000,4935634,-2301366
56466,2021-12-31,459,Value,8924660,-7237000,4935634,-2301366
56507,2020-03-31,8661,Value,9262800,-9000000,10747799,1747799
56507,2020-06-30,8661,Value,9920700,-9000000,10747799,1747799
56507,2020-08-15,8661,Capital Call,-150000,-9150000,10747799,1597799
56507,2020-08-15,8661,Distribution,1257000,-9150000,12004799,2854799
56507,2020-09-30,8661,Value,9332080,-9150000,12004799,2854799
56507,2020-12-31,8661,Value,10758570,-9150000,12004799,2854799
56507,2021-06-30,8661,Value,11040390,-9150000,12004799,2854799
56507,2021-08-15,8661,Distribution,2618730,-9150000,14623529,5473529
56507,2021-09-30,8661,Value,8971570,-9150000,14623529,5473529
56507,2021-11-15,8661,Capital Call,-75000,-9225000,14623529,5398529
56507,2021-11-15,8661,Distribution,-60,-9225000,14623469,5398469
56507,2021-12-31,8661,Value,9420570,-9225000,14623469,5398469
56529,2020-03-31,2102,Value,10646660,-8419000,1006070,-7412930
56529,2020-05-16,2102,Capital Call,-367,-8419367,1006070,-7413297
56529,2020-05-16,2102,Distribution,182,-8419367,1006252,-7413115
56529,2020-06-30,2102,Value,12225050,-8419367,1006252,-7413115
56529,2020-12-31,2102,Value,13218630,-8419367,1006252,-7413115
56529,2021-02-14,2102,Capital Call,-510633,-8930000,1006252,-7923748
56529,2021-02-14,2102,Distribution,4878,-8930000,1011130,-7918870
56529,2021-03-31,2102,Value,13480930,-8930000,1011130,-7918870
56530,2020-03-31,2102,Value,12439000,-10000000,1092000,-8908000
56530,2020-05-16,2102,Distribution,177,-10000000,1092177,-8907823
56530,2020-06-30,2102,Value,13990000,-10000000,1092177,-8907823
56530,2020-09-30,2102,Distribution,1477208,-10000000,2569385,-7430615
56530,2020-12-31,2102,Value,13288660,-10000000,2569385,-7430615
56530,2021-03-31,2102,Value,12578780,-10000000,2569385,-7430615
56530,2021-06-30,2102,Value,14238740,-10000000,2569385,-7430615
56566,2020-03-31,1357,Value,13024730,-9400000,4097500,-5302500
56566,2020-05-16,1357,Distribution,1668125,-9400000,5765625,-3634375
56566,2020-06-30,1357,Value,13121090,-9400000,5765625,-3634375
56566,2020-08-15,1357,Distribution,700000,-9400000,6465625,-2934375
56566,2020-09-30,1357,Value,15010520,-9400000,6465625,-2934375
56566,2020-11-15,1357,Distribution,6875,-9400000,6472500,-2927500
56566,2020-12-31,1357,Value,14310520,-9400000,6472500,-2927500
56566,2021-02-14,1357,Distribution,2700000,-9400000,9172500,-227500
56566,2021-03-31,1357,Value,11803840,-9400000,9172500,-227500
56566,2021-05-16,1357,Distribution,7800000,-9400000,16972500,7572500
56566,2021-06-30,1357,Value,7457320,-9400000,16972500,7572500
56566,2021-08-15,1357,Distribution,425000,-9400000,17397500,7997500
56566,2021-09-30,1357,Value,7457320,-9400000,17397500,7997500
56592,2020-02-15,12475,Capital Call,-689600,-7535231,0,-7535231
56592,2020-03-31,12475,Value,9043880,-7535231,0,-7535231
56592,2020-05-16,12475,Capital Call,-379181,-7914412,0,-7914412
56592,2020-05-16,12475,Distribution,436631,-7914412,436631,-7477781
56592,2020-06-30,12475,Value,9709370,-7914412,436631,-7477781
56592,2020-08-15,12475,Capital Call,-736457,-8650869,436631,-8214238
56592,2020-08-15,12475,Distribution,3031028,-8650869,3467659,-5183210
56592,2020-09-30,12475,Value,10071370,-8650869,3467659,-5183210
56592,2020-11-15,12475,Capital Call,-323810,-8974679,3467659,-5507020
56592,2020-11-15,12475,Distribution,454615,-8974679,3922274,-5052405
56592,2020-12-31,12475,Value,10105860,-8974679,3922274,-5052405
56643,2020-03-31,52659,Value,5576000,-6800000,340000,-6460000
56643,2020-06-30,52659,Value,6460000,-6800000,340000,-6460000
56643,2020-08-15,52659,Capital Call,-300000,-7100000,340000,-6760000
56643,2020-08-15,52659,Distribution,15000,-7100000,355000,-6745000
56643,2020-09-30,52659,Value,7597000,-7100000,355000,-6745000
56643,2020-11-15,52659,Capital Call,-100000,-7200000,355000,-6845000
56643,2020-11-15,52659,Distribution,5000,-7200000,360000,-6840000
56643,2020-12-31,52659,Value,7992000,-7200000,360000,-6840000
56643,2021-02-14,52659,Distribution,72000,-7200000,432000,-6768000
56643,2021-03-31,52659,Value,7848000,-7200000,432000,-6768000
56643,2021-05-16,52659,Capital Call,-770000,-7970000,432000,-7538000
56643,2021-05-16,52659,Distribution,-33500,-7970000,398500,-7571500
56643,2021-06-30,52659,Value,9165500,-7970000,398500,-7571500
56643,2021-08-15,52659,Capital Call,-30000,-8000000,398500,-7601500
56643,2021-08-15,52659,Distribution,561500,-8000000,960000,-7040000
56643,2021-09-30,52659,Value,8800000,-8000000,960000,-7040000
56643,2021-11-15,52659,Capital Call,-100000,-8100000,960000,-7140000
56643,2021-11-15,52659,Distribution,255000,-8100000,1215000,-6885000
56643,2021-12-31,52659,Value,9720000,-8100000,1215000,-6885000
56652,2020-02-15,579,Capital Call,-397486,-7667977,1056853,-6611124
56652,2020-02-15,579,Distribution,33664,-7667977,1090517,-6577460
56652,2020-03-31,579,Value,9388970,-7667977,1090517,-6577460
56652,2020-05-16,579,Capital Call,-252023,-7920000,1090517,-6829483
56652,2020-05-16,579,Distribution,2442,-7920000,1092959,-6827041
56652,2020-06-30,579,Value,10858320,-7920000,1092959,-6827041
56652,2020-12-30,579,Capital Call,-997000,-8917000,1092959,-7824041
56652,2020-12-30,579,Distribution,1953087,-8917000,3046046,-5870954
56652,2021-06-30,579,Value,16638230,-8917000,3046046,-5870954
56652,2021-08-15,579,Capital Call,-195000,-9112000,3046046,-6065954
56652,2021-08-15,579,Distribution,860267,-9112000,3906313,-5205687
56652,2021-09-30,579,Value,17055840,-9112000,3906313,-5205687
56684,2020-02-15,11324,Capital Call,-136200,-8252400,6800,-8245600
56684,2020-02-15,11324,Distribution,1480600,-8252400,1487400,-6765000
56684,2020-03-31,11324,Value,9339400,-8252400,1487400,-6765000
56684,2020-05-16,11324,Distribution,15000,-8252400,1502400,-6750000
56684,2020-06-30,11324,Value,10632800,-8252400,1502400,-6750000
56684,2020-08-15,11324,Capital Call,-108000,-8360400,1502400,-6858000
56684,2020-08-15,11324,Distribution,1120400,-8360400,2622800,-5737600
56684,2020-09-30,11324,Value,10283400,-8360400,2622800,-5737600
56743,2020-02-15,668,Capital Call,-56695,-7969523,562581,-7406942
56743,2020-02-15,668,Distribution,4195,-7969523,566776,-7402747
56743,2020-03-31,668,Value,8904220,-7969523,566776,-7402747
56743,2020-05-16,668,Capital Call,-64370,-8033893,566776,-7467117
56743,2020-05-16,668,Distribution,4243,-8033893,571019,-7462874
56743,2020-06-30,668,Value,8964350,-8033893,571019,-7462874
56743,2020-08-15,668,Capital Call,-55494,-8089387,571019,-7518368
56743,2020-08-15,668,Distribution,14857,-8089387,585876,-7503511
56743,2020-09-30,668,Value,10510350,-8089387,585876,-7503511
56743,2020-11-15,668,Capital Call,-62888,-8152275,585876,-7566399
56743,2020-11-15,668,Distribution,59595,-8152275,645471,-7506804
56743,2020-12-31,668,Value,11894000,-8152275,645471,-7506804
56743,2021-02-14,668,Capital Call,-52500,-8204775,645471,-7559304
56743,2021-02-14,668,Distribution,295811,-8204775,941282,-7263493
56743,2021-03-31,668,Value,12980890,-8204775,941282,-7263493
56756,2020-02-15,61739,Capital Call,28068,-9054181,0,-9054181
56756,2020-03-31,61739,Value,10253030,-9054181,0,-9054181
56756,2020-05-16,61739,Capital Call,-353985,-9408166,0,-9408166
56756,2020-05-16,61739,Distribution,82811,-9408166,82811,-9325355
56756,2020-06-30,61739,Value,10856660,-9408166,82811,-9325355
56756,2020-08-15,61739,Capital Call,-6249,-9414415,82811,-9331604
56756,2020-08-15,61739,Distribution,35484,-9414415,118295,-9296120
56756,2020-09-30,61739,Value,11025420,-9414415,118295,-9296120
56864,2020-03-31,49,Value,12703060,-9246468,262961,-8983507
56864,2020-06-30,49,Value,11152480,-9246468,262961,-8983507
56864,2020-09-30,49,Value,13305770,-9246468,262961,-8983507
56864,2020-11-15,49,Capital Call,-610863,-9857331,262961,-9594370
56864,2020-11-15,49,Distribution,418918,-9857331,681879,-9175452
56864,2020-12-31,49,Value,14751040,-9857331,681879,-9175452
56864,2021-02-14,49,Capital Call,-105727,-9963058,681879,-9281179
56864,2021-02-14,49,Distribution,2523775,-9963058,3205654,-6757404
56864,2021-03-31,49,Value,15002570,-9963058,3205654,-6757404
56864,2021-05-16,49,Distribution,761063,-9963058,3966717,-5996341
56864,2021-06-30,49,Value,15967530,-9963058,3966717,-5996341
56864,2021-08-15,49,Capital Call,-51805,-10014863,3966717,-6048146
56864,2021-08-15,49,Distribution,1918453,-10014863,5885170,-4129693
56864,2021-09-30,49,Value,15791670,-10014863,5885170,-4129693
56886,2020-02-15,14363,Capital Call,-320797,-6896996,2489195,-4407801
56886,2020-03-31,14363,Value,6441040,-6896996,2489195,-4407801
56886,2020-06-30,14363,Value,6424510,-6896996,2489195,-4407801
56886,2020-08-15,14363,Capital Call,-1089216,-7986212,2489195,-5497017
56886,2020-09-30,14363,Value,7741420,-7986212,2489195,-5497017
56886,2020-11-15,14363,Capital Call,-403950,-8390162,2489195,-5900967
56886,2020-12-31,14363,Value,8649650,-8390162,2489195,-5900967
56886,2021-02-14,14363,Capital Call,-401225,-8791387,2489195,-6302192
56886,2021-03-31,14363,Value,8951930,-8791387,2489195,-6302192
56886,2021-05-16,14363,Capital Call,670725,-8120662,2489195,-5631467
56886,2021-05-16,14363,Distribution,934727,-8120662,3423922,-4696740
56886,2021-06-30,14363,Value,8267350,-8120662,3423922,-4696740
56886,2021-08-15,14363,Capital Call,-916945,-9037607,3423922,-5613685
56886,2021-09-30,14363,Value,10662200,-9037607,3423922,-5613685
56903,2020-03-31,1642,Value,12292970,-7725000,0,-7725000
56903,2020-05-16,1642,Capital Call,-400000,-8125000,0,-8125000
56903,2020-06-30,1642,Value,14229260,-8125000,0,-8125000
56903,2020-09-30,1642,Value,14758930,-8125000,0,-8125000
56903,2020-11-15,1642,Capital Call,-200000,-8325000,0,-8325000
56903,2020-12-31,1642,Value,17671840,-8325000,0,-8325000
56903,2021-02-14,1642,Capital Call,-250000,-8575000,0,-8575000
56903,2021-03-31,1642,Value,27535840,-8575000,0,-8575000
56903,2021-05-16,1642,Distribution,4600958,-8575000,4600958,-3974042
56903,2021-06-30,1642,Value,28795430,-8575000,4600958,-3974042
56906,2020-02-15,545,Capital Call,-1150448,-4086832,0,-4086832
56906,2020-03-31,545,Value,4988870,-4086832,0,-4086832
56906,2020-05-16,545,Capital Call,-1808021,-5894853,0,-5894853
56906,2020-05-16,545,Distribution,278586,-5894853,278586,-5616267
56906,2020-06-30,545,Value,6481130,-5894853,278586,-5616267
56906,2020-09-30,545,Value,7806550,-5894853,278586,-5616267
56906,2020-11-15,545,Capital Call,-1387809,-7282662,278586,-7004076
56906,2020-11-15,545,Distribution,0,-7282662,278586,-7004076
56906,2020-12-31,545,Value,10157120,-7282662,278586,-7004076
56906,2021-02-14,545,Capital Call,0,-7282662,278586,-7004076
56906,2021-02-14,545,Distribution,254820,-7282662,533406,-6749256
56906,2021-03-31,545,Value,11278780,-7282662,533406,-6749256
56906,2021-05-16,545,Capital Call,-472726,-7755388,533406,-7221982
56906,2021-06-30,545,Value,12950320,-7755388,533406,-7221982
56906,2021-08-15,545,Capital Call,-635310,-8390698,533406,-7857292
56906,2021-09-30,545,Value,15791990,-8390698,533406,-7857292
56925,2020-02-15,1632,Capital Call,-364000,-10109000,427804,-9681196
56925,2020-02-15,1632,Distribution,204007,-10109000,631811,-9477189
56925,2020-03-31,1632,Value,13013310,-10109000,631811,-9477189
56925,2020-06-30,1632,Value,14085880,-10109000,631811,-9477189
56925,2020-08-15,1632,Capital Call,-124000,-10233000,631811,-9601189
56925,2020-08-15,1632,Distribution,587,-10233000,632398,-9600602
56925,2020-09-30,1632,Value,15551090,-10233000,632398,-9600602
56925,2020-11-15,1632,Capital Call,-44000,-10277000,632398,-9644602
56925,2020-11-15,1632,Distribution,1991319,-10277000,2623717,-7653283
56925,2020-12-31,1632,Value,14866700,-10277000,2623717,-7653283
56925,2021-02-14,1632,Capital Call,-587000,-10864000,2623717,-8240283
56925,2021-02-14,1632,Distribution,5370,-10864000,2629087,-8234913
56925,2021-03-31,1632,Value,15804940,-10864000,2629087,-8234913
56925,2021-06-30,1632,Value,16783790,-10864000,2629087,-8234913
56925,2021-08-15,1632,Capital Call,26000,-10838000,2629087,-8208913
56925,2021-08-15,1632,Distribution,321016,-10838000,2950103,-7887897
56925,2021-09-30,1632,Value,17040580,-10838000,2950103,-7887897
56934,2020-02-15,176342,Capital Call,-2520000,-11930000,2841820,-9088180
56934,2020-02-15,176342,Distribution,808760,-11930000,3650580,-8279420
56934,2020-03-31,176342,Value,9663300,-11930000,3650580,-8279420
56934,2020-05-16,176342,Capital Call,-330000,-12260000,3650580,-8609420
56934,2020-05-16,176342,Distribution,15160,-12260000,3665740,-8594260
56934,2020-06-30,176342,Value,10286140,-12260000,3665740,-8594260
56934,2020-08-15,176342,Capital Call,-150000,-12410000,3665740,-8744260
56934,2020-08-15,176342,Distribution,2402750,-12410000,6068490,-6341510
56934,2020-09-30,176342,Value,8385430,-12410000,6068490,-6341510
56934,2020-12-31,176342,Value,9689720,-12410000,6068490,-6341510
56934,2021-04-01,176342,Capital Call,-400000,-12810000,6068490,-6741510
56934,2021-04-01,176342,Distribution,925770,-12810000,6994260,-5815740
56934,2021-06-30,176342,Value,10424770,-12810000,6994260,-5815740
56937,2020-02-15,355,Distribution,272137,-7200000,2879025,-4320975
56937,2020-03-31,355,Value,7204420,-7200000,2879025,-4320975
56937,2020-05-16,355,Capital Call,-500000,-7700000,2879025,-4820975
56937,2020-05-16,355,Distribution,-652602,-7700000,2226423,-5473577
56937,2020-06-30,355,Value,1143440,-7700000,2226423,-5473577
56937,2020-08-15,355,Capital Call,-200000,-7900000,2226423,-5673577
56937,2020-08-15,355,Distribution,966606,-7900000,3193029,-4706971
56937,2020-09-30,355,Value,7793470,-7900000,3193029,-4706971
56937,2020-11-15,355,Capital Call,-100000,-8000000,3193029,-4806971
56937,2020-11-15,355,Distribution,732486,-8000000,3925515,-4074485
56937,2020-12-31,355,Value,7730810,-8000000,3925515,-4074485
56937,2021-02-14,355,Distribution,837346,-8000000,4762861,-3237139
56937,2021-03-31,355,Value,6893460,-8000000,4762861,-3237139
56937,2021-05-16,355,Distribution,460540,-8000000,5223401,-2776599
56937,2021-06-30,355,Value,8308030,-8000000,5223401,-2776599
56945,2020-02-15,1632,Distribution,-4540,-11350000,9148100,-2201900
56945,2020-03-31,1632,Value,12320420,-11350000,9148100,-2201900
56945,2020-05-16,1632,Distribution,4540,-11350000,9152640,-2197360
56945,2020-06-30,1632,Value,14447410,-11350000,9152640,-2197360
56945,2020-09-30,1632,Value,15939940,-11350000,9152640,-2197360
56945,2020-12-31,1632,Value,19419850,-11350000,9152640,-2197360
56945,2021-02-14,1632,Distribution,873950,-11350000,10026590,-1323410
56945,2021-03-31,1632,Value,21356160,-11350000,10026590,-1323410
56945,2021-05-16,1632,Distribution,1032850,-11350000,11059440,-290560
56945,2021-06-30,1632,Value,22603520,-11350000,11059440,-290560
56945,2021-09-30,1632,Value,23914450,-11350000,11059440,-290560
57015,2020-02-15,58213,Capital Call,-494948,-5452720,119469,-5333251
57015,2020-03-31,58213,Value,4806100,-5452720,119469,-5333251
57015,2020-05-16,58213,Capital Call,0,-5452720,119469,-5333251
57015,2020-06-30,58213,Value,5251130,-5452720,119469,-5333251
57044,2020-01-15,71149,Capital Call,-94813,-7016407,17664,-6998743
57044,2020-01-15,71149,Distribution,0,-7016407,17664,-6998743
57044,2020-02-29,71149,Value,7867870,-7016407,17664,-6998743
57044,2020-04-15,71149,Capital Call,0,-7016407,17664,-6998743
57044,2020-04-15,71149,Distribution,0,-7016407,17664,-6998743
57044,2020-05-31,71149,Value,5824130,-7016407,17664,-6998743
57044,2020-07-16,71149,Capital Call,-113976,-7130383,17664,-7112719
57044,2020-08-31,71149,Value,6075490,-7130383,17664,-7112719
57044,2020-10-16,71149,Capital Call,-513650,-7644033,17664,-7626369
57044,2020-11-30,71149,Value,6682760,-7644033,17664,-7626369
57044,2021-01-14,71149,Capital Call,-862500,-8506533,17664,-8488869
57044,2021-02-28,71149,Value,8799840,-8506533,17664,-8488869
57044,2021-04-15,71149,Capital Call,-607701,-9114234,17664,-9096570
57044,2021-05-31,71149,Value,9360370,-9114234,17664,-9096570
57044,2021-08-31,71149,Value,9104510,-9114234,17664,-9096570
57044,2021-10-16,71149,Capital Call,-197049,-9311283,17664,-9293619
57044,2021-10-16,71149,Distribution,0,-9311283,17664,-9293619
57044,2021-11-30,71149,Value,9400490,-9311283,17664,-9293619
57059,2020-02-15,589,Capital Call,-1200000,-9000000,0,-9000000
57059,2020-03-31,589,Value,10800000,-9000000,0,-9000000
57059,2020-07-01,589,Distribution,1440000,-9000000,1440000,-7560000
57059,2020-09-30,589,Value,12060000,-9000000,1440000,-7560000
57059,2020-11-15,589,Distribution,630000,-9000000,2070000,-6930000
57059,2020-12-31,589,Value,14580000,-9000000,2070000,-6930000
57059,2021-02-14,589,Distribution,540000,-9000000,2610000,-6390000
57059,2021-03-31,589,Value,13680000,-9000000,2610000,-6390000
57059,2021-06-30,589,Value,15210000,-9000000,2610000,-6390000
57072,2020-02-15,8699,Capital Call,-1000000,-8000000,1599775,-6400225
57072,2020-03-31,8699,Value,6400220,-8000000,1599775,-6400225
57072,2020-06-30,8699,Value,6400220,-8000000,1599775,-6400225
57072,2020-08-15,8699,Distribution,399700,-8000000,1999475,-6000525
57072,2020-09-30,8699,Value,6000520,-8000000,1999475,-6000525
57072,2020-12-31,8699,Value,6000520,-8000000,1999475,-6000525
57072,2021-02-14,8699,Capital Call,-1000000,-9000000,1999475,-7000525
57072,2021-03-31,8699,Value,7000520,-9000000,1999475,-7000525
57072,2021-05-16,8699,Distribution,418265,-9000000,2417740,-6582260
57072,2021-06-30,8699,Value,6582260,-9000000,2417740,-6582260
57072,2021-09-30,8699,Value,6582260,-9000000,2417740,-6582260
57073,2020-02-15,2238,Capital Call,-288889,-9288889,0,-9288889
57073,2020-03-31,2238,Value,12400000,-9288889,0,-9288889
57073,2020-06-30,2238,Value,13200000,-9288889,0,-9288889
57073,2020-09-30,2238,Value,15400000,-9288889,0,-9288889
57073,2020-11-15,2238,Capital Call,-355556,-9644445,0,-9644445
57073,2020-12-31,2238,Value,21711110,-9644445,0,-9644445
57073,2021-02-14,2238,Capital Call,-200000,-9844445,0,-9844445
57073,2021-03-31,2238,Value,23177770,-9844445,0,-9844445
57073,2021-05-16,2238,Capital Call,-44444,-9888889,0,-9888889
57073,2021-06-30,2238,Value,26200000,-9888889,0,-9888889
57073,2021-08-15,2238,Distribution,266667,-9888889,266667,-9622222
57073,2021-09-30,2238,Value,25266660,-9888889,266667,-9622222
57085,2021-12-31,672,Value,0,-6000000,8610000,2610000
57110,2020-02-15,18,Capital Call,-423,-5482651,602249,-4880402
57110,2020-02-15,18,Distribution,46,-5482651,602295,-4880356
57110,2020-03-31,18,Value,5711340,-5482651,602295,-4880356
57110,2020-05-16,18,Capital Call,-749350,-6232001,602295,-5629706
57110,2020-06-30,18,Value,7132520,-6232001,602295,-5629706
57110,2020-08-15,18,Distribution,195400,-6232001,797695,-5434306
57110,2020-09-30,18,Value,7429790,-6232001,797695,-5434306
57110,2020-11-15,18,Capital Call,-352000,-6584001,797695,-5786306
57110,2020-11-15,18,Distribution,-61,-6584001,797634,-5786367
57110,2020-12-31,18,Value,9300550,-6584001,797634,-5786367
57110,2021-02-14,18,Capital Call,-225753,-6809754,797634,-6012120
57110,2021-03-31,18,Value,10646880,-6809754,797634,-6012120
57110,2021-05-16,18,Capital Call,-128247,-6938001,797634,-6140367
57110,2021-05-16,18,Distribution,437961,-6938001,1235595,-5702406
57110,2021-06-30,18,Value,12090150,-6938001,1235595,-5702406
57110,2021-08-15,18,Distribution,62,-6938001,1235657,-5702344
57110,2021-09-30,18,Value,13382700,-6938001,1235657,-5702344
57116,2020-03-31,2,Value,6957780,-8469437,0,-8469437
57116,2020-05-16,2,Capital Call,-950010,-9419447,0,-9419447
57116,2020-05-16,2,Distribution,49323,-9419447,49323,-9370124
57116,2020-06-30,2,Value,9233090,-9419447,49323,-9370124
57116,2020-08-15,2,Capital Call,-5795,-9425242,49323,-9375919
57116,2020-08-15,2,Distribution,99483,-9425242,148806,-9276436
57116,2020-09-30,2,Value,10465720,-9425242,148806,-9276436
57116,2020-11-15,2,Capital Call,-42933,-9468175,148806,-9319369
57116,2020-11-15,2,Distribution,179879,-9468175,328685,-9139490
57116,2020-12-31,2,Value,11914280,-9468175,328685,-9139490
57116,2021-03-31,2,Value,12460190,-9468175,328685,-9139490
57117,2020-03-31,725,Distribution,-31850,-9100000,629720,-8470280
57117,2020-06-30,725,Value,13202280,-9100000,629720,-8470280
57219,2020-03-31,91,Value,3884440,-5235555,684445,-4551110
57219,2020-05-16,91,Capital Call,-1697778,-6933333,684445,-6248888
57219,2020-06-30,91,Value,6284440,-6933333,684445,-6248888
57219,2020-09-30,91,Value,6639990,-6933333,684445,-6248888
57219,2020-11-15,91,Capital Call,-106667,-7040000,684445,-6355555
57219,2020-11-15,91,Distribution,257778,-7040000,942223,-6097777
57219,2020-12-31,91,Value,7004440,-7040000,942223,-6097777
57219,2021-03-31,91,Value,8924440,-7040000,942223,-6097777
57219,2021-05-16,91,Capital Call,-1448889,-8488889,942223,-7546666
57219,2021-06-30,91,Value,11004440,-8488889,942223,-7546666
57219,2021-09-30,91,Value,11839990,-8488889,942223,-7546666
57400,2020-03-31,20009,Value,9177490,-8995517,1672180,-7323337
57400,2020-06-30,20009,Value,10325040,-8995517,1672180,-7323337
57400,2020-09-30,20009,Value,10645550,-8995517,1672180,-7323337
57400,2020-11-15,20009,Distribution,551471,-8995517,2223651,-6771866
57400,2020-12-31,20009,Value,11170190,-8995517,2223651,-6771866
57400,2021-03-31,20009,Value,11393210,-8995517,2223651,-6771866
57400,2021-09-30,20009,Value,12446240,-8995517,2223651,-6771866
57413,2020-02-15,303,Capital Call,-390000,-9650000,4270708,-5379292
57413,2020-03-31,303,Value,16589570,-9650000,4270708,-5379292
57413,2020-05-16,303,Capital Call,-110000,-9760000,4270708,-5489292
57413,2020-05-16,303,Distribution,604313,-9760000,4875021,-4884979
57413,2020-06-30,303,Value,18254590,-9760000,4875021,-4884979
57413,2020-09-30,303,Value,19240690,-9760000,4875021,-4884979
57413,2020-12-31,303,Value,17391510,-9760000,4875021,-4884979
57413,2021-03-31,303,Value,16323090,-9760000,4875021,-4884979
57413,2021-05-16,303,Distribution,2673519,-9760000,7548540,-2211460
57413,2021-06-30,303,Value,13438240,-9760000,7548540,-2211460
57434,2020-03-31,303,Value,7867720,-9040000,0,-9040000
57434,2020-06-30,303,Value,10075120,-9040000,0,-9040000
57434,2020-09-30,303,Value,11615780,-9040000,0,-9040000
57434,2020-11-15,303,Capital Call,-195000,-9235000,0,-9235000
57434,2020-12-31,303,Value,14145000,-9235000,0,-9235000
57434,2021-02-14,303,Distribution,2476718,-9235000,2476718,-6758282
57434,2021-03-31,303,Value,11774690,-9235000,2476718,-6758282
57434,2021-06-30,303,Value,12317330,-9235000,2476718,-6758282
57480,2020-03-31,350,Value,1269790,-10822026,15267718,4445692
57512,2020-02-15,23710,Capital Call,-78990,-9766529,0,-9766529
57512,2020-03-31,23710,Value,12716000,-9766529,0,-9766529
57512,2020-06-30,23710,Value,15303810,-9766529,0,-9766529
57512,2020-09-30,23710,Value,15839790,-9766529,0,-9766529
57512,2020-12-31,23710,Value,20243680,-9766529,0,-9766529
57519,2020-03-31,350,Capital Call,-397845,-8570738,2247077,-6323661
57519,2020-03-31,350,Distribution,286982,-8570738,2534059,-6036679
57519,2020-06-30,350,Value,7570260,-8570738,2534059,-6036679
57519,2020-09-30,350,Value,8141660,-8570738,2534059,-6036679
57519,2020-12-31,350,Value,8141660,-8570738,2534059,-6036679
57519,2021-02-14,350,Capital Call,-1516,-8572254,2534059,-6038195
57519,2021-02-14,350,Distribution,679383,-8572254,3213442,-5358812
57519,2021-03-31,350,Value,8874550,-8572254,3213442,-5358812
57519,2021-05-16,350,Distribution,2005088,-8572254,5218530,-3353724
57519,2021-06-30,350,Value,7571420,-8572254,5218530,-3353724
57519,2021-08-15,350,Distribution,501233,-8572254,5719763,-2852491
57519,2021-09-30,350,Value,8162240,-8572254,5719763,-2852491
57635,2020-02-15,103,Capital Call,-159946,-6092842,960492,-5132350
57635,2020-03-31,103,Value,5450780,-6092842,960492,-5132350
57635,2020-06-30,103,Value,5450780,-6092842,960492,-5132350
57854,2020-02-15,6691,Capital Call,-200000,-9400000,0,-9400000
57854,2020-03-31,6691,Value,17296000,-9400000,0,-9400000
57854,2020-05-16,6691,Capital Call,-200000,-9600000,0,-9600000
57854,2020-06-30,6691,Value,17760000,-9600000,0,-9600000
57854,2020-08-15,6691,Capital Call,-100000,-9700000,0,-9700000
57854,2020-09-30,6691,Value,18721000,-9700000,0,-9700000
57854,2020-12-31,6691,Value,21534000,-9700000,0,-9700000
57854,2021-02-14,6691,Capital Call,-200000,-9900000,0,-9900000
57854,2021-03-31,6691,Value,22572000,-9900000,0,-9900000
57906,2020-02-03,1368,Distribution,706436,-8049669,706436,-7343233
57906,2020-03-31,1368,Capital Call,-330,-8049999,706436,-7343563
57906,2020-03-31,1368,Distribution,243,-8049999,706679,-7343320
57906,2020-03-31,1368,Value,9904070,-8049999,706679,-7343320
57906,2020-05-16,1368,Capital Call,-335000,-8384999,706679,-7678320
57906,2020-05-16,1368,Distribution,-243,-8384999,706436,-7678563
57906,2020-06-30,1368,Value,9802060,-8384999,706436,-7678563
57906,2020-08-15,1368,Distribution,419,-8384999,706855,-7678144
57906,2020-09-30,1368,Value,9894300,-8384999,706855,-7678144
57998,2020-02-15,365,Capital Call,-1740194,-4769204,0,-4769204
57998,2020-03-31,365,Value,4940160,-4769204,0,-4769204
57998,2020-05-16,365,Capital Call,-1129636,-5898840,0,-5898840
57998,2020-05-16,365,Distribution,126601,-5898840,126601,-5772239
57998,2020-06-30,365,Value,6805890,-5898840,126601,-5772239
57998,2020-08-15,365,Capital Call,-102810,-6001650,126601,-5875049
57998,2020-08-15,365,Distribution,1610088,-6001650,1736689,-4264961
57998,2020-09-30,365,Value,6806240,-6001650,1736689,-4264961
57998,2020-11-15,365,Capital Call,-1217156,-7218806,1736689,-5482117
57998,2020-11-15,365,Distribution,53,-7218806,1736742,-5482064
57998,2020-12-31,365,Value,8416210,-7218806,1736742,-5482064
57998,2021-02-14,365,Capital Call,-128729,-7347535,1736742,-5610793
57998,2021-03-31,365,Value,10661060,-7347535,1736742,-5610793
58037,2020-03-31,11813,Value,9103550,-6800000,0,-6800000
58041,2020-02-15,72,Capital Call,-819859,-7447267,370222,-7077045
58041,2020-03-31,72,Value,8035500,-7447267,370222,-7077045
58041,2020-05-16,72,Capital Call,-459782,-7907049,370222,-7536827
58041,2020-06-30,72,Value,8528760,-7907049,370222,-7536827
58041,2020-08-15,72,Distribution,206061,-7907049,576283,-7330766
58041,2020-09-30,72,Value,8775000,-7907049,576283,-7330766
58041,2020-11-15,72,Capital Call,-964987,-8872036,576283,-8295753
58041,2020-12-31,72,Value,10304260,-8872036,576283,-8295753
58041,2021-02-14,72,Capital Call,-21665,-8893701,576283,-8317418
58041,2021-03-31,72,Value,11354100,-8893701,576283,-8317418
58116,2020-03-31,1292,Value,3835120,-3868810,383530,-3485280
58116,2020-05-16,1292,Capital Call,-1638667,-5507477,383530,-5123947
58116,2020-05-16,1292,Distribution,24840,-5507477,408370,-5099107
58116,2020-06-30,1292,Value,5423070,-5507477,408370,-5099107
58116,2020-09-30,1292,Value,5616850,-5507477,408370,-5099107
58116,2020-11-15,1292,Capital Call,-7787,-5515264,408370,-5106894
58116,2020-11-15,1292,Distribution,39435,-5515264,447805,-5067459
58116,2020-12-31,1292,Value,6106060,-5515264,447805,-5067459
58116,2021-03-31,1292,Value,6802320,-5515264,447805,-5067459
58162,2020-03-31,1357,Value,11247120,-9761666,0,-9761666
58162,2020-05-16,1357,Capital Call,-300000,-10061666,0,-10061666
58162,2020-06-30,1357,Value,11584970,-10061666,0,-10061666
58162,2020-09-30,1357,Value,13401430,-10061666,0,-10061666
58162,2020-12-31,1357,Value,14327020,-10061666,0,-10061666
58162,2021-03-31,1357,Value,19238130,-10061666,0,-10061666
58162,2021-06-30,1357,Value,22061920,-10061666,0,-10061666
58162,2021-08-15,1357,Capital Call,-200000,-10261666,0,-10261666
58162,2021-09-30,1357,Value,23591610,-10261666,0,-10261666
58188,2020-02-15,7,Capital Call,-423826,-6275078,560000,-5715078
58188,2020-03-31,7,Value,6409010,-6275078,560000,-5715078
58188,2020-05-16,7,Capital Call,-451174,-6726252,560000,-6166252
58188,2020-06-30,7,Value,7403570,-6726252,560000,-6166252
58188,2020-08-15,7,Capital Call,-602500,-7328752,560000,-6768752
58188,2020-08-15,7,Distribution,420000,-7328752,980000,-6348752
58188,2020-09-30,7,Value,8399920,-7328752,980000,-6348752
58188,2020-11-15,7,Capital Call,-817500,-8146252,980000,-7166252
58188,2020-11-15,7,Distribution,305000,-8146252,1285000,-6861252
58188,2020-12-31,7,Value,10431120,-8146252,1285000,-6861252
58188,2021-03-31,7,Value,11866730,-8146252,1285000,-6861252
58188,2021-05-16,7,Capital Call,-897500,-9043752,1285000,-7758752
58188,2021-05-16,7,Distribution,1135000,-9043752,2420000,-6623752
58188,2021-06-30,7,Value,13401290,-9043752,2420000,-6623752
58217,2020-03-31,93,Value,14940490,-8180165,1709091,-6471074
58217,2020-06-30,93,Value,15558670,-8180165,1709091,-6471074
58217,2020-09-30,93,Value,16314870,-8180165,1709091,-6471074
58217,2020-11-15,93,Capital Call,-300000,-8480165,1709091,-6771074
58217,2020-11-15,93,Distribution,1733884,-8480165,3442975,-5037190
58217,2020-12-31,93,Value,17814040,-8480165,3442975,-5037190
58217,2021-03-31,93,Value,22786770,-8480165,3442975,-5037190
58217,2021-05-16,93,Distribution,1157851,-8480165,4600826,-3879339
58217,2021-06-30,93,Value,27759500,-8480165,4600826,-3879339
58218,2020-03-31,93,Value,19734640,-9355556,1202614,-8152942
58218,2020-06-30,93,Value,21013070,-9355556,1202614,-8152942
58218,2020-09-30,93,Value,22532020,-9355556,1202614,-8152942
58218,2020-11-15,93,Distribution,4291503,-9355556,5494117,-3861439
58218,2020-12-31,93,Value,22875810,-9355556,5494117,-3861439
58218,2021-03-31,93,Value,29899340,-9355556,5494117,-3861439
58218,2021-06-30,93,Value,39142480,-9355556,5494117,-3861439
58220,2020-03-31,357,Value,10633250,-8103999,3278069,-4825930
58220,2020-05-16,357,Capital Call,-423000,-8526999,3278069,-5248930
58220,2020-05-16,357,Distribution,-289,-8526999,3277780,-5249219
58220,2020-06-30,357,Value,11178040,-8526999,3277780,-5249219
58220,2020-08-15,357,Capital Call,-256051,-8783050,3277780,-5505270
58220,2020-08-15,357,Distribution,-6592,-8783050,3271188,-5511862
58220,2020-09-30,357,Value,12047450,-8783050,3271188,-5511862
58220,2020-12-31,357,Value,13010160,-8783050,3271188,-5511862
58292,2020-03-31,5813,Capital Call,-340000,-7370000,815480,-6554520
58292,2020-03-31,5813,Distribution,341610,-7370000,1157090,-6212910
58292,2020-06-30,5813,Value,7561620,-7370000,1157090,-6212910
58292,2020-08-15,5813,Capital Call,-940000,-8310000,1157090,-7152910
58292,2020-08-15,5813,Distribution,405190,-8310000,1562280,-6747720
58292,2020-09-30,5813,Value,8916630,-8310000,1562280,-6747720
58292,2020-11-15,5813,Capital Call,-840000,-9150000,1562280,-7587720
58292,2020-11-15,5813,Distribution,469020,-9150000,2031300,-7118700
58292,2020-12-31,5813,Value,10275450,-9150000,2031300,-7118700
58292,2021-02-14,5813,Capital Call,-690000,-9840000,2031300,-7808700
58292,2021-02-14,5813,Distribution,5580,-9840000,2036880,-7803120
58292,2021-03-31,5813,Value,11748960,-9840000,2036880,-7803120
58292,2021-06-30,5813,Value,12447600,-9840000,2036880,-7803120
58292,2021-09-30,5813,Value,13648080,-9840000,2036880,-7803120
58292,2021-11-15,5813,Capital Call,-300000,-10140000,2036880,-8103120
58292,2021-11-15,5813,Distribution,700920,-10140000,2737800,-7402200
58292,2021-12-31,5813,Value,14165580,-10140000,2737800,-7402200
58393,2020-02-15,533,Capital Call,-804048,-7842668,5608617,-2234051
58393,2020-03-31,533,Value,4800370,-7842668,5608617,-2234051
58393,2020-06-30,533,Value,4738690,-7842668,5608617,-2234051
58393,2020-09-30,533,Value,5322660,-7842668,5608617,-2234051
58393,2020-11-15,533,Capital Call,-829144,-8671812,5608617,-3063195
58393,2020-11-15,533,Distribution,2591250,-8671812,8199867,-471945
58393,2020-12-31,533,Value,3560550,-8671812,8199867,-471945
58393,2021-03-31,533,Value,5767840,-8671812,8199867,-471945
58393,2021-05-16,533,Capital Call,-472460,-9144272,8199867,-944405
58393,2021-05-16,533,Distribution,1922721,-9144272,10122588,978316
58393,2021-06-30,533,Value,5301610,-9144272,10122588,978316
58415,2020-02-15,10699,Capital Call,-32167,-8642000,0,-8642000
58415,2020-03-31,10699,Value,8567670,-8642000,0,-8642000
58415,2020-05-16,10699,Capital Call,-75297,-8717297,0,-8717297
58415,2020-06-30,10699,Value,9136060,-8717297,0,-8717297
58415,2020-08-15,10699,Capital Call,-103838,-8821135,0,-8821135
58415,2020-09-30,10699,Value,9941880,-8821135,0,-8821135
58415,2020-11-15,10699,Capital Call,-140155,-8961290,0,-8961290
58415,2020-12-31,10699,Value,10729760,-8961290,0,-8961290
58415,2021-04-01,10699,Capital Call,-71711,-9033001,0,-9033001
58415,2021-06-30,10699,Value,12314680,-9033001,0,-9033001
58447,2020-03-31,6758,Value,2795910,-4283130,782373,-3500757
58447,2020-05-16,6758,Capital Call,-716489,-4999619,782373,-4217246
58447,2020-05-16,6758,Distribution,206083,-4999619,988456,-4011163
58447,2020-06-30,6758,Value,3761130,-4999619,988456,-4011163
58447,2020-08-15,6758,Capital Call,-55599,-5055218,988456,-4066762
58447,2020-08-15,6758,Distribution,128597,-5055218,1117053,-3938165
58447,2020-09-30,6758,Value,3575470,-5055218,1117053,-3938165
58447,2020-11-15,6758,Capital Call,-344879,-5400097,1117053,-4283044
58447,2020-11-15,6758,Distribution,91146,-5400097,1208199,-4191898
58447,2020-12-31,6758,Value,3829200,-5400097,1208199,-4191898
58447,2021-02-14,6758,Distribution,101640,-5400097,1309839,-4090258
58447,2021-03-31,6758,Value,3949490,-5400097,1309839,-4090258
58447,2021-05-16,6758,Capital Call,-125502,-5525599,1309839,-4215760
58447,2021-05-16,6758,Distribution,256670,-5525599,1566509,-3959090
58447,2021-06-30,6758,Value,4148580,-5525599,1566509,-3959090
58529,2020-02-15,182236,Capital Call,-2576988,-9140151,0,-9140151
58529,2020-03-31,182236,Value,10229500,-9140151,0,-9140151
58529,2020-09-30,182236,Value,10950840,-9140151,0,-9140151
58529,2020-11-15,182236,Capital Call,-398473,-9538624,0,-9538624
58529,2020-12-31,182236,Value,13579520,-9538624,0,-9538624
58529,2021-03-31,182236,Value,14928060,-9538624,0,-9538624
58529,2021-06-30,182236,Value,17256820,-9538624,0,-9538624
58530,2020-12-31,902,Value,13690000,-9626667,0,-9626667
58619,2020-03-31,1368,Value,7942780,-8146725,3115892,-5030833
58639,2020-01-15,137606,Capital Call,-43974,-5839053,361344,-5477709
58639,2020-01-15,137606,Distribution,0,-5839053,361344,-5477709
58639,2020-02-29,137606,Value,4274680,-5839053,361344,-5477709
58639,2020-05-31,137606,Capital Call,-63632,-5902685,361344,-5541341
58639,2020-05-31,137606,Distribution,29335,-5902685,390679,-5512006
58639,2020-08-31,137606,Value,4159100,-5902685,390679,-5512006
58639,2020-10-16,137606,Capital Call,-29335,-5932020,390679,-5541341
58639,2020-10-16,137606,Distribution,58442,-5932020,449121,-5482899
58639,2020-11-30,137606,Value,4901550,-5932020,449121,-5482899
58639,2021-01-14,137606,Capital Call,-19619,-5951639,449121,-5502518
58639,2021-01-14,137606,Distribution,27214,-5951639,476335,-5475304
58639,2021-02-28,137606,Value,5121310,-5951639,476335,-5475304
58639,2021-04-15,137606,Capital Call,-19732,-5971371,476335,-5495036
58639,2021-04-15,137606,Distribution,25182,-5971371,501517,-5469854
58639,2021-05-31,137606,Value,5460440,-5971371,501517,-5469854
58639,2021-07-16,137606,Capital Call,-54530,-6025901,501517,-5524384
58639,2021-07-16,137606,Distribution,31481,-6025901,532998,-5492903
58639,2021-08-31,137606,Value,5644290,-6025901,532998,-5492903
58639,2021-10-16,137606,Capital Call,-17810,-6043711,532998,-5510713
58639,2021-10-16,137606,Distribution,657793,-6043711,1190791,-4852920
58639,2021-11-30,137606,Value,5311790,-6043711,1190791,-4852920
58672,2020-02-15,25346,Capital Call,-11969,-8984305,852026,-8132279
58672,2020-02-15,25346,Distribution,1707,-8984305,853733,-8130572
58672,2020-03-31,25346,Value,10082940,-8984305,853733,-8130572
58672,2020-05-16,25346,Capital Call,-119838,-9104143,853733,-8250410
58672,2020-05-16,25346,Distribution,4811,-9104143,858544,-8245599
58672,2020-06-30,25346,Value,10974320,-9104143,858544,-8245599
58672,2020-09-30,25346,Value,10974320,-9104143,858544,-8245599
58672,2020-11-15,25346,Capital Call,-1058002,-10162145,858544,-9303601
58672,2020-11-15,25346,Distribution,1603212,-10162145,2461756,-7700389
58672,2020-12-31,25346,Value,11301030,-10162145,2461756,-7700389
58672,2021-02-14,25346,Capital Call,-85830,-10247975,2461756,-7786219
58672,2021-02-14,25346,Distribution,2556448,-10247975,5018204,-5229771
58672,2021-03-31,25346,Value,9589220,-10247975,5018204,-5229771
58694,2020-02-15,182780,Capital Call,-214706,-7325940,5716,-7320224
58694,2020-02-15,182780,Distribution,1228,-7325940,6944,-7318996
58694,2020-03-31,182780,Value,8782250,-7325940,6944,-7318996
58694,2020-05-16,182780,Capital Call,-235149,-7561089,6944,-7554145
58694,2020-05-16,182780,Distribution,0,-7561089,6944,-7554145
58694,2020-06-30,182780,Value,13585180,-7561089,6944,-7554145
58694,2020-08-15,182780,Capital Call,-330134,-7891223,6944,-7884279
58694,2020-08-15,182780,Distribution,29,-7891223,6973,-7884250
58694,2020-09-30,182780,Value,14174770,-7891223,6973,-7884250
58694,2020-12-31,182780,Value,29200760,-7891223,6973,-7884250
58694,2021-02-14,182780,Capital Call,-349122,-8240345,6973,-8233372
58694,2021-02-14,182780,Distribution,4680644,-8240345,4687617,-3552728
58694,2021-03-31,182780,Value,39753520,-8240345,4687617,-3552728
58694,2021-05-16,182780,Capital Call,-18037,-8258382,4687617,-3570765
58694,2021-05-16,182780,Distribution,12710810,-8258382,17398427,9140045
58694,2021-06-30,182780,Value,26954070,-8258382,17398427,9140045
58694,2021-08-15,182780,Capital Call,-20951,-8279333,17398427,9119094
58694,2021-08-15,182780,Distribution,6737205,-8279333,24135632,15856299
58694,2021-09-30,182780,Value,29208230,-8279333,24135632,15856299
58936,2020-02-15,577,Capital Call,-681986,-6038402,67893,-5970509
58936,2020-03-31,577,Value,9110470,-6038402,67893,-5970509
58936,2020-05-16,577,Capital Call,-796878,-6835280,67893,-6767387
58936,2020-06-30,577,Value,11415370,-6835280,67893,-6767387
58936,2020-08-15,577,Capital Call,-1112675,-7947955,67893,-7880062
58936,2020-09-30,577,Value,13841020,-7947955,67893,-7880062
58936,2020-11-15,577,Capital Call,-2515,-7950470,67893,-7882577
58936,2020-11-15,577,Distribution,2243042,-7950470,2310935,-5639535
58936,2020-12-31,577,Value,14544050,-7950470,2310935,-5639535
58936,2021-02-14,577,Capital Call,-203771,-8154241,2310935,-5843306
58936,2021-03-31,577,Value,15709930,-8154241,2310935,-5843306
58936,2021-05-16,577,Capital Call,-156054,-8310295,2310935,-5999360
58936,2021-05-16,577,Distribution,704781,-8310295,3015716,-5294579
58936,2021-06-30,577,Value,16513470,-8310295,3015716,-5294579
58957,2020-02-15,384,Capital Call,-300000,-8500000,1230000,-7270000
58957,2020-02-15,384,Distribution,45000,-8500000,1275000,-7225000
58957,2020-03-31,384,Value,9095000,-8500000,1275000,-7225000
58957,2020-05-16,384,Capital Call,-1000000,-9500000,1275000,-8225000
58957,2020-05-16,384,Distribution,-40000,-9500000,1235000,-8265000
58957,2020-06-30,384,Value,10830000,-9500000,1235000,-8265000
58957,2020-09-30,384,Value,11970000,-9500000,1235000,-8265000
58957,2020-11-15,384,Distribution,3990000,-9500000,5225000,-4275000
58957,2020-12-31,384,Value,8550000,-9500000,5225000,-4275000
58957,2021-03-31,384,Value,9405000,-9500000,5225000,-4275000
58957,2021-05-16,384,Distribution,1425000,-9500000,6650000,-2850000
58957,2021-06-30,384,Value,8550000,-9500000,6650000,-2850000
58957,2021-09-30,384,Value,8835000,-9500000,6650000,-2850000
58957,2021-11-15,384,Distribution,190000,-9500000,6840000,-2660000
58957,2021-12-31,384,Value,9975000,-9500000,6840000,-2660000
59034,2020-03-31,771,Value,11115390,-8035527,423850,-7611677
59034,2020-05-16,771,Distribution,3853353,-8035527,4277203,-3758324
59034,2020-06-30,771,Value,8304080,-8035527,4277203,-3758324
59034,2020-08-15,771,Capital Call,-979852,-9015379,4277203,-4738176
59034,2020-08-15,771,Distribution,635440,-9015379,4912643,-4102736
59034,2020-09-30,771,Value,9583710,-9015379,4912643,-4102736
59034,2020-11-15,771,Capital Call,-904081,-9919460,4912643,-5006817
59034,2020-12-31,771,Value,10269120,-9919460,4912643,-5006817
59034,2021-02-14,771,Distribution,2621879,-9919460,7534522,-2384938
59034,2021-03-31,771,Value,8852000,-9919460,7534522,-2384938
59067,2020-03-31,62264,Value,12026420,-10005666,3377576,-6628090
59067,2020-06-30,62264,Value,12161860,-10005666,3377576,-6628090
59067,2020-09-30,62264,Distribution,2934340,-10005666,6311916,-3693750
59067,2020-12-31,62264,Value,11480700,-10005666,6311916,-3693750
59067,2021-03-31,62264,Value,16831240,-10005666,6311916,-3693750
59067,2021-06-30,62264,Value,16824600,-10005666,6311916,-3693750
59082,2020-02-15,14411,Capital Call,-459440,-9410079,2128408,-7281671
59082,2020-02-15,14411,Distribution,459440,-9410079,2587848,-6822231
59082,2020-03-31,14411,Value,8384010,-9410079,2587848,-6822231
59082,2020-06-30,14411,Value,8696200,-9410079,2587848,-6822231
59082,2020-09-30,14411,Value,9426760,-9410079,2587848,-6822231
59082,2020-11-15,14411,Capital Call,-625835,-10035914,2587848,-7448066
59082,2020-11-15,14411,Distribution,1041973,-10035914,3629821,-6406093
59082,2020-12-31,14411,Value,8982130,-10035914,3629821,-6406093
59117,2020-02-15,519,Capital Call,-163683,-5163683,2336679,-2827004
59117,2020-02-15,519,Distribution,163683,-5163683,2500362,-2663321
59117,2020-03-31,519,Value,3748540,-5163683,2500362,-2663321
59117,2020-05-16,519,Capital Call,2250,-5161433,2500362,-2661071
59117,2020-05-16,519,Distribution,127422,-5161433,2627784,-2533649
59117,2020-06-30,519,Value,3705940,-5161433,2627784,-2533649
59117,2020-08-15,519,Capital Call,-2250,-5163683,2627784,-2535899
59117,2020-08-15,519,Distribution,103418,-5163683,2731202,-2432481
59117,2020-09-30,519,Value,3585750,-5163683,2731202,-2432481
59117,2020-11-15,519,Capital Call,-536317,-5700000,2731202,-2968798
59117,2020-11-15,519,Distribution,232797,-5700000,2963999,-2736001
59117,2020-12-31,519,Value,4332000,-5700000,2963999,-2736001
59117,2021-04-01,519,Capital Call,-700000,-6400000,2963999,-3436001
59117,2021-04-01,519,Distribution,876000,-6400000,3839999,-2560001
59117,2021-06-30,519,Value,5056000,-6400000,3839999,-2560001
59180,2020-01-01,2447,Capital Call,-3296000,-8040001,1723021,-6316980
59180,2020-01-01,2447,Distribution,793499,-8040001,2516520,-5523481
59180,2020-12-31,2447,Value,9935830,-8040001,2516520,-5523481
59207,2020-02-15,431,Capital Call,-209000,-6688000,288316,-6399684
59207,2020-02-15,431,Distribution,-63,-6688000,288253,-6399747
59207,2020-03-31,431,Value,6556240,-6688000,288253,-6399747
59207,2020-05-16,431,Capital Call,-787000,-7475000,288253,-7186747
59207,2020-05-16,431,Distribution,1777,-7475000,290030,-7184970
59207,2020-06-30,431,Value,7097510,-7475000,290030,-7184970
59207,2020-08-15,431,Capital Call,-249000,-7724000,290030,-7433970
59207,2020-08-15,431,Distribution,392,-7724000,290422,-7433578
59207,2020-09-30,431,Value,7608910,-7724000,290422,-7433578
59207,2020-11-15,431,Capital Call,-308000,-8032000,290422,-7741578
59207,2020-11-15,431,Distribution,-290422,-8032000,0,-8032000
59207,2020-12-31,431,Value,9193420,-8032000,0,-8032000
59207,2021-02-14,431,Capital Call,-116000,-8148000,0,-8148000
59207,2021-03-31,431,Value,9929150,-8148000,0,-8148000
59207,2021-05-16,431,Capital Call,-1065000,-9213000,0,-9213000
59207,2021-06-30,431,Value,11378970,-9213000,0,-9213000
59207,2021-08-15,431,Capital Call,425000,-8788000,0,-8788000
59207,2021-09-30,431,Value,11159880,-8788000,0,-8788000
59207,2021-12-31,431,Value,12917480,-8788000,0,-8788000
59248,2020-03-31,18,Value,7961880,-6280000,1678791,-4601209
59248,2020-05-16,18,Capital Call,-710000,-6990000,1678791,-5311209
59248,2020-06-30,18,Value,8160340,-6990000,1678791,-5311209
59248,2020-08-15,18,Distribution,492508,-6990000,2171299,-4818701
59248,2020-09-30,18,Value,8310260,-6990000,2171299,-4818701
59248,2020-11-15,18,Capital Call,-250000,-7240000,2171299,-5068701
59248,2020-12-31,18,Value,9532660,-7240000,2171299,-5068701
59248,2021-03-31,18,Value,11943640,-7240000,2171299,-5068701
59257,2020-02-15,18,Capital Call,0,-7903000,0,-7903000
59257,2020-03-31,18,Value,8811050,-7903000,0,-7903000
59257,2020-05-16,18,Capital Call,-770000,-8673000,0,-8673000
59257,2020-06-30,18,Value,11556770,-8673000,0,-8673000
59257,2020-09-30,18,Value,10969610,-8673000,0,-8673000
59257,2020-12-31,18,Value,12236730,-8673000,0,-8673000
59257,2021-03-31,18,Value,13051130,-8673000,0,-8673000
59257,2021-05-16,18,Distribution,217692,-8673000,217692,-8455308
59257,2021-06-30,18,Value,14340800,-8673000,217692,-8455308
59257,2021-09-30,18,Value,15263610,-8673000,217692,-8455308
59267,2020-03-31,2642,Value,5957390,-7262880,3079896,-4182984
59267,2020-05-16,2642,Capital Call,-45496,-7308376,3079896,-4228480
59267,2020-06-30,2642,Value,5994700,-7308376,3079896,-4228480
59267,2020-08-15,2642,Capital Call,-1898391,-9206767,3079896,-6126871
59267,2020-08-15,2642,Distribution,1742619,-9206767,4822515,-4384252
59267,2020-09-30,2642,Value,6789870,-9206767,4822515,-4384252
59267,2020-11-15,2642,Capital Call,-31333,-9238100,4822515,-4415585
59267,2020-12-31,2642,Value,6772780,-9238100,4822515,-4415585
59267,2021-02-14,2642,Capital Call,-107571,-9345671,4822515,-4523156
59267,2021-02-14,2642,Distribution,4025497,-9345671,8848012,-497659
59267,2021-03-31,2642,Value,4313410,-9345671,8848012,-497659
59267,2021-05-16,2642,Distribution,464023,-9345671,9312035,-33636
59267,2021-06-30,2642,Value,5008920,-9345671,9312035,-33636
59267,2021-08-15,2642,Capital Call,-27708,-9373379,9312035,-61344
59267,2021-08-15,2642,Distribution,314877,-9373379,9626912,253533
59267,2021-09-30,2642,Value,4694050,-9373379,9626912,253533
59321,2020-02-15,9110,Capital Call,-639273,-5161751,249723,-4912028
59321,2020-02-15,9110,Distribution,155004,-5161751,404727,-4757024
59321,2020-03-31,9110,Value,5261440,-5161751,404727,-4757024
59321,2020-05-16,9110,Capital Call,-100429,-5262180,404727,-4857453
59321,2020-05-16,9110,Distribution,810,-5262180,405537,-4856643
59321,2020-06-30,9110,Value,5619430,-5262180,405537,-4856643
59321,2020-08-15,9110,Capital Call,-692313,-5954493,405537,-5548956
59321,2020-08-15,9110,Distribution,146968,-5954493,552505,-5401988
59321,2020-09-30,9110,Value,6496580,-5954493,552505,-5401988
59321,2020-11-15,9110,Capital Call,-687675,-6642168,552505,-6089663
59321,2020-11-15,9110,Distribution,22778,-6642168,575283,-6066885
59321,2020-12-31,9110,Value,7689230,-6642168,575283,-6066885
59321,2021-02-14,9110,Capital Call,-799490,-7441658,575283,-6866375
59321,2021-02-14,9110,Distribution,223489,-7441658,798772,-6642886
59321,2021-03-31,9110,Value,8265230,-7441658,798772,-6642886
59341,2020-02-15,345712,Capital Call,-500000,-8725000,0,-8725000
59341,2020-03-31,345712,Value,13740660,-8725000,0,-8725000
59341,2020-05-16,345712,Capital Call,-160000,-8885000,0,-8885000
59341,2020-06-30,345712,Value,13891210,-8885000,0,-8885000
59341,2020-08-15,345712,Capital Call,-120000,-9005000,0,-9005000
59341,2020-09-30,345712,Value,15124340,-9005000,0,-9005000
59341,2020-12-31,345712,Value,15596940,-9005000,0,-9005000
59345,2020-03-31,2901,Value,8654370,-6500000,1160475,-5339525
59345,2020-05-16,2901,Capital Call,-30000,-6530000,1160475,-5369525
59345,2020-05-16,2901,Distribution,305171,-6530000,1465646,-5064354
59345,2020-06-30,2901,Value,9461320,-6530000,1465646,-5064354
59345,2020-08-15,2901,Capital Call,-1220000,-7750000,1465646,-6284354
59345,2020-08-15,2901,Distribution,762665,-7750000,2228311,-5521689
59345,2020-09-30,2901,Value,11602780,-7750000,2228311,-5521689
59345,2020-11-15,2901,Capital Call,-950000,-8700000,2228311,-6471689
59345,2020-11-15,2901,Distribution,796101,-8700000,3024412,-5675588
59345,2020-12-31,2901,Value,16696330,-8700000,3024412,-5675588
59345,2021-02-14,2901,Capital Call,-150000,-8850000,3024412,-5825588
59345,2021-02-14,2901,Distribution,765744,-8850000,3790156,-5059844
59345,2021-03-31,2901,Value,18233730,-8850000,3790156,-5059844
59380,2020-03-31,6715,Value,8099090,-6400000,0,-6400000
59380,2020-05-16,6715,Capital Call,-800000,-7200000,0,-7200000
59380,2020-06-30,6715,Value,9260880,-7200000,0,-7200000
59380,2020-09-30,6715,Capital Call,-400000,-7600000,0,-7600000
59380,2020-12-31,6715,Value,11406080,-7600000,0,-7600000
59380,2021-02-14,6715,Capital Call,-500000,-8100000,0,-8100000
59380,2021-02-14,6715,Distribution,3433614,-8100000,3433614,-4666386
59380,2021-03-31,6715,Value,0,-8100000,3433614,-4666386
59380,2021-09-30,6715,Value,68442950,-8100000,3433614,-4666386
59392,2020-02-15,375,Capital Call,-482000,-5937551,175204,-5762347
59392,2020-03-31,375,Value,6459550,-5937551,175204,-5762347
59392,2020-05-16,375,Capital Call,-487000,-6424551,175204,-6249347
59392,2020-06-30,375,Value,6744610,-6424551,175204,-6249347
59392,2020-08-15,375,Capital Call,-136000,-6560551,175204,-6385347
59392,2020-11-15,375,Capital Call,-392000,-6952551,175204,-6777347
59392,2020-12-31,375,Value,9124860,-6952551,175204,-6777347
59392,2021-02-14,375,Capital Call,-260000,-7212551,175204,-7037347
59392,2021-02-14,375,Distribution,365784,-7212551,540988,-6671563
59392,2021-03-31,375,Value,10164210,-7212551,540988,-6671563
59392,2021-05-16,375,Capital Call,-421000,-7633551,540988,-7092563
59392,2021-05-16,375,Distribution,1127533,-7633551,1668521,-5965030
59392,2021-06-30,375,Value,10644510,-7633551,1668521,-5965030
59398,2020-02-15,697,Capital Call,-800000,-6149999,0,-6149999
59398,2020-03-31,697,Value,7177050,-6149999,0,-6149999
59398,2020-05-16,697,Capital Call,-500000,-6649999,0,-6649999
59398,2020-06-30,697,Value,8179500,-6649999,0,-6649999
59398,2020-08-15,697,Capital Call,-400000,-7049999,0,-7049999
59398,2020-09-30,697,Value,8685600,-7049999,0,-7049999
59398,2020-11-15,697,Capital Call,-650000,-7699999,0,-7699999
59398,2020-12-31,697,Value,11088000,-7699999,0,-7699999
59398,2021-02-14,697,Capital Call,-40000,-7739999,0,-7739999
59398,2021-03-31,697,Value,12074400,-7739999,0,-7739999
59398,2021-06-30,697,Value,13204440,-7739999,0,-7739999
59398,2021-08-15,697,Capital Call,40000,-7699999,0,-7699999
59398,2021-09-30,697,Value,13136200,-7699999,0,-7699999
59413,2020-02-15,906,Capital Call,-200000,-9650000,0,-9650000
59413,2020-03-31,906,Value,14580020,-9650000,0,-9650000
59413,2020-06-30,906,Value,15330070,-9650000,0,-9650000
59413,2020-09-30,906,Value,17217940,-9650000,0,-9650000
59413,2020-11-15,906,Capital Call,-150000,-9800000,0,-9800000
59413,2020-11-15,906,Distribution,556836,-9800000,556836,-9243164
59413,2020-12-31,906,Value,17412890,-9800000,556836,-9243164
59413,2021-02-14,906,Distribution,488639,-9800000,1045475,-8754525
59413,2021-03-31,906,Value,23857560,-9800000,1045475,-8754525
59414,2020-03-31,906,Value,19591690,-9750000,0,-9750000
59414,2020-06-30,906,Value,23099650,-9750000,0,-9750000
59414,2020-09-30,906,Value,31988800,-9750000,0,-9750000
59414,2020-12-30,906,Distribution,10607711,-9750000,10607711,857711
59414,2021-03-31,906,Value,39799810,-9750000,10607711,857711
59453,2020-03-31,672,Value,7527220,-7329334,1949604,-5379730
59453,2020-05-16,672,Capital Call,-349968,-7679302,1949604,-5729698
59453,2020-05-16,672,Distribution,-14243,-7679302,1935361,-5743941
59453,2020-06-30,672,Value,8470270,-7679302,1935361,-5743941
59453,2020-08-15,672,Capital Call,-359967,-8039269,1935361,-6103908
59453,2020-08-15,672,Distribution,58379,-8039269,1993740,-6045529
59453,2020-09-30,672,Value,9413980,-8039269,1993740,-6045529
59453,2020-11-15,672,Capital Call,-169985,-8209254,1993740,-6215514
59453,2020-11-15,672,Distribution,1716844,-8209254,3710584,-4498670
59453,2020-12-31,672,Value,9366760,-8209254,3710584,-4498670
59453,2021-02-14,672,Capital Call,-289974,-8499228,3710584,-4788644
59453,2021-02-14,672,Distribution,114070,-8499228,3824654,-4674574
59453,2021-03-31,672,Value,10496540,-8499228,3824654,-4674574
59453,2021-05-16,672,Capital Call,-771,-8499999,3824654,-4675345
59453,2021-05-16,672,Distribution,612347,-8499999,4437001,-4062998
59453,2021-06-30,672,Value,10795000,-8499999,4437001,-4062998
59453,2021-08-15,672,Distribution,51000,-8499999,4488001,-4011998
59453,2021-09-30,672,Value,11432500,-8499999,4488001,-4011998
59468,2020-02-15,40167,Capital Call,-35879,-13542151,5874573,-7667578
59468,2020-02-15,40167,Distribution,161099,-13542151,6035672,-7506479
59468,2020-03-31,40167,Value,11998580,-13542151,6035672,-7506479
59468,2020-06-30,40167,Value,10987850,-13542151,6035672,-7506479
59468,2020-08-15,40167,Capital Call,-207057,-13749208,6035672,-7713536
59468,2020-08-15,40167,Distribution,177881,-13749208,6213553,-7535655
59468,2020-09-30,40167,Value,11929390,-13749208,6213553,-7535655
59468,2020-11-15,40167,Capital Call,-78557,-13827765,6213553,-7614212
59468,2020-11-15,40167,Distribution,277179,-13827765,6490732,-7337033
59468,2020-12-31,40167,Value,13166390,-13827765,6490732,-7337033
59468,2021-02-14,40167,Capital Call,-111189,-13938954,6490732,-7448222
59468,2021-02-14,40167,Distribution,307451,-13938954,6798183,-7140771
59468,2021-03-31,40167,Value,12971980,-13938954,6798183,-7140771
59491,2020-02-15,462,Capital Call,220400,-8576000,0,-8576000
59491,2020-03-31,462,Value,10212800,-8576000,0,-8576000
59491,2020-05-16,462,Capital Call,-35600,-8611600,0,-8611600
59491,2020-06-30,462,Value,9900400,-8611600,0,-8611600
59491,2020-08-15,462,Capital Call,-872800,-9484400,0,-9484400
59491,2020-09-30,462,Value,11464000,-9484400,0,-9484400
59491,2020-11-15,462,Capital Call,-228000,-9712400,0,-9712400
59491,2020-12-31,462,Value,12231200,-9712400,0,-9712400
59492,2020-02-15,2238,Distribution,50000,-8750000,50000,-8700000
59492,2020-03-31,2238,Value,11700000,-8750000,50000,-8700000
59492,2020-05-16,2238,Capital Call,-250000,-9000000,50000,-8950000
59492,2020-06-30,2238,Value,12700000,-9000000,50000,-8950000
59492,2020-09-30,2238,Value,12800000,-9000000,50000,-8950000
59492,2020-11-15,2238,Capital Call,-50000,-9050000,50000,-9000000
59492,2020-12-31,2238,Value,15100000,-9050000,50000,-9000000
59492,2021-02-14,2238,Capital Call,-450000,-9500000,50000,-9450000
59492,2021-03-31,2238,Value,16750000,-9500000,50000,-9450000
59492,2021-05-16,2238,Capital Call,-350000,-9850000,50000,-9800000
59492,2021-06-30,2238,Value,17950000,-9850000,50000,-9800000
59492,2021-09-30,2238,Value,17200000,-9850000,50000,-9800000
59493,2020-02-15,2238,Capital Call,-533333,-7666666,0,-7666666
59493,2020-03-31,2238,Value,7400000,-7666666,0,-7666666
59493,2020-06-30,2238,Value,7866660,-7666666,0,-7666666
59493,2020-08-15,2238,Capital Call,-1000000,-8666666,0,-8666666
59493,2020-09-30,2238,Value,12533330,-8666666,0,-8666666
59493,2020-11-15,2238,Capital Call,-466667,-9133333,0,-9133333
59493,2020-12-31,2238,Value,19933330,-9133333,0,-9133333
59493,2021-03-31,2238,Value,19933330,-9133333,0,-9133333
59493,2021-05-16,2238,Capital Call,-266667,-9400000,0,-9400000
59493,2021-06-30,2238,Value,32400000,-9400000,0,-9400000
59493,2021-09-30,2238,Value,31466660,-9400000,0,-9400000
59545,2020-03-31,46864,Value,9965740,-11941612,4905514,-7036098
59545,2020-06-30,46864,Value,8982060,-11941612,4905514,-7036098
59545,2020-08-15,46864,Capital Call,-292641,-12234253,4905514,-7328739
59545,2020-08-15,46864,Distribution,155844,-12234253,5061358,-7172895
59545,2020-09-30,46864,Value,9555470,-12234253,5061358,-7172895
59545,2020-12-31,46864,Value,10047730,-12234253,5061358,-7172895
59545,2021-03-31,46864,Value,10047730,-12234253,5061358,-7172895
59545,2021-05-16,46864,Distribution,142857,-12234253,5204215,-7030038
59545,2021-06-30,46864,Value,10378810,-12234253,5204215,-7030038
59603,2020-02-15,487,Capital Call,-500000,-6400000,0,-6400000
59603,2020-03-31,487,Value,8962000,-6400000,0,-6400000
59603,2020-05-16,487,Capital Call,-600000,-7000000,0,-7000000
59603,2020-06-30,487,Value,10000000,-7000000,0,-7000000
59603,2020-08-15,487,Capital Call,-700000,-7700000,0,-7700000
59603,2020-09-30,487,Value,11171330,-7700000,0,-7700000
59603,2020-11-15,487,Capital Call,-900000,-8600000,0,-8600000
59603,2020-12-31,487,Value,15269330,-8600000,0,-8600000
59603,2021-02-14,487,Distribution,3612667,-8600000,3612667,-4987333
59603,2021-03-31,487,Value,13822000,-8600000,3612667,-4987333
59603,2021-06-30,487,Value,14555330,-8600000,3612667,-4987333
59625,2020-02-15,475912,Capital Call,-227257,-7949263,2149292,-5799971
59625,2020-02-15,475912,Distribution,130030,-7949263,2279322,-5669941
59625,2020-03-31,475912,Value,6231700,-7949263,2279322,-5669941
59625,2020-05-16,475912,Capital Call,-1003578,-8952841,2279322,-6673519
59625,2020-05-16,475912,Distribution,28703,-8952841,2308025,-6644816
59625,2020-06-30,475912,Value,7613740,-8952841,2308025,-6644816
59625,2020-09-30,475912,Value,7831090,-8952841,2308025,-6644816
59625,2020-11-15,475912,Capital Call,-416883,-9369724,2308025,-7061699
59625,2020-11-15,475912,Distribution,609345,-9369724,2917370,-6452354
59625,2020-12-31,475912,Value,8363150,-9369724,2917370,-6452354
59625,2021-02-14,475912,Capital Call,-570171,-9939895,2917370,-7022525
59625,2021-02-14,475912,Distribution,52958,-9939895,2970328,-6969567
59625,2021-03-31,475912,Value,9616670,-9939895,2970328,-6969567
59638,2020-03-31,17603,Value,6518300,-7008033,2744044,-4263989
59638,2020-05-16,17603,Capital Call,-1646926,-8654959,2744044,-5910915
59638,2020-05-16,17603,Distribution,754700,-8654959,3498744,-5156215
59638,2020-06-30,17603,Value,8049000,-8654959,3498744,-5156215
59638,2020-08-15,17603,Capital Call,-366829,-9021788,3498744,-5523044
59638,2020-09-30,17603,Value,8923870,-9021788,3498744,-5523044
59638,2020-11-15,17603,Capital Call,-11,-9021799,3498744,-5523055
59638,2020-11-15,17603,Distribution,602725,-9021799,4101469,-4920330
59638,2020-12-31,17603,Value,8321150,-9021799,4101469,-4920330
59638,2021-02-14,17603,Capital Call,-198443,-9220242,4101469,-5118773
59638,2021-02-14,17603,Distribution,2108436,-9220242,6209905,-3010337
59638,2021-03-31,17603,Value,8332380,-9220242,6209905,-3010337
59638,2021-05-16,17603,Capital Call,-329804,-9550046,6209905,-3340141
59638,2021-05-16,17603,Distribution,1764001,-9550046,7973906,-1576140
59638,2021-06-30,17603,Value,8806880,-9550046,7973906,-1576140
59638,2021-08-15,17603,Capital Call,-54216,-9604262,7973906,-1630356
59638,2021-08-15,17603,Distribution,222616,-9604262,8196522,-1407740
59638,2021-09-30,17603,Value,8584260,-9604262,8196522,-1407740
59747,2020-02-15,2154,Capital Call,-3656873,-4118573,0,-4118573
59747,2020-03-31,2154,Value,3683100,-4118573,0,-4118573
59747,2020-06-30,2154,Value,3693590,-4118573,0,-4118573
59747,2020-09-30,2154,Value,4123810,-4118573,0,-4118573
59747,2020-12-31,2154,Value,4328430,-4118573,0,-4118573
59747,2021-03-31,2154,Value,4102830,-4118573,0,-4118573
59747,2021-06-30,2154,Value,10178380,-4118573,0,-4118573
59747,2021-08-15,2154,Capital Call,-1946485,-6065058,0,-6065058
59747,2021-09-30,2154,Value,11820560,-6065058,0,-6065058
59763,2020-03-31,461,Value,8634500,-7600000,863000,-6737000
59763,2020-06-30,461,Value,8526500,-7600000,863000,-6737000
59763,2020-08-15,461,Capital Call,-700000,-8300000,863000,-7437000
59763,2020-09-30,461,Value,9443000,-8300000,863000,-7437000
59763,2020-12-31,461,Value,10575000,-8300000,863000,-7437000
59763,2021-02-14,461,Capital Call,-200000,-8500000,863000,-7637000
59763,2021-03-31,461,Value,13209000,-8500000,863000,-7637000
59763,2021-05-16,461,Capital Call,-200000,-8700000,863000,-7837000
59763,2021-06-30,461,Value,15428500,-8700000,863000,-7837000
59764,2020-02-15,461,Distribution,2700000,-9400000,3440667,-5959333
59764,2020-03-31,461,Value,12495330,-9400000,3440667,-5959333
59764,2020-06-30,461,Value,12383330,-9400000,3440667,-5959333
59764,2020-09-30,461,Value,12818660,-9400000,3440667,-5959333
59764,2020-12-31,461,Value,16501330,-9400000,3440667,-5959333
59764,2021-02-14,461,Distribution,500000,-9400000,3940667,-5459333
59764,2021-03-31,461,Value,18904000,-9400000,3940667,-5459333
59764,2021-06-30,461,Value,21403330,-9400000,3940667,-5459333
59793,2020-02-15,458,Capital Call,-1335780,-8919193,401541,-8517652
59793,2020-02-15,458,Distribution,132945,-8919193,534486,-8384707
59793,2020-03-31,458,Value,9573140,-8919193,534486,-8384707
59793,2020-05-16,458,Capital Call,-286239,-9205432,534486,-8670946
59793,2020-05-16,458,Distribution,96443,-9205432,630929,-8574503
59793,2020-06-30,458,Value,9460240,-9205432,630929,-8574503
59793,2020-08-15,458,Capital Call,-104954,-9310386,630929,-8679457
59793,2020-08-15,458,Distribution,718818,-9310386,1349747,-7960639
59793,2020-09-30,458,Value,10044010,-9310386,1349747,-7960639
59793,2020-11-15,458,Capital Call,-531198,-9841584,1349747,-8491837
59793,2020-11-15,458,Distribution,923728,-9841584,2273475,-7568109
59793,2020-12-31,458,Value,10613510,-9841584,2273475,-7568109
59793,2021-02-14,458,Capital Call,-45137,-9886721,2273475,-7613246
59793,2021-02-14,458,Distribution,35770,-9886721,2309245,-7577476
59793,2021-03-31,458,Value,10587110,-9886721,2309245,-7577476
59793,2021-05-16,458,Capital Call,-337083,-10223804,2309245,-7914559
59793,2021-05-16,458,Distribution,987092,-10223804,3296337,-6927467
59793,2021-06-30,458,Value,12427840,-10223804,3296337,-6927467
59793,2021-08-15,458,Capital Call,-174990,-10398794,3296337,-7102457
59793,2021-08-15,458,Distribution,991615,-10398794,4287952,-6110842
59793,2021-09-30,458,Value,12718610,-10398794,4287952,-6110842
59867,2020-02-15,8710,Capital Call,-940000,-6884999,3120667,-3764332
59867,2020-03-31,8710,Value,8360330,-6884999,3120667,-3764332
59867,2020-05-16,8710,Capital Call,-518333,-7403332,3120667,-4282665
59867,2020-06-30,8710,Value,10093000,-7403332,3120667,-4282665
59867,2020-08-15,8710,Capital Call,-654000,-8057332,3120667,-4936665
59867,2020-09-30,8710,Value,11217660,-8057332,3120667,-4936665
59867,2020-11-15,8710,Distribution,2354333,-8057332,5475000,-2582332
59867,2020-12-31,8710,Value,10423330,-8057332,5475000,-2582332
59867,2021-02-14,8710,Capital Call,-245000,-8302332,5475000,-2827332
59867,2021-03-31,8710,Value,10740330,-8302332,5475000,-2827332
59872,2020-03-31,124,Value,5785900,-5683193,348800,-5334393
59872,2020-06-30,124,Value,5685080,-5683193,348800,-5334393
59872,2020-09-30,124,Value,6078780,-5683193,348800,-5334393
59872,2020-12-31,124,Value,6022110,-5683193,348800,-5334393
59872,2021-02-14,124,Capital Call,-951751,-6634944,348800,-6286144
59872,2021-02-14,124,Distribution,2116411,-6634944,2465211,-4169733
59872,2021-03-31,124,Value,5987960,-6634944,2465211,-4169733
59898,2020-03-31,112924,Value,12996930,-8740392,0,-8740392
59898,2020-05-16,112924,Capital Call,-212204,-8952596,0,-8952596
59898,2020-06-30,112924,Value,13183900,-8952596,0,-8952596
59898,2020-08-15,112924,Capital Call,-210986,-9163582,0,-9163582
59898,2020-09-30,112924,Value,13246150,-9163582,0,-9163582
59898,2020-11-15,112924,Capital Call,-264763,-9428345,0,-9428345
59898,2020-12-31,112924,Value,13525370,-9428345,0,-9428345
59898,2021-02-14,112924,Capital Call,-222969,-9651314,0,-9651314
59898,2021-03-31,112924,Value,15034140,-9651314,0,-9651314
59898,2021-05-16,112924,Capital Call,-263869,-9915183,0,-9915183
59898,2021-06-30,112924,Value,16700960,-9915183,0,-9915183
59929,2020-03-31,24,Value,6017090,-5000000,531624,-4468376
59929,2020-05-16,24,Capital Call,-300178,-5300178,531624,-4768554
59929,2020-05-16,24,Distribution,18,-5300178,531642,-4768536
59929,2020-06-30,24,Value,6269570,-5300178,531642,-4768536
59929,2020-08-15,24,Capital Call,178,-5300000,531642,-4768358
59929,2020-08-15,24,Distribution,31139,-5300000,562781,-4737219
59929,2020-09-30,24,Value,6855310,-5300000,562781,-4737219
59929,2020-12-31,24,Value,8578500,-5300000,562781,-4737219
59929,2021-02-14,24,Capital Call,-178,-5300178,562781,-4737397
59929,2021-02-14,24,Distribution,19,-5300178,562800,-4737378
59929,2021-03-31,24,Value,9573630,-5300178,562800,-4737378
59929,2021-05-16,24,Capital Call,-499822,-5800000,562800,-5237200
59929,2021-05-16,24,Distribution,-19,-5800000,562781,-5237219
59929,2021-06-30,24,Value,11249710,-5800000,562781,-5237219
59929,2021-08-15,24,Capital Call,-100000,-5900000,562781,-5337219
59929,2021-09-30,24,Value,12227390,-5900000,562781,-5337219
59977,2020-02-15,81348,Capital Call,24182,-6754000,0,-6754000
59977,2020-03-31,81348,Value,7775880,-6754000,0,-6754000
59977,2020-05-16,81348,Capital Call,-118727,-6872727,0,-6872727
59977,2020-06-30,81348,Value,8087270,-6872727,0,-6872727
59977,2020-09-30,81348,Value,8800000,-6872727,0,-6872727
59977,2020-11-15,81348,Capital Call,-1061818,-7934545,0,-7934545
59977,2020-12-31,81348,Value,10421810,-7934545,0,-7934545
59977,2021-03-31,81348,Value,12334540,-7934545,0,-7934545
59977,2021-05-16,81348,Capital Call,-72727,-8007272,0,-8007272
59977,2021-05-16,81348,Distribution,6792727,-8007272,6792727,-1214545
59977,2021-06-30,81348,Value,7141810,-8007272,6792727,-1214545
59977,2021-08-15,81348,Capital Call,-437091,-8444363,6792727,-1651636
59977,2021-08-15,81348,Distribution,2909,-8444363,6795636,-1648727
59977,2021-09-30,81348,Value,8238540,-8444363,6795636,-1648727
60017,2020-02-15,8072,Capital Call,-300000,-8350400,0,-8350400
60017,2020-03-31,8072,Value,8961600,-8350400,0,-8350400
60017,2020-05-16,8072,Capital Call,-400000,-8750400,0,-8750400
60017,2020-06-30,8072,Value,9996000,-8750400,0,-8750400
60017,2020-08-15,8072,Distribution,1684800,-8750400,1684800,-7065600
60017,2020-09-30,8072,Value,8486400,-8750400,1684800,-7065600
60017,2020-11-15,8072,Capital Call,-300000,-9050400,1684800,-7365600
60017,2020-12-31,8072,Value,8918400,-9050400,1684800,-7365600
60017,2021-02-14,8072,Capital Call,-400000,-9450400,1684800,-7765600
60017,2021-03-31,8072,Value,9835200,-9450400,1684800,-7765600
60017,2021-05-16,8072,Capital Call,-200000,-9650400,1684800,-7965600
60017,2021-06-30,8072,Value,16735200,-9650400,1684800,-7965600
60024,2020-03-31,350,Value,13505540,-7528975,37181,-7491794
60024,2020-06-30,350,Value,13505540,-7528975,37181,-7491794
60024,2020-09-30,350,Value,14997020,-7528975,37181,-7491794
60024,2020-12-31,350,Value,15862940,-7528975,37181,-7491794
60024,2021-02-14,350,Distribution,864220,-7528975,901401,-6627574
60024,2021-03-31,350,Value,18714120,-7528975,901401,-6627574
60024,2021-05-16,350,Capital Call,-20,-7528995,901401,-6627594
60024,2021-05-16,350,Distribution,1492135,-7528995,2393536,-5135459
60024,2021-06-30,350,Value,21534560,-7528995,2393536,-5135459
60156,2020-02-15,14,Capital Call,-600000,-6700000,0,-6700000
60156,2020-03-31,14,Value,7402640,-6700000,0,-6700000
60156,2020-06-30,14,Value,7231250,-6700000,0,-6700000
60156,2020-09-30,14,Value,7197950,-6700000,0,-6700000
60162,2020-03-31,296,Value,5450000,-5450000,327000,-5123000
60162,2020-06-30,296,Value,6213000,-5450000,327000,-5123000
60192,2020-03-31,70170,Value,1727510,-2348736,196338,-2152398
60192,2020-06-30,70170,Value,1972300,-2348736,196338,-2152398
60192,2020-09-30,70170,Value,2075780,-2348736,196338,-2152398
60192,2020-11-15,70170,Capital Call,-825468,-3174204,196338,-2977866
60192,2020-12-31,70170,Value,2926740,-3174204,196338,-2977866
60192,2021-03-31,70170,Value,3080420,-3174204,196338,-2977866
60309,2020-01-15,52,Capital Call,-750000,-8950000,13087,-8936913
60309,2020-02-29,52,Value,14703860,-8950000,13087,-8936913
60309,2020-04-15,52,Capital Call,-100000,-9050000,13087,-9036913
60309,2020-05-31,52,Value,20226600,-9050000,13087,-9036913
60309,2020-07-16,52,Capital Call,-250000,-9300000,13087,-9286913
60309,2020-08-31,52,Value,24786910,-9300000,13087,-9286913
60309,2020-10-16,52,Capital Call,-150000,-9450000,13087,-9436913
60309,2020-10-16,52,Distribution,124487,-9450000,137574,-9312426
60309,2020-11-30,52,Value,23049570,-9450000,137574,-9312426
60309,2021-01-14,52,Capital Call,-200000,-9650000,137574,-9512426
60309,2021-01-14,52,Distribution,132129,-9650000,269703,-9380297
60309,2021-02-28,52,Value,23150270,-9650000,269703,-9380297
60309,2021-04-15,52,Distribution,1870490,-9650000,2140193,-7509807
60309,2021-05-31,52,Value,33126000,-9650000,2140193,-7509807
60309,2021-07-16,52,Capital Call,-100000,-9750000,2140193,-7609807
60309,2021-07-16,52,Distribution,5949798,-9750000,8089991,-1660009
60309,2021-08-31,52,Value,29338360,-9750000,8089991,-1660009
60309,2021-10-16,52,Capital Call,-250000,-10000000,8089991,-1910009
60309,2021-10-16,52,Distribution,329303,-10000000,8419294,-1580706
60309,2021-11-30,52,Value,30391440,-10000000,8419294,-1580706
60311,2020-02-15,24103,Capital Call,-256836,-8839742,143627,-8696115
60311,2020-03-31,24103,Value,14955990,-8839742,143627,-8696115
60311,2020-05-16,24103,Capital Call,-259884,-9099626,143627,-8955999
60311,2020-06-30,24103,Value,15010810,-9099626,143627,-8955999
60311,2020-08-15,24103,Capital Call,-87537,-9187163,143627,-9043536
60311,2020-09-30,24103,Value,15744980,-9187163,143627,-9043536
60311,2020-11-15,24103,Capital Call,-49377,-9236540,143627,-9092913
60311,2020-12-31,24103,Value,18167760,-9236540,143627,-9092913
60311,2021-02-14,24103,Capital Call,-180245,-9416785,143627,-9273158
60311,2021-03-31,24103,Value,23466320,-9416785,143627,-9273158
60311,2021-05-16,24103,Capital Call,-19803,-9436588,143627,-9292961
60311,2021-06-30,24103,Value,23872410,-9436588,143627,-9292961
60311,2021-08-15,24103,Capital Call,-504598,-9941186,143627,-9797559
60311,2021-09-30,24103,Value,25177550,-9941186,143627,-9797559
60317,2020-03-31,2264,Value,9360000,-8000000,400000,-7600000
60317,2020-08-16,2264,Distribution,240000,-8000000,640000,-7360000
60317,2020-12-31,2264,Value,10160000,-8000000,640000,-7360000
60317,2021-02-14,2264,Capital Call,-1000000,-9000000,640000,-8360000
60317,2021-02-14,2264,Distribution,980000,-9000000,1620000,-7380000
60317,2021-03-31,2264,Value,11160000,-9000000,1620000,-7380000
60317,2021-05-16,2264,Distribution,810000,-9000000,2430000,-6570000
60317,2021-06-30,2264,Value,11250000,-9000000,2430000,-6570000
60317,2021-08-15,2264,Distribution,810000,-9000000,3240000,-5760000
60317,2021-09-30,2264,Value,10980000,-9000000,3240000,-5760000
60362,2020-05-16,178752,Capital Call,-98487,-12826023,9715898,-3110125
60362,2020-05-16,178752,Distribution,550430,-12826023,10266328,-2559695
60362,2020-09-30,178752,Value,4607970,-12826023,10266328,-2559695
60362,2020-11-15,178752,Capital Call,-60750,-12886773,10266328,-2620445
60362,2020-11-15,178752,Distribution,116857,-12886773,10383185,-2503588
60362,2020-12-31,178752,Value,4800130,-12886773,10383185,-2503588
60362,2021-02-14,178752,Capital Call,-30318,-12917091,10383185,-2533906
60362,2021-02-14,178752,Distribution,365180,-12917091,10748365,-2168726
60362,2021-03-31,178752,Value,4444120,-12917091,10748365,-2168726
60401,2020-03-31,795,Value,11090410,-9040001,876500,-8163501
60401,2020-05-16,795,Distribution,417950,-9040001,1294450,-7745551
60401,2020-06-30,795,Value,11438640,-9040001,1294450,-7745551
60401,2020-08-15,795,Capital Call,-410000,-9450001,1294450,-8155551
60401,2020-08-15,795,Distribution,351150,-9450001,1645600,-7804401
60401,2020-09-30,795,Value,12881120,-9450001,1645600,-7804401
60401,2020-12-31,795,Value,13823780,-9450001,1645600,-7804401
60401,2021-02-14,795,Distribution,585000,-9450001,2230600,-7219401
60401,2021-03-31,795,Value,14971360,-9450001,2230600,-7219401
60406,2020-01-15,9022,Capital Call,-500000,-7500000,0,-7500000
60406,2020-02-29,9022,Value,6829090,-7500000,0,-7500000
60406,2020-04-15,9022,Capital Call,-400000,-7900000,0,-7900000
60406,2020-05-31,9022,Value,7188230,-7900000,0,-7900000
60406,2020-07-16,9022,Capital Call,-400000,-8300000,0,-8300000
60406,2020-08-31,9022,Value,7583870,-8300000,0,-8300000
60406,2020-11-30,9022,Value,7549280,-8300000,0,-8300000
60406,2021-01-14,9022,Capital Call,-200000,-8500000,0,-8500000
60406,2021-02-28,9022,Value,7749280,-8500000,0,-8500000
60406,2021-04-15,9022,Capital Call,-800000,-9300000,0,-9300000
60406,2021-05-31,9022,Value,9188860,-9300000,0,-9300000
60406,2021-07-16,9022,Distribution,1449976,-9300000,1449976,-7850024
60406,2021-08-31,9022,Value,7796030,-9300000,1449976,-7850024
60406,2021-11-30,9022,Value,11127990,-9300000,1449976,-7850024
60509,2020-03-31,355,Value,9175800,-8089217,0,-8089217
60509,2020-06-30,355,Value,8098540,-8089217,0,-8089217
60509,2020-09-30,355,Value,9162300,-8089217,0,-8089217
60509,2020-12-31,355,Value,10337280,-8089217,0,-8089217
60509,2021-03-31,355,Value,9742380,-8089217,0,-8089217
60509,2021-06-30,355,Value,11468370,-8089217,0,-8089217
60510,2020-03-31,436,Value,5136000,-4800000,964800,-3835200
60510,2020-05-16,436,Capital Call,-980000,-5780000,964800,-4815200
60510,2020-05-16,436,Distribution,260560,-5780000,1225360,-4554640
60510,2020-06-30,436,Value,6161480,-5780000,1225360,-4554640
60510,2020-08-15,436,Capital Call,-530000,-6310000,1225360,-5084640
60510,2020-08-15,436,Distribution,5090,-6310000,1230450,-5079550
60510,2020-09-30,436,Value,7060890,-6310000,1230450,-5079550
60510,2020-11-15,436,Capital Call,-620000,-6930000,1230450,-5699550
60510,2020-11-15,436,Distribution,23880,-6930000,1254330,-5675670
60510,2020-12-31,436,Value,8752590,-6930000,1254330,-5675670
60510,2021-04-01,436,Capital Call,-560000,-7490000,1254330,-6235670
60510,2021-04-01,436,Distribution,445900,-7490000,1700230,-5789770
60510,2021-06-30,436,Value,10890460,-7490000,1700230,-5789770
60510,2021-08-15,436,Capital Call,-384000,-7874000,1700230,-6173770
60510,2021-08-15,436,Distribution,-20706,-7874000,1679524,-6194476
60510,2021-09-30,436,Value,13940120,-7874000,1679524,-6194476
60510,2021-11-15,436,Capital Call,-212000,-8086000,1679524,-6406476
60510,2021-11-15,436,Distribution,1664037,-8086000,3343561,-4742439
60510,2021-12-31,436,Value,13127620,-8086000,3343561,-4742439
60514,2020-02-15,161262,Capital Call,-227916,-8838174,2226782,-6611392
60514,2020-02-15,161262,Distribution,0,-8838174,2226782,-6611392
60514,2020-03-31,161262,Value,8191790,-8838174,2226782,-6611392
60514,2020-05-16,161262,Capital Call,-136442,-8974616,2226782,-6747834
60514,2020-06-30,161262,Value,9404910,-8974616,2226782,-6747834
60514,2020-09-30,161262,Value,9776290,-8974616,2226782,-6747834
60514,2020-11-15,161262,Capital Call,-65856,-9040472,2226782,-6813690
60514,2020-11-15,161262,Distribution,1914574,-9040472,4141356,-4899116
60514,2020-12-31,161262,Value,9543740,-9040472,4141356,-4899116
60514,2021-04-01,161262,Capital Call,-84512,-9124984,4141356,-4983628
60514,2021-04-01,161262,Distribution,54245,-9124984,4195601,-4929383
60514,2021-06-30,161262,Value,11811170,-9124984,4195601,-4929383
60538,2020-02-15,1759,Capital Call,-500000,-5400000,0,-5400000
60538,2020-03-31,1759,Value,5336940,-5400000,0,-5400000
60538,2020-05-16,1759,Capital Call,-500000,-5900000,0,-5900000
60538,2020-06-30,1759,Value,5690200,-5900000,0,-5900000
60538,2020-08-15,1759,Capital Call,-500000,-6400000,0,-6400000
60538,2020-09-30,1759,Value,6682740,-6400000,0,-6400000
60538,2020-11-15,1759,Capital Call,-500000,-6900000,0,-6900000
60538,2020-12-31,1759,Value,8070800,-6900000,0,-6900000
60538,2021-02-14,1759,Capital Call,-772740,-7672740,0,-7672740
60538,2021-02-14,1759,Distribution,272740,-7672740,272740,-7400000
60538,2021-03-31,1759,Value,8570800,-7672740,272740,-7400000
60538,2021-05-16,1759,Capital Call,-153973,-7826713,272740,-7553973
60538,2021-05-16,1759,Distribution,373187,-7826713,645927,-7180786
60538,2021-06-30,1759,Value,10069130,-7826713,645927,-7180786
60554,2020-02-15,423991,Capital Call,-57143,-9720000,2428572,-7291428
60554,2020-02-15,423991,Distribution,308571,-9720000,2737143,-6982857
60554,2020-03-31,423991,Value,7068570,-9720000,2737143,-6982857
60554,2020-05-16,423991,Capital Call,-371429,-10091429,2737143,-7354286
60554,2020-05-16,423991,Distribution,-5714,-10091429,2731429,-7360000
60554,2020-06-30,423991,Value,7639990,-10091429,2731429,-7360000
60554,2020-08-15,423991,Capital Call,-542857,-10634286,2731429,-7902857
60554,2020-08-15,423991,Distribution,268571,-10634286,3000000,-7634286
60554,2020-09-30,423991,Value,8039990,-10634286,3000000,-7634286
60554,2020-11-15,423991,Capital Call,-177143,-10811429,3000000,-7811429
60554,2020-11-15,423991,Distribution,2040000,-10811429,5040000,-5771429
60554,2020-12-31,423991,Value,6851420,-10811429,5040000,-5771429
60554,2021-02-14,423991,Distribution,274286,-10811429,5314286,-5497143
60554,2021-03-31,423991,Value,6919990,-10811429,5314286,-5497143
60554,2021-05-16,423991,Capital Call,-85714,-10897143,5314286,-5582857
60554,2021-05-16,423991,Distribution,11429,-10897143,5325715,-5571428
60554,2021-06-30,423991,Value,8222850,-10897143,5325715,-5571428
60554,2021-08-15,423991,Capital Call,-57143,-10954286,5325715,-5628571
60554,2021-08-15,423991,Distribution,48571,-10954286,5374286,-5580000
60554,2021-09-30,423991,Value,8634280,-10954286,5374286,-5580000
60583,2020-03-31,22036,Value,4711600,-4854308,0,-4854308
60583,2020-05-16,22036,Capital Call,-868024,-5722332,0,-5722332
60583,2020-06-30,22036,Value,6314460,-5722332,0,-5722332
60583,2020-09-30,22036,Value,6691670,-5722332,0,-5722332
60583,2020-11-15,22036,Capital Call,-644839,-6367171,0,-6367171
60583,2020-12-31,22036,Value,7721380,-6367171,0,-6367171
60583,2021-03-31,22036,Value,8193010,-6367171,0,-6367171
60662,2020-02-15,77,Capital Call,-474769,-9474769,360000,-9114769
60662,2020-02-15,77,Distribution,-44158,-9474769,315842,-9158927
60662,2020-03-31,77,Value,10517970,-9474769,315842,-9158927
60662,2020-05-16,77,Capital Call,352769,-9122000,315842,-8806158
60662,2020-05-16,77,Distribution,955765,-9122000,1271607,-7850393
60662,2020-06-30,77,Value,9320850,-9122000,1271607,-7850393
60662,2020-09-30,77,Value,9827130,-9122000,1271607,-7850393
60662,2020-11-15,77,Distribution,1308095,-9122000,2579702,-6542298
60662,2020-12-31,77,Value,8944120,-9122000,2579702,-6542298
60662,2021-03-31,77,Value,9201360,-9122000,2579702,-6542298
60662,2021-05-16,77,Distribution,384948,-9122000,2964650,-6157350
60662,2021-06-30,77,Value,8958710,-9122000,2964650,-6157350
60662,2021-08-15,77,Distribution,790877,-9122000,3755527,-5366473
60662,2021-09-30,77,Value,8279120,-9122000,3755527,-5366473
60675,2020-02-15,24,Capital Call,-500000,-8400000,1746690,-6653310
60675,2020-02-15,24,Distribution,418830,-8400000,2165520,-6234480
60675,2020-03-31,24,Value,9626400,-8400000,2165520,-6234480
60675,2020-05-16,24,Capital Call,-201000,-8601000,2165520,-6435480
60675,2020-05-16,24,Distribution,212,-8601000,2165732,-6435268
60675,2020-06-30,24,Value,10709100,-8601000,2165732,-6435268
60675,2020-08-15,24,Capital Call,-349000,-8950000,2165732,-6784268
60675,2020-08-15,24,Distribution,178273,-8950000,2344005,-6605995
60675,2020-09-30,24,Value,11890070,-8950000,2344005,-6605995
60675,2020-12-31,24,Value,15095960,-8950000,2344005,-6605995
60675,2021-02-14,24,Capital Call,-450000,-9400000,2344005,-7055995
60675,2021-02-14,24,Distribution,1054095,-9400000,3398100,-6001900
60675,2021-03-31,24,Value,16273280,-9400000,3398100,-6001900
60675,2021-05-16,24,Distribution,344040,-9400000,3742140,-5657860
60675,2021-06-30,24,Value,17872220,-9400000,3742140,-5657860
60718,2020-03-31,733,Value,22230,-9803509,21675305,11871796
60718,2020-09-30,733,Value,11310,-9803509,21675305,11871796
60718,2020-11-15,733,Distribution,9205,-9803509,21684510,11881001
60718,2020-12-31,733,Value,0,-9803509,21684510,11881001
60718,2021-06-30,733,Value,0,-9803509,21684510,11881001
60718,2021-09-30,733,Value,0,-9803509,21684510,11881001
60718,2021-12-31,733,Value,0,-9803509,21684510,11881001
60732,2020-03-31,613,Value,10181380,-11153254,7425725,-3727529
60732,2020-05-16,613,Capital Call,-87978,-11241232,7425725,-3815507
60732,2020-05-16,613,Distribution,35425,-11241232,7461150,-3780082
60732,2020-06-30,613,Value,10654690,-11241232,7461150,-3780082
60732,2020-08-15,613,Capital Call,-141347,-11382579,7461150,-3921429
60732,2020-09-30,613,Value,16298530,-11382579,7461150,-3921429
60732,2020-11-15,613,Capital Call,-433434,-11816013,7461150,-4354863
60732,2020-11-15,613,Distribution,5621452,-11816013,13082602,1266589
60732,2020-12-31,613,Value,12391480,-11816013,13082602,1266589
60732,2021-03-31,613,Value,16384900,-11816013,13082602,1266589
60776,2020-02-15,14,Capital Call,-753846,-8523079,0,-8523079
60776,2020-03-31,14,Value,14712250,-8523079,0,-8523079
60802,2020-02-15,8072,Capital Call,-1150000,-8850000,0,-8850000
60802,2020-03-31,8072,Value,10033500,-8850000,0,-8850000
60802,2020-05-16,8072,Capital Call,-100000,-8950000,0,-8950000
60802,2020-06-30,8072,Value,10763500,-8950000,0,-8950000
60802,2020-09-30,8072,Value,11933500,-8950000,0,-8950000
60802,2020-12-31,8072,Value,11910500,-8950000,0,-8950000
60802,2021-03-31,8072,Value,13164000,-8950000,0,-8950000
60810,2020-01-15,14497,Capital Call,-87500,-8305966,0,-8305966
60810,2020-02-29,14497,Value,9998450,-8305966,0,-8305966
60810,2020-04-15,14497,Capital Call,-200000,-8505966,0,-8505966
60810,2020-05-31,14497,Value,10163710,-8505966,0,-8505966
60810,2020-07-16,14497,Capital Call,-437500,-8943466,0,-8943466
60810,2020-08-31,14497,Value,10360290,-8943466,0,-8943466
60810,2020-11-30,14497,Value,11688140,-8943466,0,-8943466
60810,2021-01-14,14497,Capital Call,-150000,-9093466,0,-9093466
60810,2021-02-28,14497,Value,13828290,-9093466,0,-9093466
60810,2021-04-15,14497,Capital Call,-165488,-9258954,0,-9258954
60810,2021-04-15,14497,Distribution,553488,-9258954,553488,-8705466
60810,2021-05-31,14497,Value,13660620,-9258954,553488,-8705466
60810,2021-08-31,14497,Value,16338850,-9258954,553488,-8705466
60810,2021-10-16,14497,Capital Call,0,-9258954,553488,-8705466
60810,2021-10-16,14497,Distribution,0,-9258954,553488,-8705466
60810,2021-11-30,14497,Value,18841950,-9258954,553488,-8705466
60860,2020-02-15,7234,Capital Call,-24444,-7226667,542222,-6684445
60860,2020-02-15,7234,Distribution,1515556,-7226667,2057778,-5168889
60860,2020-03-31,7234,Value,6437770,-7226667,2057778,-5168889
60860,2020-05-16,7234,Capital Call,2222,-7224445,2057778,-5166667
60860,2020-05-16,7234,Distribution,37778,-7224445,2095556,-5128889
60860,2020-06-30,7234,Value,6686660,-7224445,2095556,-5128889
60860,2020-08-15,7234,Capital Call,-35556,-7260001,2095556,-5164445
60860,2020-09-30,7234,Value,10286660,-7260001,2095556,-5164445
60860,2020-11-15,7234,Capital Call,-371111,-7631112,2095556,-5535556
60860,2020-12-31,7234,Value,12999990,-7631112,2095556,-5535556
60860,2021-02-14,7234,Capital Call,-1613333,-9244445,2095556,-7148889
60860,2021-03-31,7234,Value,13044440,-9244445,2095556,-7148889
60860,2021-05-16,7234,Capital Call,-120000,-9364445,2095556,-7268889
60860,2021-06-30,7234,Value,17284440,-9364445,2095556,-7268889
60860,2021-08-15,7234,Capital Call,-1333,-9365778,2095556,-7270222
60860,2021-08-15,7234,Distribution,640889,-9365778,2736445,-6629333
60860,2021-09-30,7234,Value,13809770,-9365778,2736445,-6629333
60920,2020-02-15,2901,Capital Call,-44444,-844444,177778,-666666
60920,2020-02-15,2901,Distribution,133333,-844444,311111,-533333
60920,2020-03-31,2901,Value,977770,-844444,311111,-533333
60920,2020-07-01,2901,Capital Call,-177778,-1022222,311111,-711111
60920,2020-07-01,2901,Distribution,222222,-1022222,533333,-488889
60920,2020-09-30,2901,Value,977770,-1022222,533333,-488889
60920,2020-11-15,2901,Distribution,444444,-1022222,977777,-44445
60920,2020-12-31,2901,Value,977770,-1022222,977777,-44445
60920,2021-03-31,2901,Value,933330,-1022222,977777,-44445
61166,2020-02-15,191595,Capital Call,-1400000,-7230000,1716987,-5513013
61166,2020-03-31,191595,Value,6890190,-7230000,1716987,-5513013
61166,2020-05-16,191595,Distribution,104973,-7230000,1821960,-5408040
61166,2020-06-30,191595,Value,6861270,-7230000,1821960,-5408040
61166,2020-08-15,191595,Capital Call,-160000,-7390000,1821960,-5568040
61166,2020-08-15,191595,Distribution,-4020,-7390000,1817940,-5572060
61166,2020-09-30,191595,Value,7360440,-7390000,1817940,-5572060
61166,2020-11-15,191595,Capital Call,1000,-7389000,1817940,-5571060
61166,2020-11-15,191595,Distribution,2710,-7389000,1820650,-5568350
61166,2020-12-31,191595,Value,7748840,-7389000,1820650,-5568350
61166,2021-03-31,191595,Value,9040440,-7389000,1820650,-5568350
61166,2021-05-16,191595,Capital Call,-1269000,-8658000,1820650,-6837350
61166,2021-05-16,191595,Distribution,295366,-8658000,2116016,-6541984
61166,2021-06-30,191595,Value,11271850,-8658000,2116016,-6541984
61166,2021-09-30,191595,Value,11498680,-8658000,2116016,-6541984
61166,2021-11-15,191595,Capital Call,-200000,-8858000,2116016,-6741984
61166,2021-11-15,191595,Distribution,161,-8858000,2116177,-6741823
61166,2021-12-31,191595,Value,12214290,-8858000,2116177,-6741823
61179,2020-03-31,656,Value,6310260,-6400177,1947031,-4453146
61179,2020-07-01,656,Capital Call,-218514,-6618691,1947031,-4671660
61179,2020-07-01,656,Distribution,-1079055,-6618691,867976,-5750715
61179,2020-09-30,656,Value,8404590,-6618691,867976,-5750715
61179,2020-11-15,656,Capital Call,83676,-6535015,867976,-5667039
61179,2020-11-15,656,Distribution,115576,-6535015,983552,-5551463
61179,2020-12-31,656,Value,8843590,-6535015,983552,-5551463
61179,2021-02-14,656,Capital Call,6138,-6528877,983552,-5545325
61179,2021-02-14,656,Distribution,366957,-6528877,1350509,-5178368
61179,2021-03-31,656,Value,9100980,-6528877,1350509,-5178368
61179,2021-06-30,656,Value,10048210,-6528877,1350509,-5178368
61253,2020-02-15,496,Capital Call,-198000,-9062460,392762,-8669698
61253,2020-03-31,496,Value,10749450,-9062460,392762,-8669698
61253,2020-06-30,496,Value,10735540,-9062460,392762,-8669698
61253,2020-09-30,496,Value,17742860,-9062460,392762,-8669698
61253,2020-11-15,496,Capital Call,-673200,-9735660,392762,-9342898
61253,2020-12-31,496,Value,19595600,-9735660,392762,-9342898
61253,2021-03-31,496,Value,19566960,-9735660,392762,-9342898
61253,2021-05-16,496,Capital Call,-264340,-10000000,392762,-9607238
61253,2021-06-30,496,Value,22644700,-10000000,392762,-9607238
61326,2020-01-15,302,Capital Call,-125000,-6950000,1710000,-5240000
61326,2020-02-29,302,Value,8446810,-6950000,1710000,-5240000
61326,2020-04-15,302,Capital Call,0,-6950000,1710000,-5240000
61326,2020-05-31,302,Value,9275760,-6950000,1710000,-5240000
61326,2020-07-16,302,Capital Call,-1950000,-8900000,1710000,-7190000
61326,2020-08-31,302,Value,12718730,-8900000,1710000,-7190000
61326,2020-11-30,302,Value,14677680,-8900000,1710000,-7190000
61326,2021-01-14,302,Distribution,125000,-8900000,1835000,-7065000
61326,2021-02-28,302,Value,18811500,-8900000,1835000,-7065000
61326,2021-04-15,302,Distribution,7550000,-8900000,9385000,485000
61326,2021-05-31,302,Value,12722520,-8900000,9385000,485000
61326,2021-08-31,302,Value,19033190,-8900000,9385000,485000
61326,2021-10-16,302,Capital Call,0,-8900000,9385000,485000
61326,2021-10-16,302,Distribution,8075000,-8900000,17460000,8560000
61326,2021-11-30,302,Value,15198160,-8900000,17460000,8560000
61329,2020-02-15,487,Capital Call,-900000,-5800000,0,-5800000
61329,2020-03-31,487,Value,11662000,-5800000,0,-5800000
61329,2020-06-30,487,Value,12324000,-5800000,0,-5800000
61329,2020-09-30,487,Value,12534000,-5800000,0,-5800000
61329,2020-11-15,487,Distribution,1088000,-5800000,1088000,-4712000
61329,2020-12-31,487,Value,13000000,-5800000,1088000,-4712000
61329,2021-02-14,487,Capital Call,-600000,-6400000,1088000,-5312000
61329,2021-03-31,487,Value,17080000,-6400000,1088000,-5312000
61329,2021-05-16,487,Capital Call,-1100000,-7500000,1088000,-6412000
61329,2021-06-30,487,Value,21932000,-7500000,1088000,-6412000
61339,2020-02-15,458,Capital Call,-548628,-4539086,1331282,-3207804
61339,2020-02-15,458,Distribution,163990,-4539086,1495272,-3043814
61339,2020-03-31,458,Value,4375700,-4539086,1495272,-3043814
61339,2020-05-16,458,Capital Call,-378813,-4917899,1495272,-3422627
61339,2020-05-16,458,Distribution,199501,-4917899,1694773,-3223126
61339,2020-06-30,458,Value,5296790,-4917899,1694773,-3223126
61339,2020-08-15,458,Capital Call,-695889,-5613788,1694773,-3919015
61339,2020-08-15,458,Distribution,678564,-5613788,2373337,-3240451
61339,2020-09-30,458,Value,5537350,-5613788,2373337,-3240451
61339,2020-11-15,458,Distribution,124688,-5613788,2498025,-3115763
61339,2020-12-31,458,Value,6296000,-5613788,2498025,-3115763
61339,2021-02-14,458,Capital Call,-528678,-6142466,2498025,-3644441
61339,2021-02-14,458,Distribution,262264,-6142466,2760289,-3382177
61339,2021-03-31,458,Value,6994340,-6142466,2760289,-3382177
61340,2020-02-15,192093,Capital Call,-602706,-6268525,108770,-6159755
61340,2020-02-15,192093,Distribution,70265,-6268525,179035,-6089490
61340,2020-03-31,192093,Value,6729590,-6268525,179035,-6089490
61340,2020-05-16,192093,Capital Call,-258051,-6526576,179035,-6347541
61340,2020-06-30,192093,Value,7275810,-6526576,179035,-6347541
61340,2020-08-15,192093,Capital Call,-486749,-7013325,179035,-6834290
61340,2020-08-15,192093,Distribution,131039,-7013325,310074,-6703251
61340,2020-09-30,192093,Value,8060220,-7013325,310074,-6703251
61340,2020-11-15,192093,Capital Call,-495335,-7508660,310074,-7198586
61340,2020-12-31,192093,Value,9408670,-7508660,310074,-7198586
61340,2021-02-14,192093,Capital Call,-438505,-7947165,310074,-7637091
61340,2021-02-14,192093,Distribution,12964,-7947165,323038,-7624127
61340,2021-03-31,192093,Value,12222450,-7947165,323038,-7624127
61402,2020-02-15,15641,Capital Call,-6230,-4782275,3375399,-1406876
61402,2020-02-15,15641,Distribution,241493,-4782275,3616892,-1165383
61402,2020-03-31,15641,Value,3813380,-4782275,3616892,-1165383
61402,2020-05-16,15641,Capital Call,-789568,-5571843,3616892,-1954951
61402,2020-05-16,15641,Distribution,34391,-5571843,3651283,-1920560
61402,2020-06-30,15641,Value,4968960,-5571843,3651283,-1920560
61402,2020-08-15,15641,Capital Call,-1668116,-7239959,3651283,-3588676
61402,2020-08-15,15641,Distribution,14536,-7239959,3665819,-3574140
61402,2020-09-30,15641,Value,6600240,-7239959,3665819,-3574140
61559,2020-03-31,77,Value,7812030,-5795799,1562292,-4233507
61559,2020-06-30,77,Value,7378130,-5795799,1562292,-4233507
61559,2020-08-15,77,Capital Call,-333111,-6128910,1562292,-4566618
61559,2020-08-15,77,Distribution,999334,-6128910,2561626,-3567284
61559,2020-09-30,77,Value,7085480,-6128910,2561626,-3567284
61559,2020-11-15,77,Distribution,333111,-6128910,2894737,-3234173
61559,2020-12-31,77,Value,7149680,-6128910,2894737,-3234173
61559,2021-02-14,77,Capital Call,-39973,-6168883,2894737,-3274146
61559,2021-02-14,77,Distribution,1105929,-6168883,4000666,-2168217
61559,2021-03-31,77,Value,6161980,-6168883,4000666,-2168217
61559,2021-05-16,77,Distribution,667265,-6168883,4667931,-1500952
61559,2021-06-30,77,Value,6176400,-6168883,4667931,-1500952
61720,2020-02-15,23580,Capital Call,-349967,-5621184,805604,-4815580
61720,2020-02-15,23580,Distribution,-326955,-5621184,478649,-5142535
61720,2020-03-31,23580,Value,4543940,-5621184,478649,-5142535
61720,2020-05-16,23580,Capital Call,-55296,-5676480,478649,-5197831
61720,2020-05-16,23580,Distribution,723584,-5676480,1202233,-4474247
61720,2020-06-30,23580,Value,3431920,-5676480,1202233,-4474247
61720,2020-12-31,23580,Value,3997070,-5676480,1202233,-4474247
61720,2021-02-14,23580,Capital Call,-260010,-5936490,1202233,-4734257
61720,2021-02-14,23580,Distribution,1014627,-5936490,2216860,-3719630
61720,2021-03-31,23580,Value,3972420,-5936490,2216860,-3719630
61720,2021-05-16,23580,Capital Call,-1035385,-6971875,2216860,-4755015
61720,2021-05-16,23580,Distribution,0,-6971875,2216860,-4755015
61720,2021-06-30,23580,Value,8082300,-6971875,2216860,-4755015
61770,2020-03-31,14209,Value,4240000,-6912000,1816667,-5095333
61770,2020-07-01,14209,Capital Call,-83333,-6995333,1816667,-5178666
61770,2020-09-30,14209,Value,5973330,-6995333,1816667,-5178666
61770,2020-11-15,14209,Capital Call,-248000,-7243333,1816667,-5426666
61770,2020-12-31,14209,Value,6700660,-7243333,1816667,-5426666
61770,2021-02-14,14209,Capital Call,-48667,-7292000,1816667,-5475333
61770,2021-03-31,14209,Value,6740000,-7292000,1816667,-5475333
61770,2021-06-30,14209,Value,7269330,-7292000,1816667,-5475333
61969,2020-03-31,588,Capital Call,-1253548,-5300000,193388,-5106612
61969,2020-06-30,588,Value,5707840,-5300000,193388,-5106612
61969,2020-08-15,588,Capital Call,-200000,-5500000,193388,-5306612
61969,2020-09-30,588,Value,6286260,-5500000,193388,-5306612
61969,2020-11-15,588,Capital Call,-944388,-6444388,193388,-6251000
61969,2020-11-15,588,Distribution,866088,-6444388,1059476,-5384912
61969,2020-12-31,588,Value,7268710,-6444388,1059476,-5384912
61969,2021-02-14,588,Capital Call,-400000,-6844388,1059476,-5784912
61969,2021-02-14,588,Distribution,315089,-6844388,1374565,-5469823
61969,2021-03-31,588,Value,8171410,-6844388,1374565,-5469823
62005,2020-03-31,134353,Capital Call,-527336,-6156073,622373,-5533700
62005,2020-03-31,134353,Value,6896190,-6156073,622373,-5533700
62005,2020-05-07,134353,Distribution,353924,-6156073,976297,-5179776
62005,2020-08-05,134353,Capital Call,-463771,-6619844,976297,-5643547
62005,2020-09-30,134353,Value,8220770,-6619844,976297,-5643547
62005,2020-12-31,134353,Value,9488540,-6619844,976297,-5643547
62005,2021-06-30,134353,Value,14022540,-6619844,976297,-5643547
62153,2020-02-15,2317,Capital Call,-1160000,-9710000,666900,-9043100
62153,2020-02-15,2317,Distribution,-103720,-9710000,563180,-9146820
62153,2020-03-31,2317,Value,12234600,-9710000,563180,-9146820
62153,2020-06-30,2317,Value,12749230,-9710000,563180,-9146820
62153,2020-09-30,2317,Value,12778360,-9710000,563180,-9146820
62153,2020-11-15,2317,Capital Call,320000,-9390000,563180,-8826820
62153,2020-11-15,2317,Distribution,197410,-9390000,760590,-8629410
62153,2020-12-31,2317,Value,13934760,-9390000,760590,-8629410
62153,2021-02-14,2317,Capital Call,-350000,-9740000,760590,-8979410
62153,2021-02-14,2317,Distribution,1586750,-9740000,2347340,-7392660
62153,2021-03-31,2317,Value,16441120,-9740000,2347340,-7392660
62154,2020-02-15,2317,Capital Call,910000,-8800000,330140,-8469860
62154,2020-02-15,2317,Distribution,-74940,-8800000,255200,-8544800
62154,2020-03-31,2317,Value,9574400,-8800000,255200,-8544800
62154,2020-06-30,2317,Value,9979200,-8800000,255200,-8544800
62154,2020-08-15,2317,Capital Call,-80000,-8880000,255200,-8624800
62154,2020-08-15,2317,Distribution,37840,-8880000,293040,-8586960
62154,2020-09-30,2317,Value,10229760,-8880000,293040,-8586960
62154,2020-11-15,2317,Capital Call,450000,-8430000,293040,-8136960
62154,2020-11-15,2317,Distribution,-6420,-8430000,286620,-8143380
62154,2020-12-31,2317,Value,12097050,-8430000,286620,-8143380
62154,2021-03-31,2317,Value,13884210,-8430000,286620,-8143380
62156,2020-03-31,428403,Value,21651760,-10076305,1546854,-8529451
62156,2020-06-30,428403,Value,21633510,-10076305,1546854,-8529451
62156,2020-08-15,428403,Capital Call,-15217,-10091522,1546854,-8544668
62156,2020-08-15,428403,Distribution,804593,-10091522,2351447,-7740075
62156,2020-09-30,428403,Value,25128600,-10091522,2351447,-7740075
62156,2020-12-31,428403,Value,28795240,-10091522,2351447,-7740075
62156,2021-02-14,428403,Capital Call,12748,-10078774,2351447,-7727327
62156,2021-02-14,428403,Distribution,397630,-10078774,2749077,-7329697
62156,2021-03-31,428403,Value,29680030,-10078774,2749077,-7329697
62156,2021-06-30,428403,Value,28932000,-10078774,2749077,-7329697
62156,2021-09-30,428403,Value,23777330,-10078774,2749077,-7329697
62213,2020-02-15,5782,Capital Call,-537117,-15295640,12920297,-2375343
62213,2020-02-15,5782,Distribution,527154,-15295640,13447451,-1848189
62213,2020-03-31,5782,Value,12633920,-15295640,13447451,-1848189
62213,2020-05-16,5782,Capital Call,-262821,-15558461,13447451,-2111010
62213,2020-05-16,5782,Distribution,1174651,-15558461,14622102,-936359
62213,2020-06-30,5782,Value,13777400,-15558461,14622102,-936359
62213,2020-08-15,5782,Capital Call,-219571,-15778032,14622102,-1155930
62213,2020-08-15,5782,Distribution,1205712,-15778032,15827814,49782
62213,2020-09-30,5782,Value,19098370,-15778032,15827814,49782
62213,2020-11-15,5782,Capital Call,-228589,-16006621,15827814,-178807
62213,2020-11-15,5782,Distribution,675452,-16006621,16503266,496645
62213,2020-12-31,5782,Value,23962640,-16006621,16503266,496645
62213,2021-02-14,5782,Capital Call,-96860,-16103481,16503266,399785
62213,2021-02-14,5782,Distribution,3553497,-16103481,20056763,3953282
62213,2021-03-31,5782,Value,23563060,-16103481,20056763,3953282
62213,2021-05-16,5782,Capital Call,-2346952,-18450433,20056763,1606330
62213,2021-05-16,5782,Distribution,3464908,-18450433,23521671,5071238
62213,2021-06-30,5782,Value,23099720,-18450433,23521671,5071238
62213,2021-08-15,5782,Capital Call,-135427,-18585860,23521671,4935811
62213,2021-08-15,5782,Distribution,2213739,-18585860,25735410,7149550
62213,2021-09-30,5782,Value,22219420,-18585860,25735410,7149550
62305,2020-02-15,391,Capital Call,-200000,-3500000,0,-3500000
62305,2020-03-31,391,Value,3010000,-3500000,0,-3500000
62305,2020-05-16,391,Capital Call,-700000,-4200000,0,-4200000
62305,2020-06-30,391,Value,4074000,-4200000,0,-4200000
62305,2020-08-15,391,Capital Call,-1400000,-5600000,0,-5600000
62305,2020-09-30,391,Value,5600000,-5600000,0,-5600000
62305,2020-11-15,391,Capital Call,-400000,-6000000,0,-6000000
62305,2020-12-31,391,Value,6660000,-6000000,0,-6000000
62305,2021-02-14,391,Capital Call,-1300000,-7300000,0,-7300000
62305,2021-03-31,391,Value,8614000,-7300000,0,-7300000
62305,2021-05-16,391,Capital Call,-900000,-8200000,0,-8200000
62305,2021-06-30,391,Value,10988000,-8200000,0,-8200000
62305,2021-08-15,391,Capital Call,-100000,-8300000,0,-8300000
62305,2021-08-15,391,Distribution,83000,-8300000,83000,-8217000
62305,2021-09-30,391,Value,11371000,-8300000,83000,-8217000
62305,2021-11-15,391,Capital Call,-100000,-8400000,83000,-8317000
62305,2021-11-15,391,Distribution,85000,-8400000,168000,-8232000
62305,2021-12-31,391,Value,12012000,-8400000,168000,-8232000
62376,2020-03-31,212,Value,10346460,-9920938,1517359,-8403579
62376,2020-06-30,212,Value,9981030,-9920938,1517359,-8403579
62376,2020-08-15,212,Capital Call,-36584,-9957522,1517359,-8440163
62376,2020-09-30,212,Value,10341090,-9957522,1517359,-8440163
62376,2020-11-15,212,Distribution,744190,-9957522,2261549,-7695973
62376,2020-12-31,212,Value,11263150,-9957522,2261549,-7695973
62376,2021-02-14,212,Capital Call,-290279,-10247801,2261549,-7986252
62376,2021-02-14,212,Distribution,10549,-10247801,2272098,-7975703
62376,2021-03-31,212,Value,11538920,-10247801,2272098,-7975703
62376,2021-05-16,212,Capital Call,-51952,-10299753,2272098,-8027655
62376,2021-05-16,212,Distribution,136929,-10299753,2409027,-7890726
62376,2021-06-30,212,Value,12534380,-10299753,2409027,-7890726
62383,2020-03-31,15730,Value,6410860,-6381739,0,-6381739
62383,2020-05-16,15730,Capital Call,-1002174,-7383913,0,-7383913
62383,2020-06-30,15730,Value,8968260,-7383913,0,-7383913
62383,2020-08-15,15730,Capital Call,-97826,-7481739,0,-7481739
62383,2020-08-15,15730,Distribution,2393478,-7481739,2393478,-5088261
62383,2020-09-30,15730,Value,7359560,-7481739,2393478,-5088261
62383,2020-11-15,15730,Distribution,222609,-7481739,2616087,-4865652
62383,2020-12-31,15730,Value,7107820,-7481739,2616087,-4865652
62383,2021-02-14,15730,Capital Call,-2007826,-9489565,2616087,-6873478
62383,2021-02-14,15730,Distribution,34348,-9489565,2650435,-6839130
62383,2021-03-31,15730,Value,10105650,-9489565,2650435,-6839130
62383,2021-05-16,15730,Distribution,410435,-9489565,3060870,-6428695
62383,2021-06-30,15730,Value,9855210,-9489565,3060870,-6428695
62383,2021-08-15,15730,Capital Call,87,-9489478,3060870,-6428608
62383,2021-08-15,15730,Distribution,194304,-9489478,3255174,-6234304
62383,2021-09-30,15730,Value,8661430,-9489478,3255174,-6234304
62384,2020-02-15,6372,Capital Call,-11925,-9735749,38866,-9696883
62384,2020-02-15,6372,Distribution,14397,-9735749,53263,-9682486
62384,2020-03-31,6372,Value,10105940,-9735749,53263,-9682486
62384,2020-05-16,6372,Capital Call,-31927,-9767676,53263,-9714413
62384,2020-06-30,6372,Value,11663250,-9767676,53263,-9714413
62384,2020-08-15,6372,Capital Call,-78968,-9846644,53263,-9793381
62384,2020-09-30,6372,Value,15496920,-9846644,53263,-9793381
62384,2020-11-15,6372,Capital Call,-137058,-9983702,53263,-9930439
62384,2020-11-15,6372,Distribution,13117,-9983702,66380,-9917322
62384,2020-12-31,6372,Value,15335680,-9983702,66380,-9917322
62384,2021-02-14,6372,Capital Call,-12221,-9995923,66380,-9929543
62384,2021-03-31,6372,Value,17161560,-9995923,66380,-9929543
62384,2021-05-16,6372,Capital Call,-166341,-10162264,66380,-10095884
62384,2021-05-16,6372,Distribution,2623856,-10162264,2690236,-7472028
62384,2021-06-30,6372,Value,16435420,-10162264,2690236,-7472028
62412,2020-02-15,668,Capital Call,-119676,-6311137,232461,-6078676
62412,2020-02-15,668,Distribution,706454,-6311137,938915,-5372222
62412,2020-03-31,668,Value,4546380,-6311137,938915,-5372222
62412,2020-05-16,668,Capital Call,-1559138,-7870275,938915,-6931360
62412,2020-06-30,668,Value,6813570,-7870275,938915,-6931360
62412,2020-08-15,668,Capital Call,-1508572,-9378847,938915,-8439932
62412,2020-08-15,668,Distribution,1299954,-9378847,2238869,-7139978
62412,2020-09-30,668,Value,7566610,-9378847,2238869,-7139978
62412,2020-11-15,668,Capital Call,-60827,-9439674,2238869,-7200805
62412,2020-11-15,668,Distribution,64100,-9439674,2302969,-7136705
62412,2020-12-31,668,Value,8030870,-9439674,2302969,-7136705
62412,2021-02-14,668,Capital Call,-59108,-9498782,2302969,-7195813
62412,2021-02-14,668,Distribution,65672,-9498782,2368641,-7130141
62412,2021-03-31,668,Value,9460480,-9498782,2368641,-7130141
62523,2020-02-15,5411,Capital Call,-1290000,-9030000,1733760,-7296240
62523,2020-02-15,5411,Distribution,117390,-9030000,1851150,-7178850
62523,2020-03-31,5411,Value,9418290,-9030000,1851150,-7178850
62523,2020-06-30,5411,Value,10438680,-9030000,1851150,-7178850
62523,2020-08-15,5411,Distribution,81270,-9030000,1932420,-7097580
62523,2020-09-30,5411,Value,11865420,-9030000,1932420,-7097580
62523,2020-11-15,5411,Distribution,45150,-9030000,1977570,-7052430
62523,2020-12-31,5411,Value,14032620,-9030000,1977570,-7052430
62523,2021-02-14,5411,Capital Call,110000,-8920000,1977570,-6942430
62523,2021-02-14,5411,Distribution,1795590,-8920000,3773160,-5146840
62523,2021-03-31,5411,Value,12880480,-8920000,3773160,-5146840
62523,2021-05-16,5411,Distribution,3273640,-8920000,7046800,-1873200
62523,2021-06-30,5411,Value,9187600,-8920000,7046800,-1873200
62523,2021-08-15,5411,Distribution,1016880,-8920000,8063680,-856320
62523,2021-09-30,5411,Value,11069720,-8920000,8063680,-856320
62572,2020-02-15,22035,Capital Call,-450000,-6100000,0,-6100000
62572,2020-03-31,22035,Value,6406810,-6100000,0,-6100000
62572,2020-05-16,22035,Capital Call,-700000,-6800000,0,-6800000
62572,2020-06-30,22035,Value,7497920,-6800000,0,-6800000
62572,2020-08-15,22035,Capital Call,-800000,-7600000,0,-7600000
62572,2020-09-30,22035,Value,9630450,-7600000,0,-7600000
62572,2020-11-15,22035,Capital Call,-500000,-8100000,0,-8100000
62572,2020-12-31,22035,Value,10824300,-8100000,0,-8100000
62572,2021-03-31,22035,Value,10965700,-8100000,0,-8100000
62572,2021-05-16,22035,Distribution,628217,-8100000,628217,-7471783
62572,2021-06-30,22035,Value,15833850,-8100000,628217,-7471783
62572,2021-08-15,22035,Capital Call,-550000,-8650000,628217,-8021783
62572,2021-09-30,22035,Value,23714280,-8650000,628217,-8021783
62573,2020-02-15,22035,Capital Call,-1850000,-9600000,0,-9600000
62573,2020-03-31,22035,Value,11493940,-9600000,0,-9600000
62573,2020-05-16,22035,Capital Call,-400000,-10000000,0,-10000000
62573,2020-05-16,22035,Distribution,366487,-10000000,366487,-9633513
62573,2020-06-30,22035,Value,11541700,-10000000,366487,-9633513
62573,2020-09-30,22035,Value,14751730,-10000000,366487,-9633513
62573,2020-12-31,22035,Value,16782090,-10000000,366487,-9633513
62573,2021-03-31,22035,Value,18362590,-10000000,366487,-9633513
62573,2021-06-30,22035,Value,25973400,-10000000,366487,-9633513
62573,2021-08-15,22035,Distribution,2495677,-10000000,2862164,-7137836
62573,2021-09-30,22035,Value,30061460,-10000000,2862164,-7137836
62582,2020-02-05,1368,Capital Call,-496689,-4596461,331126,-4265335
62582,2020-03-31,1368,Value,4799050,-4596461,331126,-4265335
62599,2020-06-30,367179,Value,7687120,-7000000,0,-7000000
62702,2020-02-15,21929,Capital Call,-50611,-6234555,459222,-5775333
62702,2020-03-31,21929,Value,5694440,-6234555,459222,-5775333
62702,2020-05-16,21929,Capital Call,-5833,-6240388,459222,-5781166
62702,2020-06-30,21929,Value,6136110,-6240388,459222,-5781166
62702,2020-08-15,21929,Capital Call,-964121,-7204509,459222,-6745287
62702,2020-08-15,21929,Distribution,449235,-7204509,908457,-6296052
62702,2020-09-30,21929,Value,6674250,-7204509,908457,-6296052
62702,2020-11-15,21929,Capital Call,-55541,-7260050,908457,-6351593
62702,2020-11-15,21929,Distribution,158045,-7260050,1066502,-6193548
62702,2020-12-31,21929,Value,7665070,-7260050,1066502,-6193548
62702,2021-02-14,21929,Capital Call,-1346949,-8606999,1066502,-7540497
62702,2021-02-14,21929,Distribution,-94,-8606999,1066408,-7540591
62702,2021-03-31,21929,Value,9975510,-8606999,1066408,-7540591
62702,2021-05-16,21929,Capital Call,-857000,-9463999,1066408,-8397591
62702,2021-05-16,21929,Distribution,2657677,-9463999,3724085,-5739914
62702,2021-06-30,21929,Value,9197110,-9463999,3724085,-5739914
62702,2021-08-15,21929,Capital Call,-34000,-9497999,3724085,-5773914
62702,2021-08-15,21929,Distribution,82,-9497999,3724167,-5773832
62702,2021-09-30,21929,Value,10172350,-9497999,3724167,-5773832
62733,2020-02-15,32667,Distribution,363652,-8367564,1400060,-6967504
62733,2020-03-31,32667,Value,6518960,-8367564,1400060,-6967504
62733,2020-05-16,32667,Capital Call,-58606,-8426170,1400060,-7026110
62733,2020-05-16,32667,Distribution,181826,-8426170,1581886,-6844284
62733,2020-06-30,32667,Value,7199580,-8426170,1581886,-6844284
62733,2020-08-15,32667,Distribution,181826,-8426170,1763712,-6662458
62733,2020-09-30,32667,Value,8034200,-8426170,1763712,-6662458
62733,2020-12-31,32667,Value,9115880,-8426170,1763712,-6662458
62733,2021-02-14,32667,Distribution,590935,-8426170,2354647,-6071523
62733,2021-03-31,32667,Value,9442020,-8426170,2354647,-6071523
62733,2021-05-16,32667,Capital Call,-378859,-8805029,2354647,-6450382
62733,2021-05-16,32667,Distribution,4430311,-8805029,6784958,-2020071
62733,2021-06-30,32667,Value,6047280,-8805029,6784958,-2020071
62733,2021-08-15,32667,Distribution,545478,-8805029,7330436,-1474593
62733,2021-09-30,32667,Value,5988580,-8805029,7330436,-1474593
62741,2020-02-15,1360,Distribution,2040268,-10456374,12087245,1630871
62741,2020-03-31,1360,Value,3724830,-10456374,12087245,1630871
62741,2020-05-16,1360,Distribution,3020134,-10456374,15107379,4651005
62741,2020-06-30,1360,Value,3724830,-10456374,15107379,4651005
62741,2020-09-30,1360,Value,0,-10456374,15107379,4651005
62741,2020-12-31,1360,Value,0,-10456374,15107379,4651005
62741,2021-03-31,1360,Value,0,-10456374,15107379,4651005
62741,2021-06-30,1360,Value,0,-10456374,15107379,4651005
62741,2021-09-30,1360,Value,0,-10456374,15107379,4651005
62741,2021-12-31,1360,Value,0,-10456374,15107379,4651005
62763,2020-12-31,198087,Value,9089290,-7500000,0,-7500000
62792,2020-02-15,212,Capital Call,18753,-4862885,41696,-4821189
62792,2020-02-15,212,Distribution,27434,-4862885,69130,-4793755
62792,2020-03-31,212,Value,4746680,-4862885,69130,-4793755
62792,2020-05-16,212,Distribution,17906,-4862885,87036,-4775849
62792,2020-06-30,212,Value,5216980,-4862885,87036,-4775849
62792,2020-09-30,212,Value,5414320,-4862885,87036,-4775849
62792,2020-11-15,212,Capital Call,-1470148,-6333033,87036,-6245997
62792,2020-11-15,212,Distribution,41760,-6333033,128796,-6204237
62792,2020-12-31,212,Value,8124630,-6333033,128796,-6204237
62792,2021-02-14,212,Distribution,14133,-6333033,142929,-6190104
62792,2021-03-31,212,Value,7962890,-6333033,142929,-6190104
62792,2021-05-16,212,Distribution,28301,-6333033,171230,-6161803
62792,2021-06-30,212,Value,10209400,-6333033,171230,-6161803
62804,2020-02-15,145015,Capital Call,-890000,-7220000,0,-7220000
62804,2020-03-31,145015,Value,8365380,-7220000,0,-7220000
62804,2020-05-16,145015,Capital Call,-870000,-8090000,0,-8090000
62804,2020-06-30,145015,Value,9593000,-8090000,0,-8090000
62804,2020-08-15,145015,Capital Call,-280000,-8370000,0,-8370000
62804,2020-09-30,145015,Value,12497600,-8370000,0,-8370000
62804,2020-11-15,145015,Capital Call,-230000,-8600000,0,-8600000
62804,2020-12-31,145015,Value,15059800,-8600000,0,-8600000
62805,2020-03-31,2165,Capital Call,-655811,-8525548,551040,-7974508
62805,2020-03-31,2165,Distribution,-39507,-8525548,511533,-8014015
62805,2020-06-30,2165,Value,13044090,-8525548,511533,-8014015
62805,2020-08-15,2165,Capital Call,-774451,-9299999,511533,-8788466
62805,2020-08-15,2165,Distribution,1069467,-9299999,1581000,-7718999
62805,2020-09-30,2165,Value,13299000,-9299999,1581000,-7718999
62805,2020-11-15,2165,Distribution,372000,-9299999,1953000,-7346999
62805,2020-12-31,2165,Value,23529000,-9299999,1953000,-7346999
62805,2021-02-14,2165,Distribution,12555000,-9299999,14508000,5208001
62805,2021-03-31,2165,Value,17949000,-9299999,14508000,5208001
62805,2021-05-16,2165,Capital Call,-395000,-9694999,14508000,4813001
62805,2021-05-16,2165,Distribution,604566,-9694999,15112566,5417567
62805,2021-06-30,2165,Value,13818280,-9694999,15112566,5417567
62805,2021-08-15,2165,Capital Call,-226000,-9920999,15112566,5191567
62805,2021-08-15,2165,Distribution,17951,-9920999,15130517,5209518
62805,2021-09-30,2165,Value,12602640,-9920999,15130517,5209518
62805,2021-11-15,2165,Distribution,0,-9920999,15130517,5209518
62805,2021-12-31,2165,Value,13095720,-9920999,15130517,5209518
63043,2020-02-15,77,Capital Call,-513104,-7413106,3657000,-3756106
63043,2020-02-15,77,Distribution,2702184,-7413106,6359184,-1053922
63043,2020-03-31,77,Value,4572250,-7413106,6359184,-1053922
63043,2020-05-16,77,Capital Call,104,-7413002,6359184,-1053818
63043,2020-05-16,77,Distribution,-313,-7413002,6358871,-1054131
63043,2020-06-30,77,Value,4273590,-7413002,6358871,-1054131
63043,2020-09-30,77,Value,4389970,-7413002,6358871,-1054131
63043,2020-11-15,77,Capital Call,-474000,-7887002,6358871,-1528131
63043,2020-11-15,77,Distribution,417,-7887002,6359288,-1527714
63043,2020-12-31,77,Value,5095790,-7887002,6359288,-1527714
63043,2021-03-31,77,Value,5858460,-7887002,6359288,-1527714
63043,2021-06-30,77,Value,6537530,-7887002,6359288,-1527714
63043,2021-08-15,77,Distribution,1590808,-7887002,7950096,63094
63043,2021-09-30,77,Value,5527990,-7887002,7950096,63094
63055,2020-03-31,458,Value,1832410,-1884446,118058,-1766388
63055,2020-05-16,458,Capital Call,-442855,-2327301,118058,-2209243
63055,2020-05-16,458,Distribution,27744,-2327301,145802,-2181499
63055,2020-06-30,458,Value,2263040,-2327301,145802,-2181499
63055,2020-08-15,458,Capital Call,-489812,-2817113,145802,-2671311
63055,2020-09-30,458,Value,2538560,-2817113,145802,-2671311
63055,2020-11-15,458,Capital Call,-1224900,-4042013,145802,-3896211
63055,2020-11-15,458,Distribution,358022,-4042013,503824,-3538189
63055,2020-12-31,458,Value,3381890,-4042013,503824,-3538189
63055,2021-02-14,458,Capital Call,-489924,-4531937,503824,-4028113
63055,2021-02-14,458,Distribution,400965,-4531937,904789,-3627148
63055,2021-03-31,458,Value,4293050,-4531937,904789,-3627148
63055,2021-05-16,458,Capital Call,-489812,-5021749,904789,-4116960
63055,2021-05-16,458,Distribution,403383,-5021749,1308172,-3713577
63055,2021-06-30,458,Value,4365650,-5021749,1308172,-3713577
63055,2021-08-15,458,Capital Call,-367448,-5389197,1308172,-4081025
63055,2021-08-15,458,Distribution,126361,-5389197,1434533,-3954664
63055,2021-09-30,458,Value,6000840,-5389197,1434533,-3954664
63057,2020-03-31,10486,Value,6707580,-6526192,0,-6526192
63057,2020-05-16,10486,Capital Call,-1576787,-8102979,0,-8102979
63057,2020-06-30,10486,Value,8193330,-8102979,0,-8102979
63057,2020-09-30,10486,Value,7829090,-8102979,0,-8102979
63057,2020-12-31,10486,Value,8170100,-8102979,0,-8102979
63057,2021-03-31,10486,Value,9005380,-8102979,0,-8102979
63395,2020-02-15,9110,Capital Call,-667046,-3321149,57540,-3263609
63395,2020-02-15,9110,Distribution,14133,-3321149,71673,-3249476
63395,2020-03-31,9110,Value,2773470,-3321149,71673,-3249476
63395,2020-05-16,9110,Capital Call,-882013,-4203162,71673,-4131489
63395,2020-05-16,9110,Distribution,44990,-4203162,116663,-4086499
63395,2020-06-30,9110,Value,3753870,-4203162,116663,-4086499
63395,2020-08-15,9110,Capital Call,-410197,-4613359,116663,-4496696
63395,2020-09-30,9110,Value,4445650,-4613359,116663,-4496696
63395,2020-11-15,9110,Capital Call,-1006182,-5619541,116663,-5502878
63395,2020-11-15,9110,Distribution,169975,-5619541,286638,-5332903
63395,2020-12-31,9110,Value,5481220,-5619541,286638,-5332903
63395,2021-02-14,9110,Capital Call,-1057595,-6677136,286638,-6390498
63395,2021-02-14,9110,Distribution,138677,-6677136,425315,-6251821
63395,2021-03-31,9110,Value,6400340,-6677136,425315,-6251821
63395,2021-05-16,9110,Capital Call,-672942,-7350078,425315,-6924763
63395,2021-05-16,9110,Distribution,112689,-7350078,538004,-6812074
63395,2021-06-30,9110,Value,7790560,-7350078,538004,-6812074
63395,2021-08-15,9110,Capital Call,-698580,-8048658,538004,-7510654
63395,2021-08-15,9110,Distribution,221161,-8048658,759165,-7289493
63395,2021-09-30,9110,Value,9397410,-8048658,759165,-7289493
63413,2020-03-31,57823,Value,12656160,-7480000,0,-7480000
63413,2020-05-16,57823,Capital Call,-1150000,-8630000,0,-8630000
63413,2020-05-16,57823,Distribution,526430,-8630000,526430,-8103570
63413,2020-06-30,57823,Value,13652660,-8630000,526430,-8103570
63413,2020-09-30,57823,Value,13152120,-8630000,526430,-8103570
63413,2020-12-31,57823,Value,15939610,-8630000,526430,-8103570
63421,2020-02-29,16570,Value,17117750,-7692000,0,-7692000
63421,2020-05-31,16570,Value,16638180,-7692000,0,-7692000
63421,2020-07-16,16570,Capital Call,-201000,-7893000,0,-7893000
63421,2020-08-31,16570,Value,16784890,-7893000,0,-7893000
63421,2020-10-16,16570,Capital Call,-687000,-8580000,0,-8580000
63421,2020-11-30,16570,Value,17014900,-8580000,0,-8580000
63421,2021-02-28,16570,Value,21314320,-8580000,0,-8580000
63421,2021-05-31,16570,Value,24484950,-8580000,0,-8580000
63421,2021-07-16,16570,Capital Call,-118000,-8698000,0,-8698000
63421,2021-08-31,16570,Value,35519520,-8698000,0,-8698000
63421,2021-10-16,16570,Capital Call,-109000,-8807000,0,-8807000
63421,2021-11-30,16570,Value,39351900,-8807000,0,-8807000
63642,2020-03-31,162111,Value,15328400,-10000000,299823,-9700177
63642,2020-05-16,162111,Distribution,1333333,-10000000,1633156,-8366844
63642,2020-06-30,162111,Value,13251730,-10000000,1633156,-8366844
63642,2020-09-30,162111,Value,14164400,-10000000,1633156,-8366844
63642,2020-12-30,162111,Distribution,881924,-10000000,2515080,-7484920
63642,2021-03-31,162111,Value,16737310,-10000000,2515080,-7484920
63756,2020-02-15,104974,Capital Call,-1000000,-7500000,0,-7500000
63756,2020-03-31,104974,Value,9750000,-7500000,0,-7500000
63756,2020-06-30,104974,Value,9750000,-7500000,0,-7500000
63756,2020-08-15,104974,Capital Call,-800000,-8300000,0,-8300000
63756,2020-09-30,104974,Value,11537000,-8300000,0,-8300000
63756,2020-12-31,104974,Value,12284000,-8300000,0,-8300000
63756,2021-03-31,104974,Value,13031000,-8300000,0,-8300000
63756,2021-05-16,104974,Capital Call,-500000,-8800000,0,-8800000
63756,2021-06-30,104974,Value,13464000,-8800000,0,-8800000
63756,2021-09-30,104974,Value,13464000,-8800000,0,-8800000
63756,2021-12-31,104974,Value,16368000,-8800000,0,-8800000
63928,2020-02-15,14055,Capital Call,-752327,-7431699,0,-7431699
63928,2020-03-31,14055,Value,9685810,-7431699,0,-7431699
63928,2020-06-30,14055,Value,10573220,-7431699,0,-7431699
63928,2020-08-15,14055,Capital Call,-1005801,-8437500,0,-8437500
63928,2020-09-30,14055,Value,12515000,-8437500,0,-8437500
63928,2020-12-31,14055,Value,14202130,-8437500,0,-8437500
63928,2021-02-14,14055,Capital Call,-36765,-8474265,0,-8474265
63928,2021-03-31,14055,Value,15460730,-8474265,0,-8474265
63928,2021-06-30,14055,Value,17443330,-8474265,0,-8474265
64015,2020-03-31,212,Value,8555960,-7627002,4574264,-3052738
64020,2020-02-15,1597,Distribution,32430,-6900000,1101240,-5798760
64020,2020-03-31,1597,Value,6999360,-6900000,1101240,-5798760
64020,2020-05-16,1597,Capital Call,-500000,-7400000,1101240,-6298760
64020,2020-05-16,1597,Distribution,-32680,-7400000,1068560,-6331440
64020,2020-06-30,1597,Value,8111140,-7400000,1068560,-6331440
64020,2020-09-30,1597,Value,8398260,-7400000,1068560,-6331440
64020,2020-11-15,1597,Capital Call,-700000,-8100000,1068560,-7031440
64020,2020-11-15,1597,Distribution,-170,-8100000,1068390,-7031610
64020,2020-12-31,1597,Value,9681120,-8100000,1068390,-7031610
64020,2021-03-31,1597,Value,13352040,-8100000,1068390,-7031610
64020,2021-05-16,1597,Distribution,1781190,-8100000,2849580,-5250420
64020,2021-06-30,1597,Value,13275090,-8100000,2849580,-5250420
64020,2021-09-30,1597,Value,14184720,-8100000,2849580,-5250420
64202,2020-02-15,11,Capital Call,-321640,-5325251,2679792,-2645459
64202,2020-02-15,11,Distribution,0,-5325251,2679792,-2645459
64202,2020-03-31,11,Value,3511060,-5325251,2679792,-2645459
64202,2020-06-30,11,Value,3757270,-5325251,2679792,-2645459
64202,2020-08-15,11,Capital Call,-596287,-5921538,2679792,-3241746
64202,2020-08-15,11,Distribution,200105,-5921538,2879897,-3041641
64202,2020-09-30,11,Value,4486820,-5921538,2879897,-3041641
64202,2020-11-15,11,Capital Call,-418682,-6340220,2879897,-3460323
64202,2020-11-15,11,Distribution,59452,-6340220,2939349,-3400871
64202,2020-12-31,11,Value,5499170,-6340220,2939349,-3400871
64439,2020-02-15,164732,Capital Call,-1383694,-4621177,0,-4621177
64439,2020-03-31,164732,Value,4889930,-4621177,0,-4621177
64439,2020-09-30,164732,Value,6797000,-4621177,0,-4621177
64439,2020-11-15,164732,Capital Call,-1068433,-5689610,0,-5689610
64439,2020-12-31,164732,Value,8320190,-5689610,0,-5689610
64439,2021-03-31,164732,Value,8687690,-5689610,0,-5689610
64439,2021-05-16,164732,Capital Call,-1620311,-7309921,0,-7309921
64439,2021-06-30,164732,Value,10363980,-7309921,0,-7309921
64483,2020-01-15,9022,Distribution,0,-10000000,3274396,-6725604
64483,2020-02-29,9022,Value,12816510,-10000000,3274396,-6725604
64483,2020-04-15,9022,Distribution,4358887,-10000000,7633283,-2366717
64483,2020-05-31,9022,Value,10186110,-10000000,7633283,-2366717
64483,2020-08-31,9022,Value,13494010,-10000000,7633283,-2366717
64483,2020-10-16,9022,Distribution,11017122,-10000000,18650405,8650405
64483,2020-11-30,9022,Value,6446950,-10000000,18650405,8650405
64483,2021-02-28,9022,Value,6446950,-10000000,18650405,8650405
64483,2021-05-31,9022,Value,7801260,-10000000,18650405,8650405
64483,2021-08-31,9022,Value,8297350,-10000000,18650405,8650405
64483,2021-11-30,9022,Value,7625140,-10000000,18650405,8650405
64712,2020-02-15,6198,Capital Call,-45000,-9410000,1564892,-7845108
64712,2020-02-15,6198,Distribution,933,-9410000,1565825,-7844175
64712,2020-03-31,6198,Value,12111610,-9410000,1565825,-7844175
64712,2020-05-16,6198,Capital Call,-270000,-9680000,1565825,-8114175
64712,2020-05-16,6198,Distribution,6152040,-9680000,7717865,-1962135
64712,2020-06-30,6198,Value,6594010,-9680000,7717865,-1962135
64712,2020-08-15,6198,Capital Call,-70000,-9750000,7717865,-2032135
64712,2020-08-15,6198,Distribution,236,-9750000,7718101,-2031899
64712,2020-09-30,6198,Value,7590370,-9750000,7718101,-2031899
64712,2020-11-15,6198,Distribution,2346825,-9750000,10064926,314926
64712,2020-12-31,6198,Value,5546770,-9750000,10064926,314926
64712,2021-02-14,6198,Capital Call,-250000,-10000000,10064926,64926
64712,2021-02-14,6198,Distribution,75,-10000000,10065001,65001
64712,2021-03-31,6198,Value,5121000,-10000000,10065001,65001
64712,2021-05-16,6198,Distribution,796000,-10000000,10861001,861001
64712,2021-06-30,6198,Value,5050000,-10000000,10861001,861001
64712,2021-09-30,6198,Value,5018000,-10000000,10861001,861001
64714,2020-02-15,173483,Distribution,1432,-7500000,244302,-7255698
64714,2020-03-31,173483,Value,9161880,-7500000,244302,-7255698
64714,2020-06-30,173483,Value,13050000,-7500000,244302,-7255698
64714,2020-08-15,173483,Capital Call,-1000000,-8500000,244302,-8255698
64714,2020-08-15,173483,Distribution,2198,-8500000,246500,-8253500
64714,2020-09-30,173483,Value,12648000,-8500000,246500,-8253500
64714,2020-11-15,173483,Capital Call,-1100000,-9600000,246500,-9353500
64714,2020-11-15,173483,Distribution,1097500,-9600000,1344000,-8256000
64714,2020-12-31,173483,Value,13488000,-9600000,1344000,-8256000
64714,2021-05-17,173483,Capital Call,-20000,-9620000,1344000,-8276000
64714,2021-05-17,173483,Distribution,2800,-9620000,1346800,-8273200
64714,2021-09-30,173483,Value,15430480,-9620000,1346800,-8273200
64754,2020-03-31,5571,Value,8033660,-7500000,946598,-6553402
64754,2020-05-16,5571,Distribution,142051,-7500000,1088649,-6411351
64754,2020-06-30,5571,Value,8142420,-7500000,1088649,-6411351
64754,2020-08-15,5571,Distribution,818934,-7500000,1907583,-5592417
64754,2020-09-30,5571,Value,7393020,-7500000,1907583,-5592417
64754,2020-11-15,5571,Distribution,984417,-7500000,2892000,-4608000
64754,2020-12-31,5571,Value,7776000,-7500000,2892000,-4608000
64754,2021-02-14,5571,Distribution,558000,-7500000,3450000,-4050000
64754,2021-03-31,5571,Value,9082670,-7500000,3450000,-4050000
64754,2021-05-16,5571,Distribution,8244,-7500000,3458244,-4041756
64754,2021-06-30,5571,Value,9737530,-7500000,3458244,-4041756
64754,2021-08-15,5571,Distribution,1661256,-7500000,5119500,-2380500
64754,2021-09-30,5571,Value,8586750,-7500000,5119500,-2380500
64841,2020-02-15,80,Capital Call,-547094,-5793947,1262838,-4531109
64841,2020-03-31,80,Value,4848130,-5793947,1262838,-4531109
64841,2020-05-16,80,Capital Call,-1427379,-7221326,1262838,-5958488
64841,2020-06-30,80,Value,7179900,-7221326,1262838,-5958488
64841,2020-09-30,80,Value,8559770,-7221326,1262838,-5958488
64841,2020-11-15,80,Capital Call,-276868,-7498194,1262838,-6235356
64841,2020-11-15,80,Distribution,2904601,-7498194,4167439,-3330755
64841,2020-12-31,80,Value,7662690,-7498194,4167439,-3330755
64869,2020-03-31,673,Value,10052930,-6934289,51826,-6882463
64869,2020-05-16,673,Capital Call,-295000,-7229289,51826,-7177463
64869,2020-06-30,673,Value,12392080,-7229289,51826,-7177463
64869,2020-08-15,673,Capital Call,-290000,-7519289,51826,-7467463
64869,2020-09-30,673,Value,13241480,-7519289,51826,-7467463
64869,2020-11-15,673,Capital Call,-475000,-7994289,51826,-7942463
64869,2020-12-31,673,Value,18653690,-7994289,51826,-7942463
64869,2021-03-31,673,Value,20048550,-7994289,51826,-7942463
64882,2020-06-30,203376,Value,4450590,-5172500,2800,-5169700
64882,2020-12-30,203376,Capital Call,-2714651,-7887151,2800,-7884351
64882,2021-06-30,203376,Value,11643310,-7887151,2800,-7884351
64940,2020-03-31,6733,Value,1626310,-1857942,18648,-1839294
64940,2020-05-16,6733,Capital Call,-819304,-2677246,18648,-2658598
64940,2020-05-16,6733,Distribution,234313,-2677246,252961,-2424285
64940,2020-06-30,6733,Value,2303280,-2677246,252961,-2424285
64940,2020-09-30,6733,Value,2404450,-2677246,252961,-2424285
64940,2020-11-15,6733,Capital Call,-152874,-2830120,252961,-2577159
64940,2020-11-15,6733,Distribution,71858,-2830120,324819,-2505301
64940,2020-12-31,6733,Value,2779040,-2830120,324819,-2505301
64940,2021-02-14,6733,Capital Call,-148479,-2978599,324819,-2653780
64940,2021-02-14,6733,Distribution,312991,-2978599,637810,-2340789
64940,2021-03-31,6733,Value,3278940,-2978599,637810,-2340789
64940,2021-05-16,6733,Capital Call,-1882611,-4861210,637810,-4223400
64940,2021-06-30,6733,Value,5414140,-4861210,637810,-4223400
65034,2020-03-31,2166,Value,8567840,-8613984,1279794,-7334190
65034,2020-06-30,2166,Value,9376020,-8613984,1279794,-7334190
65079,2020-02-15,66301,Capital Call,-80000,-11556667,5750002,-5806665
65079,2020-02-15,66301,Distribution,30000,-11556667,5780002,-5776665
65079,2020-03-31,66301,Value,13043330,-11556667,5780002,-5776665
65079,2020-05-16,66301,Capital Call,3333,-11553334,5780002,-5773332
65079,2020-05-16,66301,Distribution,190000,-11553334,5970002,-5583332
65079,2020-06-30,66301,Value,14786660,-11553334,5970002,-5583332
65079,2020-08-15,66301,Capital Call,-30000,-11583334,5970002,-5613332
65079,2020-08-15,66301,Distribution,633333,-11583334,6603335,-4979999
65079,2020-09-30,66301,Value,14976660,-11583334,6603335,-4979999
65079,2020-11-15,66301,Capital Call,-306667,-11890001,6603335,-5286666
65079,2020-11-15,66301,Distribution,123333,-11890001,6726668,-5163333
65079,2020-12-31,66301,Value,16399990,-11890001,6726668,-5163333
65079,2021-02-14,66301,Capital Call,-36667,-11926668,6726668,-5200000
65079,2021-02-14,66301,Distribution,1583333,-11926668,8310001,-3616667
65079,2021-03-31,66301,Value,16856660,-11926668,8310001,-3616667
65079,2021-05-16,66301,Capital Call,-243333,-12170001,8310001,-3860000
65079,2021-05-16,66301,Distribution,473333,-12170001,8783334,-3386667
65079,2021-06-30,66301,Value,19150000,-12170001,8783334,-3386667
65079,2021-08-15,66301,Capital Call,-146333,-12316334,8783334,-3533000
65079,2021-08-15,66301,Distribution,1089333,-12316334,9872667,-2443667
65079,2021-09-30,66301,Value,15430990,-12316334,9872667,-2443667
65080,2020-02-15,5782,Capital Call,-581640,-5936414,110816,-5825598
65080,2020-02-15,5782,Distribution,168162,-5936414,278978,-5657436
65080,2020-03-31,5782,Value,5142710,-5936414,278978,-5657436
65080,2020-05-16,5782,Capital Call,-335154,-6271568,278978,-5992590
65080,2020-05-16,5782,Distribution,104377,-6271568,383355,-5888213
65080,2020-06-30,5782,Value,5686650,-6271568,383355,-5888213
65080,2020-08-15,5782,Capital Call,-511897,-6783465,383355,-6400110
65080,2020-08-15,5782,Distribution,6830,-6783465,390185,-6393280
65080,2020-09-30,5782,Value,6455450,-6783465,390185,-6393280
65080,2020-11-15,5782,Capital Call,-427739,-7211204,390185,-6821019
65080,2020-11-15,5782,Distribution,12624,-7211204,402809,-6808395
65080,2020-12-31,5782,Value,7734190,-7211204,402809,-6808395
65080,2021-02-14,5782,Capital Call,253205,-6957999,402809,-6555190
65080,2021-02-14,5782,Distribution,-28470,-6957999,374339,-6583660
65080,2021-03-31,5782,Value,8990430,-6957999,374339,-6583660
65080,2021-05-16,5782,Capital Call,-414000,-7371999,374339,-6997660
65080,2021-05-16,5782,Distribution,44389,-7371999,418728,-6953271
65080,2021-06-30,5782,Value,10425480,-7371999,418728,-6953271
65080,2021-08-15,5782,Capital Call,-559000,-7930999,418728,-7512271
65080,2021-08-15,5782,Distribution,7958,-7930999,426686,-7504313
65080,2021-09-30,5782,Value,10247640,-7930999,426686,-7504313
65125,2020-02-15,8971,Capital Call,-30000,-7050001,0,-7050001
65125,2020-03-31,8971,Value,5957250,-7050001,0,-7050001
65234,2020-03-12,1368,Capital Call,-309119,-6186207,1429675,-4756532
65234,2020-03-31,1368,Capital Call,123706,-6062501,1429675,-4632826
65234,2020-03-31,1368,Distribution,262825,-6062501,1692500,-4370001
65234,2020-03-31,1368,Value,6955950,-6062501,1692500,-4370001
65234,2020-05-16,1368,Capital Call,-1802500,-7865001,1692500,-6172501
65234,2020-06-30,1368,Value,10230000,-7865001,1692500,-6172501
65234,2020-09-30,1368,Value,10077500,-7865001,1692500,-6172501
65234,2020-12-31,1368,Value,10987500,-7865001,1692500,-6172501
65234,2021-02-14,1368,Distribution,1030000,-7865001,2722500,-5142501
65234,2021-03-31,1368,Value,9425000,-7865001,2722500,-5142501
65234,2021-05-16,1368,Capital Call,-1007500,-8872501,2722500,-6150001
65234,2021-06-30,1368,Value,12382500,-8872501,2722500,-6150001
65234,2021-08-15,1368,Distribution,897500,-8872501,3620000,-5252501
65234,2021-09-30,1368,Value,12394290,-8872501,3620000,-5252501
65283,2020-03-31,205008,Value,7040000,-6400000,0,-6400000
65327,2020-02-15,681,Capital Call,-200000,-3800000,0,-3800000
65327,2020-02-15,681,Distribution,314081,-3800000,314081,-3485919
65327,2020-03-31,681,Value,4447750,-3800000,314081,-3485919
65327,2020-05-16,681,Capital Call,-400000,-4200000,314081,-3885919
65327,2020-06-30,681,Value,7038060,-4200000,314081,-3885919
65327,2020-08-15,681,Capital Call,-900000,-5100000,314081,-4785919
65327,2020-08-15,681,Distribution,558764,-5100000,872845,-4227155
65327,2020-09-30,681,Value,6792270,-5100000,872845,-4227155
65327,2020-11-15,681,Capital Call,-300000,-5400000,872845,-4527155
65327,2020-11-15,681,Distribution,3701148,-5400000,4573993,-826007
65327,2020-12-31,681,Value,7120890,-5400000,4573993,-826007
65327,2021-02-14,681,Capital Call,-700000,-6100000,4573993,-1526007
65327,2021-03-31,681,Value,8272450,-6100000,4573993,-1526007
65327,2021-05-16,681,Capital Call,-800000,-6900000,4573993,-2326007
65327,2021-06-30,681,Value,9430800,-6900000,4573993,-2326007
65466,2020-02-15,783,Capital Call,-526262,-8801664,0,-8801664
65466,2020-03-31,783,Value,15190560,-8801664,0,-8801664
65466,2020-05-16,783,Capital Call,-780718,-9582382,0,-9582382
65466,2020-05-16,783,Distribution,799131,-9582382,799131,-8783251
65466,2020-06-30,783,Value,20418740,-9582382,799131,-8783251
65466,2020-09-30,783,Distribution,3046347,-9582382,3845478,-5736904
65466,2020-12-31,783,Value,19958130,-9582382,3845478,-5736904
65466,2021-02-14,783,Capital Call,-417618,-10000000,3845478,-6154522
65466,2021-02-14,783,Distribution,764389,-10000000,4609867,-5390133
65466,2021-03-31,783,Value,27178030,-10000000,4609867,-5390133
65466,2021-05-16,783,Distribution,4465353,-10000000,9075220,-924780
65466,2021-06-30,783,Value,28554950,-10000000,9075220,-924780
65496,2020-02-15,170252,Capital Call,-52000,-421334,0,-421334
65496,2020-03-31,170252,Value,60000,-421334,0,-421334
65496,2020-05-16,170252,Capital Call,-56000,-477334,0,-477334
65496,2020-06-30,170252,Value,57330,-477334,0,-477334
65496,2020-08-15,170252,Capital Call,-1090667,-1568001,0,-1568001
65496,2020-09-30,170252,Value,1092000,-1568001,0,-1568001
65496,2020-12-31,170252,Value,1024000,-1568001,0,-1568001
65629,2020-03-31,9816,Capital Call,-1700000,-7700000,0,-7700000
65629,2020-06-30,9816,Value,9163000,-7700000,0,-7700000
65629,2020-09-30,9816,Capital Call,-300000,-8000000,0,-8000000
65629,2020-09-30,9816,Distribution,160000,-8000000,160000,-7840000
65629,2020-12-31,9816,Value,10000000,-8000000,160000,-7840000
65631,2020-02-15,733,Capital Call,-1362555,-4885748,73284,-4812464
65631,2020-02-15,733,Distribution,137057,-4885748,210341,-4675407
65631,2020-03-31,733,Value,4047200,-4885748,210341,-4675407
65631,2020-05-16,733,Capital Call,-438003,-5323751,210341,-5113410
65631,2020-06-30,733,Value,5560600,-5323751,210341,-5113410
65631,2020-08-15,733,Capital Call,-401865,-5725616,210341,-5515275
65631,2020-08-15,733,Distribution,314172,-5725616,524513,-5201103
65631,2020-09-30,733,Value,5694950,-5725616,524513,-5201103
65631,2020-11-15,733,Capital Call,-411045,-6136661,524513,-5612148
65631,2020-12-31,733,Value,6377520,-6136661,524513,-5612148
65631,2021-02-14,733,Capital Call,-327538,-6464199,524513,-5939686
65631,2021-03-31,733,Value,7146650,-6464199,524513,-5939686
65631,2021-05-16,733,Capital Call,-697302,-7161501,524513,-6636988
65631,2021-05-16,733,Distribution,281843,-7161501,806356,-6355145
65631,2021-06-30,733,Value,8934280,-7161501,806356,-6355145
65631,2021-09-30,733,Value,9978020,-7161501,806356,-6355145
65765,2020-02-15,733,Capital Call,-97014,-6699135,136908,-6562227
65765,2020-03-31,733,Value,7506840,-6699135,136908,-6562227
65765,2020-07-01,733,Capital Call,-646545,-7345680,136908,-7208772
65765,2020-07-01,733,Distribution,201970,-7345680,338878,-7006802
65765,2020-09-30,733,Value,8031090,-7345680,338878,-7006802
65765,2020-11-15,733,Capital Call,-435573,-7781253,338878,-7442375
65765,2020-11-15,733,Distribution,9927,-7781253,348805,-7432448
65765,2020-12-31,733,Value,8693420,-7781253,348805,-7432448
65765,2021-02-14,733,Capital Call,-278478,-8059731,348805,-7710926
65765,2021-02-14,733,Distribution,132498,-8059731,481303,-7578428
65765,2021-03-31,733,Value,11023210,-8059731,481303,-7578428
65765,2021-05-16,733,Capital Call,-758482,-8818213,481303,-8336910
65765,2021-05-16,733,Distribution,950213,-8818213,1431516,-7386697
65765,2021-06-30,733,Value,11476390,-8818213,1431516,-7386697
65807,2020-03-31,196463,Value,6456650,-7206537,173357,-7033180
65807,2020-05-16,196463,Capital Call,-130399,-7336936,173357,-7163579
65807,2020-06-30,196463,Value,7090210,-7336936,173357,-7163579
65807,2020-08-15,196463,Capital Call,-78471,-7415407,173357,-7242050
65807,2020-09-30,196463,Value,7761130,-7415407,173357,-7242050
65807,2020-11-15,196463,Capital Call,-235509,-7650916,173357,-7477559
65807,2020-11-15,196463,Distribution,330222,-7650916,503579,-7147337
65807,2020-12-31,196463,Value,8218460,-7650916,503579,-7147337
65807,2021-02-14,196463,Capital Call,-58651,-7709567,503579,-7205988
65807,2021-03-31,196463,Value,8670800,-7709567,503579,-7205988
65807,2021-05-16,196463,Capital Call,-245157,-7954724,503579,-7451145
65807,2021-06-30,196463,Value,9042090,-7954724,503579,-7451145
65846,2020-05-16,22829,Capital Call,-618557,-6083762,437914,-5645848
65846,2020-05-16,22829,Distribution,47979,-6083762,485893,-5597869
65846,2020-09-30,22829,Value,6693190,-6083762,485893,-5597869
65846,2020-11-15,22829,Capital Call,-278350,-6362112,485893,-5876219
65846,2020-11-15,22829,Distribution,505627,-6362112,991520,-5370592
65846,2020-12-31,22829,Value,6742610,-6362112,991520,-5370592
65846,2021-03-31,22829,Value,7468120,-6362112,991520,-5370592
65847,2020-05-16,22829,Capital Call,-1000000,-7378457,158583,-7219874
65847,2020-05-16,22829,Distribution,343344,-7378457,501927,-6876530
65847,2020-09-30,22829,Value,10011260,-7378457,501927,-6876530
65847,2020-11-15,22829,Capital Call,-182927,-7561384,501927,-7059457
65847,2020-11-15,22829,Distribution,519501,-7561384,1021428,-6539956
65847,2020-12-31,22829,Value,11030290,-7561384,1021428,-6539956
65847,2021-02-14,22829,Capital Call,-182927,-7744311,1021428,-6722883
65847,2021-02-14,22829,Distribution,553999,-7744311,1575427,-6168884
65847,2021-03-31,22829,Value,13040740,-7744311,1575427,-6168884
66494,2020-03-31,436,Value,4705950,-4110000,587730,-3522270
66494,2020-05-16,436,Capital Call,40000,-4070000,587730,-3482270
66494,2020-05-16,436,Distribution,87890,-4070000,675620,-3394380
66494,2020-06-30,436,Value,4770040,-4070000,675620,-3394380
66494,2020-09-30,436,Value,5034590,-4070000,675620,-3394380
66494,2020-11-15,436,Capital Call,-520000,-4590000,675620,-3914380
66494,2020-11-15,436,Distribution,141400,-4590000,817020,-3772980
66494,2020-12-31,436,Value,6655500,-4590000,817020,-3772980
66494,2021-04-01,436,Capital Call,-1140000,-5730000,817020,-4912980
66494,2021-04-01,436,Distribution,529530,-5730000,1346550,-4383450
66494,2021-06-30,436,Value,7884480,-5730000,1346550,-4383450
66494,2021-08-15,436,Capital Call,-1096000,-6826000,1346550,-5479450
66494,2021-08-15,436,Distribution,2268,-6826000,1348818,-5477182
66494,2021-09-30,436,Value,8649220,-6826000,1348818,-5477182
66494,2021-11-15,436,Capital Call,-318000,-7144000,1348818,-5795182
66494,2021-11-15,436,Distribution,-30,-7144000,1348788,-5795212
66494,2021-12-31,436,Value,8197740,-7144000,1348788,-5795212
66534,2020-03-31,175718,Value,6718860,-4669779,945032,-3724747
66534,2020-07-01,175718,Capital Call,-2926317,-7596096,945032,-6651064
66534,2020-07-01,175718,Distribution,98832,-7596096,1043864,-6552232
66534,2020-09-30,175718,Value,10501630,-7596096,1043864,-6552232
66534,2020-11-15,175718,Distribution,9308119,-7596096,10351983,2755887
66534,2020-12-31,175718,Value,7318510,-7596096,10351983,2755887
66534,2021-03-31,175718,Value,9000310,-7596096,10351983,2755887
66534,2021-05-16,175718,Distribution,770384,-7596096,11122367,3526271
66534,2021-06-30,175718,Value,9311360,-7596096,11122367,3526271
66560,2020-02-15,7,Capital Call,-241153,-2849452,1,-2849451
66560,2020-02-15,7,Distribution,1438,-2849452,1439,-2848013
66560,2020-03-31,7,Value,2960060,-2849452,1439,-2848013
66560,2020-05-16,7,Capital Call,-288112,-3137564,1439,-3136125
66560,2020-05-16,7,Distribution,782,-3137564,2221,-3135343
66560,2020-06-30,7,Value,3678480,-3137564,2221,-3135343
66560,2020-08-15,7,Capital Call,-789370,-3926934,2221,-3924713
66560,2020-08-15,7,Distribution,556019,-3926934,558240,-3368694
66560,2020-09-30,7,Value,4086410,-3926934,558240,-3368694
66598,2020-02-15,100681,Capital Call,-1346858,-8302099,1410368,-6891731
66598,2020-03-31,100681,Value,8405870,-8302099,1410368,-6891731
66598,2020-06-30,100681,Value,8391280,-8302099,1410368,-6891731
66598,2020-08-15,100681,Capital Call,-533491,-8835590,1410368,-7425222
66598,2020-08-15,100681,Distribution,1759,-8835590,1412127,-7423463
66598,2020-09-30,100681,Value,10040690,-8835590,1412127,-7423463
66598,2020-11-15,100681,Capital Call,-95597,-8931187,1412127,-7519060
66598,2020-12-31,100681,Value,10764350,-8931187,1412127,-7519060
66598,2021-02-14,100681,Capital Call,-1009559,-9940746,1412127,-8528619
66598,2021-03-31,100681,Value,14547090,-9940746,1412127,-8528619
66637,2020-02-15,18,Capital Call,-800377,-5357378,195634,-5161744
66637,2020-02-15,18,Distribution,-13,-5357378,195621,-5161757
66637,2020-03-31,18,Value,5360920,-5357378,195621,-5161757
66637,2020-05-16,18,Capital Call,-500044,-5857422,195621,-5661801
66637,2020-06-30,18,Value,6453090,-5857422,195621,-5661801
66637,2020-09-30,18,Value,7025760,-5857422,195621,-5661801
66637,2020-12-31,18,Value,8191120,-5857422,195621,-5661801
66637,2021-02-14,18,Capital Call,-255022,-6112444,195621,-5916823
66637,2021-03-31,18,Value,9598430,-6112444,195621,-5916823
66637,2021-05-16,18,Capital Call,-380770,-6493214,195621,-6297593
66637,2021-05-16,18,Distribution,119544,-6493214,315165,-6178049
66637,2021-06-30,18,Value,11808830,-6493214,315165,-6178049
66637,2021-08-15,18,Capital Call,-450035,-6943249,315165,-6628084
66637,2021-08-15,18,Distribution,224812,-6943249,539977,-6403272
66637,2021-09-30,18,Value,13452490,-6943249,539977,-6403272
66638,2020-02-15,18,Capital Call,-1000000,-3370000,117078,-3252922
66638,2020-02-15,18,Distribution,-139,-3370000,116939,-3253061
66638,2020-03-31,18,Value,3320790,-3370000,116939,-3253061
66638,2020-06-30,18,Value,3713400,-3370000,116939,-3253061
66638,2020-08-15,18,Capital Call,-500000,-3870000,116939,-3753061
66638,2020-08-15,18,Distribution,322,-3870000,117261,-3752739
66638,2020-09-30,18,Value,4862260,-3870000,117261,-3752739
66638,2020-11-15,18,Capital Call,-750000,-4620000,117261,-4502739
66638,2020-11-15,18,Distribution,499509,-4620000,616770,-4003230
66638,2020-12-31,18,Value,6411630,-4620000,616770,-4003230
66638,2021-02-14,18,Capital Call,-1250000,-5870000,616770,-5253230
66638,2021-02-14,18,Distribution,759745,-5870000,1376515,-4493485
66638,2021-03-31,18,Value,7613970,-5870000,1376515,-4493485
66638,2021-07-01,18,Capital Call,-1000000,-6870000,1376515,-5493485
66638,2021-07-01,18,Distribution,499682,-6870000,1876197,-4993803
66638,2021-09-30,18,Value,10094090,-6870000,1876197,-4993803
66679,2020-02-15,40167,Capital Call,-5033,-8395031,12249402,3854371
66679,2020-02-15,40167,Distribution,175248,-8395031,12424650,4029619
66679,2020-03-31,40167,Value,3609860,-8395031,12424650,4029619
66679,2020-05-16,40167,Capital Call,-4967,-8399998,12424650,4024652
66679,2020-05-16,40167,Distribution,175352,-8399998,12600002,4200004
66679,2020-06-30,40167,Value,3864000,-8399998,12600002,4200004
66679,2020-08-15,40167,Distribution,840000,-8399998,13440002,5040004
66679,2020-09-30,40167,Value,3108000,-8399998,13440002,5040004
66679,2020-11-15,40167,Distribution,84000,-8399998,13524002,5124004
66679,2020-12-31,40167,Value,2856000,-8399998,13524002,5124004
66679,2021-02-14,40167,Distribution,252000,-8399998,13776002,5376004
66679,2021-03-31,40167,Value,2772000,-8399998,13776002,5376004
66679,2021-05-16,40167,Distribution,336000,-8399998,14112002,5712004
66679,2021-06-30,40167,Value,2688000,-8399998,14112002,5712004
66679,2021-08-15,40167,Distribution,168000,-8399998,14280002,5880004
66679,2021-09-30,40167,Value,2520000,-8399998,14280002,5880004
66705,2020-02-15,1484,Capital Call,-91068,-3837952,0,-3837952
66705,2020-03-31,1484,Value,2443270,-3837952,0,-3837952
66705,2020-06-30,1484,Value,2266750,-3837952,0,-3837952
66705,2020-08-15,1484,Capital Call,-109431,-3947383,0,-3947383
66705,2020-09-30,1484,Value,2409720,-3947383,0,-3947383
66705,2020-12-31,1484,Value,3148760,-3947383,0,-3947383
66705,2021-02-14,1484,Capital Call,-585193,-4532576,0,-4532576
66705,2021-03-31,1484,Value,3524270,-4532576,0,-4532576
66705,2021-06-30,1484,Value,5048620,-4532576,0,-4532576
66745,2020-02-15,2385,Capital Call,-33333,-5444166,18334,-5425832
66745,2020-02-15,2385,Distribution,12500,-5444166,30834,-5413332
66745,2020-03-31,2385,Value,6556660,-5444166,30834,-5413332
66745,2020-05-16,2385,Capital Call,-1116667,-6560833,30834,-6529999
66745,2020-05-16,2385,Distribution,3333,-6560833,34167,-6526666
66745,2020-06-30,2385,Value,7943330,-6560833,34167,-6526666
66745,2020-08-15,2385,Capital Call,-79167,-6640000,34167,-6605833
66745,2020-09-30,2385,Value,7833330,-6640000,34167,-6605833
66745,2020-11-15,2385,Capital Call,-251667,-6891667,34167,-6857500
66745,2020-12-31,2385,Value,8261660,-6891667,34167,-6857500
66907,2020-03-31,317,Value,10276810,-7585306,464297,-7121009
66907,2020-05-16,317,Capital Call,-2031242,-9616548,464297,-9152251
66907,2020-05-16,317,Distribution,109112,-9616548,573409,-9043139
66907,2020-06-30,317,Value,12313170,-9616548,573409,-9043139
66907,2020-08-15,317,Capital Call,-40394,-9656942,573409,-9083533
66907,2020-09-30,317,Value,12808990,-9656942,573409,-9083533
66907,2020-11-15,317,Capital Call,-267844,-9924786,573409,-9351377
66907,2020-11-15,317,Distribution,1015843,-9924786,1589252,-8335534
66907,2020-12-31,317,Value,14201560,-9924786,1589252,-8335534
66907,2021-02-14,317,Capital Call,-39172,-9963958,1589252,-8374706
66907,2021-02-14,317,Distribution,1996133,-9963958,3585385,-6378573
66907,2021-03-31,317,Value,13674830,-9963958,3585385,-6378573
66907,2021-05-16,317,Capital Call,-46282,-10010240,3585385,-6424855
66907,2021-05-16,317,Distribution,1369312,-10010240,4954697,-5055543
66907,2021-06-30,317,Value,12983960,-10010240,4954697,-5055543
66907,2021-08-15,317,Capital Call,-34184,-10044424,4954697,-5089727
66907,2021-08-15,317,Distribution,33796,-10044424,4988493,-5055931
66907,2021-09-30,317,Value,12950170,-10044424,4988493,-5055931
66913,2020-05-16,48800,Capital Call,-1540000,-8670000,0,-8670000
66913,2020-09-30,48800,Value,10603410,-8670000,0,-8670000
66913,2020-11-15,48800,Capital Call,-40000,-8710000,0,-8710000
66913,2020-12-31,48800,Value,11871730,-8710000,0,-8710000
66913,2021-02-14,48800,Capital Call,-16000,-8726000,0,-8726000
66913,2021-02-14,48800,Distribution,1292321,-8726000,1292321,-7433679
66913,2021-03-31,48800,Value,11830710,-8726000,1292321,-7433679
66913,2021-06-30,48800,Value,12223380,-8726000,1292321,-7433679
66913,2021-08-15,48800,Capital Call,-56000,-8782000,1292321,-7489679
66913,2021-08-15,48800,Distribution,390,-8782000,1292711,-7489289
66913,2021-09-30,48800,Value,12642560,-8782000,1292711,-7489289
66924,2020-02-15,200477,Distribution,0,-7600000,1070060,-6529940
66924,2020-03-31,200477,Value,9758160,-7600000,1070060,-6529940
66924,2020-05-16,200477,Capital Call,-500000,-8100000,1070060,-7029940
66924,2020-05-16,200477,Distribution,0,-8100000,1070060,-7029940
66924,2020-06-30,200477,Value,10445910,-8100000,1070060,-7029940
66924,2020-08-15,200477,Capital Call,-400000,-8500000,1070060,-7429940
66924,2020-09-30,200477,Value,11053590,-8500000,1070060,-7429940
66924,2020-12-31,200477,Value,14257110,-8500000,1070060,-7429940
66924,2021-03-31,200477,Value,15725350,-8500000,1070060,-7429940
66924,2021-05-16,200477,Capital Call,-400000,-8900000,1070060,-7829940
66924,2021-06-30,200477,Value,17028100,-8900000,1070060,-7829940
66924,2021-09-30,200477,Value,17261210,-8900000,1070060,-7829940
66966,2020-02-15,1878,Capital Call,-1000000,-4000000,0,-4000000
66966,2020-03-31,1878,Value,4000000,-4000000,0,-4000000
66966,2020-06-30,1878,Value,4400000,-4000000,0,-4000000
66966,2020-09-30,1878,Value,4600000,-4000000,0,-4000000
66966,2020-11-15,1878,Capital Call,-200000,-4200000,0,-4200000
66966,2020-11-15,1878,Distribution,210000,-4200000,210000,-3990000
66966,2020-12-31,1878,Value,5166000,-4200000,210000,-3990000
66966,2021-02-14,1878,Capital Call,-1000000,-5200000,210000,-4990000
66966,2021-02-14,1878,Distribution,-2000,-5200000,208000,-4992000
66966,2021-03-31,1878,Value,6656000,-5200000,208000,-4992000
66966,2021-06-30,1878,Value,7020000,-5200000,208000,-4992000
66966,2021-09-30,1878,Value,7540000,-5200000,208000,-4992000
67005,2020-02-15,135498,Capital Call,-400000,-5800000,0,-5800000
67005,2020-03-31,135498,Value,7366000,-5800000,0,-5800000
67005,2020-07-01,135498,Capital Call,-700000,-6500000,0,-6500000
67005,2020-09-30,135498,Value,8255000,-6500000,0,-6500000
67005,2021-02-14,135498,Capital Call,-600000,-7100000,0,-7100000
67005,2021-06-30,135498,Value,9017000,-7100000,0,-7100000
67043,2020-05-16,21315,Capital Call,-901000,-5000000,0,-5000000
67043,2020-09-30,21315,Value,5350000,-5000000,0,-5000000
67043,2020-11-15,21315,Capital Call,-1600000,-6600000,0,-6600000
67043,2020-12-31,21315,Value,6382200,-6600000,0,-6600000
67043,2021-04-01,21315,Capital Call,-100000,-6700000,0,-6700000
67043,2021-06-30,21315,Value,7839000,-6700000,0,-6700000
67043,2021-08-15,21315,Capital Call,-200000,-6900000,0,-6900000
67043,2021-09-30,21315,Value,8487000,-6900000,0,-6900000
67075,2020-03-31,444,Value,3094750,-3002517,465164,-2537353
67075,2020-05-16,444,Capital Call,-499971,-3502488,465164,-3037324
67075,2020-06-30,444,Value,3723830,-3502488,465164,-3037324
67075,2020-08-15,444,Capital Call,-251620,-3754108,465164,-3288944
67075,2020-08-15,444,Distribution,24350,-3754108,489514,-3264594
67075,2020-09-30,444,Value,3982590,-3754108,489514,-3264594
67075,2020-11-15,444,Capital Call,-753517,-4507625,489514,-4018111
67075,2020-11-15,444,Distribution,21291,-4507625,510805,-3996820
67075,2020-12-31,444,Value,4944310,-4507625,510805,-3996820
67075,2021-02-14,444,Distribution,300360,-4507625,811165,-3696460
67075,2021-03-31,444,Value,5248970,-4507625,811165,-3696460
67075,2021-05-16,444,Distribution,473143,-4507625,1284308,-3223317
67075,2021-06-30,444,Value,5114790,-4507625,1284308,-3223317
67194,2020-03-31,1878,Value,8858000,-8600000,0,-8600000
67194,2020-06-30,1878,Value,9632000,-8600000,0,-8600000
67194,2020-09-30,1878,Value,9718000,-8600000,0,-8600000
67194,2020-11-15,1878,Capital Call,-400000,-9000000,0,-9000000
67194,2020-11-15,1878,Distribution,3330000,-9000000,3330000,-5670000
67194,2020-12-31,1878,Value,7740000,-9000000,3330000,-5670000
67194,2021-03-31,1878,Value,8280000,-9000000,3330000,-5670000
67194,2021-06-30,1878,Value,9360000,-9000000,3330000,-5670000
67194,2021-09-30,1878,Value,11340000,-9000000,3330000,-5670000
67200,2020-02-15,49,Capital Call,-200000,-2506666,0,-2506666
67200,2020-03-31,49,Value,2066660,-2506666,0,-2506666
67200,2020-05-16,49,Capital Call,-1673333,-4179999,0,-4179999
67200,2020-06-30,49,Value,5160000,-4179999,0,-4179999
67200,2020-09-30,49,Value,6766660,-4179999,0,-4179999
67200,2020-11-15,49,Capital Call,-846667,-5026666,0,-5026666
67200,2020-11-15,49,Distribution,206667,-5026666,206667,-4819999
67200,2020-12-31,49,Value,8386660,-5026666,206667,-4819999
67200,2021-02-14,49,Capital Call,-580000,-5606666,206667,-5399999
67200,2021-02-14,49,Distribution,2266667,-5606666,2473334,-3133332
67200,2021-03-31,49,Value,7353330,-5606666,2473334,-3133332
67200,2021-05-16,49,Capital Call,-640000,-6246666,2473334,-3773332
67200,2021-06-30,49,Value,8366660,-6246666,2473334,-3773332
67200,2021-08-15,49,Capital Call,-627333,-6873999,2473334,-4400665
67200,2021-08-15,49,Distribution,1674667,-6873999,4148001,-2725998
67200,2021-09-30,49,Value,8823990,-6873999,4148001,-2725998
67205,2020-02-15,15,Capital Call,-1712500,-5676250,0,-5676250
67205,2020-03-31,15,Value,6225000,-5676250,0,-5676250
67205,2020-06-30,15,Value,5856250,-5676250,0,-5676250
67205,2020-08-15,15,Capital Call,-565000,-6241250,0,-6241250
67205,2020-09-30,15,Value,6882500,-6241250,0,-6241250
67205,2020-11-15,15,Capital Call,-223750,-6465000,0,-6465000
67205,2020-12-31,15,Value,7182500,-6465000,0,-6465000
67205,2021-02-14,15,Capital Call,-681250,-7146250,0,-7146250
67205,2021-02-14,15,Distribution,291250,-7146250,291250,-6855000
67205,2021-03-31,15,Value,7553750,-7146250,291250,-6855000
67205,2021-05-16,15,Capital Call,-758750,-7905000,291250,-7613750
67205,2021-06-30,15,Value,9507500,-7905000,291250,-7613750
67205,2021-08-15,15,Capital Call,-183750,-8088750,291250,-7797500
67205,2021-08-15,15,Distribution,447500,-8088750,738750,-7350000
67205,2021-09-30,15,Value,10248190,-8088750,738750,-7350000
67208,2020-03-31,7951,Value,8210750,-6650000,0,-6650000
67208,2020-05-16,7951,Capital Call,151,-6649849,0,-6649849
67208,2020-06-30,7951,Value,7871340,-6649849,0,-6649849
67208,2020-08-15,7951,Capital Call,49849,-6600000,0,-6600000
67208,2020-09-30,7951,Value,7854000,-6600000,0,-6600000
67208,2020-11-15,7951,Capital Call,-49849,-6649849,0,-6649849
67208,2020-12-31,7951,Value,8751490,-6649849,0,-6649849
67208,2021-02-14,7951,Capital Call,-349992,-6999841,0,-6999841
67208,2021-02-14,7951,Distribution,419990,-6999841,419990,-6579851
67208,2021-03-31,7951,Value,9432360,-6999841,419990,-6579851
67208,2021-05-16,7951,Capital Call,-158,-6999999,419990,-6580009
67208,2021-05-16,7951,Distribution,10,-6999999,420000,-6579999
67208,2021-06-30,7951,Value,10010000,-6999999,420000,-6579999
67208,2021-08-15,7951,Distribution,1120000,-6999999,1540000,-5459999
67208,2021-09-30,7951,Value,9660000,-6999999,1540000,-5459999
67231,2020-02-15,171102,Capital Call,-300000,-8100000,1482000,-6618000
67231,2020-02-15,171102,Distribution,-24000,-8100000,1458000,-6642000
67231,2020-03-31,171102,Value,10125000,-8100000,1458000,-6642000
67231,2020-05-16,171102,Capital Call,-400000,-8500000,1458000,-7042000
67231,2020-05-16,171102,Distribution,72000,-8500000,1530000,-6970000
67231,2020-06-30,171102,Value,11390000,-8500000,1530000,-6970000
67231,2020-09-30,171102,Capital Call,-1000000,-9500000,1530000,-7970000
67231,2020-09-30,171102,Distribution,845000,-9500000,2375000,-7125000
67231,2020-12-31,171102,Value,21850000,-9500000,2375000,-7125000
67231,2021-03-31,171102,Value,21850000,-9500000,2375000,-7125000
67231,2021-09-30,171102,Value,21850000,-9500000,2375000,-7125000
67282,2020-03-31,1718,Value,4186000,-4600000,0,-4600000
67282,2020-05-16,1718,Capital Call,-700000,-5300000,0,-5300000
67282,2020-06-30,1718,Value,6095000,-5300000,0,-5300000
67282,2020-08-15,1718,Distribution,7950,-5300000,7950,-5292050
67282,2020-09-30,1718,Value,6201000,-5300000,7950,-5292050
67282,2020-11-15,1718,Capital Call,-1000000,-6300000,7950,-6292050
67282,2020-11-15,1718,Distribution,-390,-6300000,7560,-6292440
67282,2020-12-31,1718,Value,6552000,-6300000,7560,-6292440
67282,2021-02-14,1718,Distribution,1315440,-6300000,1323000,-4977000
67282,2021-03-31,1718,Value,6363000,-6300000,1323000,-4977000
67282,2021-05-16,1718,Capital Call,-750000,-7050000,1323000,-5727000
67282,2021-05-16,1718,Distribution,-54000,-7050000,1269000,-5781000
67282,2021-06-30,1718,Value,7402500,-7050000,1269000,-5781000
67282,2021-08-15,1718,Capital Call,-750000,-7800000,1269000,-6531000
67282,2021-08-15,1718,Distribution,57000,-7800000,1326000,-6474000
67282,2021-09-30,1718,Value,8502000,-7800000,1326000,-6474000
67282,2021-12-31,1718,Value,8034000,-7800000,1326000,-6474000
67287,2020-03-31,16986,Value,10441640,-6891224,0,-6891224
67287,2020-05-16,16986,Capital Call,-1260157,-8151381,0,-8151381
67287,2020-05-16,16986,Distribution,540322,-8151381,540322,-7611059
67287,2020-06-30,16986,Value,13063910,-8151381,540322,-7611059
67287,2020-08-15,16986,Capital Call,-612248,-8763629,540322,-8223307
67287,2020-09-30,16986,Value,16302230,-8763629,540322,-8223307
67287,2020-11-15,16986,Capital Call,-728925,-9492554,540322,-8952232
67287,2020-11-15,16986,Distribution,1235907,-9492554,1776229,-7716325
67287,2020-12-31,16986,Value,20737450,-9492554,1776229,-7716325
67513,2020-02-15,121,Capital Call,-1013379,-3398744,39877,-3358867
67513,2020-02-15,121,Distribution,0,-3398744,39877,-3358867
67513,2020-03-31,121,Value,3588510,-3398744,39877,-3358867
67513,2020-05-16,121,Capital Call,-474552,-3873296,39877,-3833419
67513,2020-05-16,121,Distribution,1787,-3873296,41664,-3831632
67513,2020-06-30,121,Value,4637650,-3873296,41664,-3831632
67513,2020-08-15,121,Capital Call,-46909,-3920205,41664,-3878541
67513,2020-09-30,121,Value,5018120,-3920205,41664,-3878541
67513,2020-11-15,121,Capital Call,-1694214,-5614419,41664,-5572755
67513,2020-11-15,121,Distribution,33365,-5614419,75029,-5539390
67513,2020-12-31,121,Value,7085000,-5614419,75029,-5539390
67514,2020-03-31,2147,Value,1669300,-2269885,0,-2269885
67514,2020-05-16,2147,Capital Call,-474949,-2744834,0,-2744834
67514,2020-06-30,2147,Value,2349370,-2744834,0,-2744834
67514,2020-08-15,2147,Capital Call,-481663,-3226497,0,-3226497
67514,2020-09-30,2147,Value,2952050,-3226497,0,-3226497
67514,2020-11-15,2147,Capital Call,-1243741,-4470238,0,-4470238
67514,2020-11-15,2147,Distribution,335918,-4470238,335918,-4134320
67514,2020-12-31,2147,Value,4599370,-4470238,335918,-4134320
67514,2021-02-14,2147,Capital Call,-1228558,-5698796,335918,-5362878
67514,2021-02-14,2147,Distribution,317992,-5698796,653910,-5044886
67514,2021-03-31,2147,Value,5730890,-5698796,653910,-5044886
67514,2021-05-16,2147,Capital Call,-937855,-6636651,653910,-5982741
67514,2021-05-16,2147,Distribution,85470,-6636651,739380,-5897271
67514,2021-06-30,2147,Value,6800260,-6636651,739380,-5897271
67517,2020-02-15,11773,Capital Call,-213000,-4691000,0,-4691000
67517,2020-03-31,11773,Value,3943720,-4691000,0,-4691000
67517,2020-05-16,11773,Distribution,1407,-4691000,1407,-4689593
67517,2020-06-30,11773,Value,4056300,-4691000,1407,-4689593
67517,2020-08-15,11773,Capital Call,-100000,-4791000,1407,-4789593
67517,2020-08-15,11773,Distribution,30,-4791000,1437,-4789563
67517,2020-09-30,11773,Value,4104920,-4791000,1437,-4789563
67517,2020-11-15,11773,Capital Call,-1043000,-5834000,1437,-5832563
67517,2020-11-15,11773,Distribution,-271,-5834000,1166,-5832834
67517,2020-12-31,11773,Value,6071440,-5834000,1166,-5832834
67558,2020-02-15,105936,Capital Call,-1089438,-8440118,278359,-8161759
67558,2020-03-31,105936,Value,8451920,-8440118,278359,-8161759
67558,2020-08-16,105936,Capital Call,-4907,-8445025,278359,-8166666
67558,2020-08-16,105936,Distribution,1923538,-8445025,2201897,-6243128
67558,2020-12-31,105936,Value,11565170,-8445025,2201897,-6243128
67558,2021-02-14,105936,Capital Call,475538,-7969487,2201897,-5767590
67558,2021-02-14,105936,Distribution,1851210,-7969487,4053107,-3916380
67558,2021-03-31,105936,Value,11901900,-7969487,4053107,-3916380
67558,2021-05-16,105936,Capital Call,-101146,-8070633,4053107,-4017526
67558,2021-05-16,105936,Distribution,466150,-8070633,4519257,-3551376
67558,2021-06-30,105936,Value,13135350,-8070633,4519257,-3551376
67601,2020-02-15,780,Capital Call,-1332000,-8643000,219331,-8423669
67601,2020-02-15,780,Distribution,39960,-8643000,259291,-8383709
67601,2020-03-31,780,Value,14520240,-8643000,259291,-8383709
67601,2020-06-30,780,Value,16594560,-8643000,259291,-8383709
67601,2020-08-15,780,Capital Call,-708000,-9351000,259291,-9091709
67601,2020-08-15,780,Distribution,21240,-9351000,280531,-9070469
67601,2020-09-30,780,Value,18795510,-9351000,280531,-9070469
67601,2020-11-15,780,Capital Call,-838615,-10189615,280531,-9909084
67601,2020-11-15,780,Distribution,546906,-10189615,827437,-9362178
67601,2020-12-31,780,Value,18845400,-10189615,827437,-9362178
67601,2021-02-14,780,Capital Call,-142223,-10331838,827437,-9504401
67601,2021-02-14,780,Distribution,139406,-10331838,966843,-9364995
67601,2021-03-31,780,Value,24695120,-10331838,966843,-9364995
67601,2021-06-30,780,Value,32783170,-10331838,966843,-9364995
67601,2021-08-15,780,Capital Call,-2816,-10334654,966843,-9367811
67601,2021-08-15,780,Distribution,2831195,-10334654,3798038,-6536616
67601,2021-09-30,780,Value,31788770,-10334654,3798038,-6536616
67625,2020-02-15,337,Capital Call,-344000,-7362833,2935387,-4427446
67625,2020-03-31,337,Value,7399630,-7362833,2935387,-4427446
67625,2020-05-16,337,Capital Call,-693000,-8055833,2935387,-5120446
67625,2020-06-30,337,Value,8792060,-8055833,2935387,-5120446
67625,2020-08-15,337,Capital Call,-724000,-8779833,2935387,-5844446
67625,2020-09-30,337,Value,11378050,-8779833,2935387,-5844446
67625,2020-11-15,337,Capital Call,-462000,-9241833,2935387,-6306446
67625,2020-11-15,337,Distribution,164840,-9241833,3100227,-6141606
67625,2020-12-31,337,Value,13794970,-9241833,3100227,-6141606
67625,2021-03-31,337,Value,15724060,-9241833,3100227,-6141606
67625,2021-05-16,337,Capital Call,-33000,-9274833,3100227,-6174606
67625,2021-05-16,337,Distribution,126502,-9274833,3226729,-6048104
67625,2021-06-30,337,Value,19124640,-9274833,3226729,-6048104
67625,2021-08-15,337,Distribution,3592279,-9274833,6819008,-2455825
67625,2021-09-30,337,Value,18165630,-9274833,6819008,-2455825
67628,2020-03-31,80,Value,8769310,-7853138,2284137,-5569001
67628,2020-05-16,80,Distribution,329303,-7853138,2613440,-5239698
67628,2020-06-30,80,Value,11722670,-7853138,2613440,-5239698
67628,2020-08-15,80,Capital Call,-371469,-8224607,2613440,-5611167
67628,2020-08-15,80,Distribution,171923,-8224607,2785363,-5439244
67628,2020-09-30,80,Value,11545990,-8224607,2785363,-5439244
67628,2020-11-15,80,Capital Call,-902457,-9127064,2785363,-6341701
67628,2020-11-15,80,Distribution,1033178,-9127064,3818541,-5308523
67628,2020-12-31,80,Value,14448540,-9127064,3818541,-5308523
67628,2021-02-14,80,Capital Call,-930007,-10057071,3818541,-6238530
67628,2021-02-14,80,Distribution,700761,-10057071,4519302,-5537769
67628,2021-03-31,80,Value,16920210,-10057071,4519302,-5537769
67628,2021-05-16,80,Distribution,597585,-10057071,5116887,-4940184
67628,2021-06-30,80,Value,19138650,-10057071,5116887,-4940184
67773,2020-02-15,617,Distribution,33143,-4952571,180572,-4771999
67773,2020-03-31,617,Value,4808280,-4952571,180572,-4771999
67773,2020-05-16,617,Capital Call,-1259429,-6212000,180572,-6031428
67773,2020-06-30,617,Value,6266000,-6212000,180572,-6031428
67773,2020-09-30,617,Value,7090850,-6212000,180572,-6031428
67773,2020-11-15,617,Capital Call,-802000,-7014000,180572,-6833428
67773,2020-11-15,617,Distribution,79429,-7014000,260001,-6753999
67773,2020-12-31,617,Value,9600000,-7014000,260001,-6753999
67773,2021-02-14,617,Capital Call,-932000,-7946000,260001,-7685999
67773,2021-02-14,617,Distribution,17143,-7946000,277144,-7668856
67773,2021-03-31,617,Value,11412570,-7946000,277144,-7668856
67773,2021-05-16,617,Capital Call,-1665714,-9611714,277144,-9334570
67773,2021-05-16,617,Distribution,3987143,-9611714,4264287,-5347427
67773,2021-06-30,617,Value,9753140,-9611714,4264287,-5347427
67811,2020-02-15,14055,Capital Call,-2354000,-7975429,0,-7975429
67811,2020-03-31,14055,Value,8184850,-7975429,0,-7975429
67811,2020-05-16,14055,Capital Call,-130571,-8106000,0,-8106000
67811,2020-06-30,14055,Value,9009710,-8106000,0,-8106000
67811,2020-08-15,14055,Capital Call,-20571,-8126571,0,-8126571
67811,2020-09-30,14055,Value,9207140,-8126571,0,-8126571
67811,2020-11-15,14055,Capital Call,-109429,-8236000,0,-8236000
67811,2020-12-31,14055,Value,10267710,-8236000,0,-8236000
67811,2021-02-14,14055,Capital Call,-89429,-8325429,0,-8325429
67811,2021-03-31,14055,Value,11023710,-8325429,0,-8325429
67811,2021-05-16,14055,Capital Call,-92571,-8418000,0,-8418000
67811,2021-05-16,14055,Distribution,2109714,-8418000,2109714,-6308286
67811,2021-06-30,14055,Value,9448850,-8418000,2109714,-6308286
67954,2020-02-15,674,Capital Call,-1317948,-5926997,73527,-5853470
67954,2020-03-31,674,Value,6621050,-5926997,73527,-5853470
67954,2020-05-16,674,Capital Call,-830604,-6757601,73527,-6684074
67954,2020-06-30,674,Value,7121470,-6757601,73527,-6684074
67954,2020-08-15,674,Capital Call,-867515,-7625116,73527,-7551589
67954,2020-08-15,674,Distribution,11527,-7625116,85054,-7540062
67954,2020-09-30,674,Value,8513590,-7625116,85054,-7540062
67954,2020-11-15,674,Capital Call,-513228,-8138344,85054,-8053290
67954,2020-12-31,674,Value,12414830,-8138344,85054,-8053290
67954,2021-02-14,674,Capital Call,-902574,-9040918,85054,-8955864
67954,2021-02-14,674,Distribution,1532165,-9040918,1617219,-7423699
67954,2021-03-31,674,Value,11995010,-9040918,1617219,-7423699
67954,2021-05-16,674,Capital Call,-191882,-9232800,1617219,-7615581
67954,2021-05-16,674,Distribution,221426,-9232800,1838645,-7394155
67954,2021-06-30,674,Value,13406630,-9232800,1838645,-7394155
67954,2021-09-30,674,Value,14153110,-9232800,1838645,-7394155
67966,2020-09-30,14737,Value,9940280,-7765849,776585,-6989264
67999,2020-02-15,218060,Capital Call,-2026667,-3901333,0,-3901333
67999,2020-03-31,218060,Value,4041330,-3901333,0,-3901333
67999,2020-05-16,218060,Capital Call,-304000,-4205333,0,-4205333
67999,2020-06-30,218060,Value,4313330,-4205333,0,-4205333
67999,2020-09-30,218060,Value,4257330,-4205333,0,-4205333
67999,2020-11-15,218060,Capital Call,-581333,-4786666,0,-4786666
67999,2020-12-31,218060,Value,4768000,-4786666,0,-4786666
68001,2020-06-30,557,Value,3984440,-3735706,0,-3735706
68026,2020-03-31,353,Capital Call,-3679000,-10000000,528436,-9471564
68026,2020-03-31,353,Distribution,1870564,-10000000,2399000,-7601000
68026,2021-03-31,353,Value,12140000,-10000000,2399000,-7601000
68056,2020-02-15,171102,Capital Call,-300000,-6800000,195000,-6605000
68056,2020-02-15,171102,Distribution,9000,-6800000,204000,-6596000
68056,2020-03-31,171102,Value,7140000,-6800000,204000,-6596000
68056,2020-06-30,171102,Value,7276000,-6800000,204000,-6596000
68056,2020-09-30,171102,Capital Call,-1700000,-8500000,204000,-8296000
68056,2020-09-30,171102,Distribution,51000,-8500000,255000,-8245000
68056,2020-12-31,171102,Value,11050000,-8500000,255000,-8245000
68056,2021-02-14,171102,Capital Call,-500000,-9000000,255000,-8745000
68056,2021-02-14,171102,Distribution,15000,-9000000,270000,-8730000
68056,2021-03-31,171102,Value,11700000,-9000000,270000,-8730000
68056,2021-08-16,171102,Distribution,1530000,-9000000,1800000,-7200000
68056,2021-12-31,171102,Value,18900000,-9000000,1800000,-7200000
68069,2020-02-15,466,Distribution,6250,-6200000,979926,-5220074
68069,2020-03-31,466,Value,5664690,-6200000,979926,-5220074
68069,2020-05-16,466,Capital Call,-1200000,-7400000,979926,-6420074
68069,2020-05-16,466,Distribution,6250,-7400000,986176,-6413824
68069,2020-06-30,466,Value,7074090,-7400000,986176,-6413824
68069,2020-08-15,466,Distribution,6250,-7400000,992426,-6407574
68069,2020-09-30,466,Value,7318830,-7400000,992426,-6407574
68069,2020-11-15,466,Capital Call,-1800000,-9200000,992426,-8207574
68069,2020-11-15,466,Distribution,1067713,-9200000,2060139,-7139861
68069,2020-12-31,466,Value,8719200,-9200000,2060139,-7139861
68069,2021-03-31,466,Value,9108160,-9200000,2060139,-7139861
68162,2020-03-31,8661,Value,10124000,-8000000,0,-8000000
68162,2020-06-30,8661,Value,11120800,-8000000,0,-8000000
68162,2020-08-15,8661,Capital Call,-175000,-8175000,0,-8175000
68162,2020-09-30,8661,Value,12045860,-8175000,0,-8175000
68162,2020-11-15,8661,Capital Call,-700000,-8875000,0,-8875000
68162,2020-12-31,8661,Value,14912660,-8875000,0,-8875000
68162,2021-04-01,8661,Capital Call,-100000,-8975000,0,-8975000
68162,2021-04-01,8661,Distribution,2724810,-8975000,2724810,-6250190
68162,2021-06-30,8661,Value,13919320,-8975000,2724810,-6250190
68162,2021-09-30,8661,Value,14674120,-8975000,2724810,-6250190
68162,2021-11-15,8661,Capital Call,-325000,-9300000,2724810,-6575190
68162,2021-11-15,8661,Distribution,90,-9300000,2724900,-6575100
68162,2021-12-31,8661,Value,17430060,-9300000,2724900,-6575100
68221,2020-02-15,219123,Capital Call,-248891,-6690110,89994,-6600116
68221,2020-02-15,219123,Distribution,1453,-6690110,91447,-6598663
68221,2020-03-31,219123,Value,7138320,-6690110,91447,-6598663
68221,2020-05-16,219123,Capital Call,-334732,-7024842,91447,-6933395
68221,2020-05-16,219123,Distribution,1453,-7024842,92900,-6931942
68221,2020-06-30,219123,Value,7500070,-7024842,92900,-6931942
68221,2020-08-15,219123,Capital Call,-486731,-7511573,92900,-7418673
68221,2020-08-15,219123,Distribution,1453,-7511573,94353,-7417220
68221,2020-09-30,219123,Value,8338410,-7511573,94353,-7417220
68221,2020-11-15,219123,Capital Call,-597817,-8109390,94353,-8015037
68221,2020-11-15,219123,Distribution,1453,-8109390,95806,-8013584
68221,2020-12-31,219123,Value,9756600,-8109390,95806,-8013584
68221,2021-02-14,219123,Capital Call,-547233,-8656623,95806,-8560817
68221,2021-02-14,219123,Distribution,1453,-8656623,97259,-8559364
68221,2021-03-31,219123,Value,10303840,-8656623,97259,-8559364
68248,2020-03-31,17773,Capital Call,-313009,-5634848,182822,-5452026
68248,2020-03-31,17773,Distribution,1662015,-5634848,1844837,-3790011
68248,2020-06-30,17773,Value,2531540,-5634848,1844837,-3790011
68248,2020-09-30,17773,Value,3104750,-5634848,1844837,-3790011
68248,2020-11-15,17773,Capital Call,-387235,-6022083,1844837,-4177246
68248,2020-12-31,17773,Value,4169910,-6022083,1844837,-4177246
68248,2021-03-31,17773,Value,5491390,-6022083,1844837,-4177246
68248,2021-06-30,17773,Value,5819930,-6022083,1844837,-4177246
68248,2021-08-15,17773,Capital Call,-284959,-6307042,1844837,-4462205
68248,2021-09-30,17773,Value,7337340,-6307042,1844837,-4462205
68248,2021-11-15,17773,Capital Call,-534533,-6841575,1844837,-4996738
68248,2021-11-15,17773,Distribution,775756,-6841575,2620593,-4220982
68248,2021-12-31,17773,Value,9323230,-6841575,2620593,-4220982
68267,2020-03-31,22829,Capital Call,-1224490,-4897958,0,-4897958
68267,2020-03-31,22829,Distribution,7023,-4897958,7023,-4890935
68267,2020-06-30,22829,Value,5762120,-4897958,7023,-4890935
68267,2020-08-15,22829,Capital Call,-561224,-5459182,7023,-5452159
68267,2020-09-30,22829,Value,7394860,-5459182,7023,-5452159
68267,2020-11-15,22829,Capital Call,-306122,-5765304,7023,-5758281
68267,2020-12-31,22829,Value,10056710,-5765304,7023,-5758281
68267,2021-02-14,22829,Capital Call,-204082,-5969386,7023,-5962363
68267,2021-02-14,22829,Distribution,864875,-5969386,871898,-5097488
68267,2021-03-31,22829,Value,10182430,-5969386,871898,-5097488
68291,2020-06-30,13359,Value,18997720,-9786417,1206142,-8580275
68341,2020-03-31,355,Value,1882760,-1806040,245776,-1560264
68341,2020-05-16,355,Capital Call,-387112,-2193152,245776,-1947376
68341,2020-06-30,355,Value,2499540,-2193152,245776,-1947376
68341,2020-08-15,355,Capital Call,-424145,-2617297,245776,-2371521
68341,2020-08-15,355,Distribution,29288,-2617297,275064,-2342233
68341,2020-09-30,355,Value,3074910,-2617297,275064,-2342233
68341,2020-12-30,355,Capital Call,-706922,-3324219,275064,-3049155
68341,2020-12-30,355,Distribution,226971,-3324219,502035,-2822184
68341,2021-03-31,355,Value,4615840,-3324219,502035,-2822184
68342,2020-02-15,1213,Capital Call,-1105447,-3690447,0,-3690447
68342,2020-03-31,1213,Value,4008140,-3690447,0,-3690447
68342,2020-06-30,1213,Value,3666380,-3690447,0,-3690447
68342,2020-09-30,1213,Value,3469030,-3690447,0,-3690447
68342,2020-12-31,1213,Value,3474790,-3690447,0,-3690447
68349,2020-02-15,118460,Distribution,792000,-7200000,792000,-6408000
68349,2020-03-31,118460,Value,9936000,-7200000,792000,-6408000
68349,2020-05-16,118460,Distribution,216000,-7200000,1008000,-6192000
68349,2020-06-30,118460,Value,9432000,-7200000,1008000,-6192000
68349,2020-08-15,118460,Distribution,1008000,-7200000,2016000,-5184000
68349,2020-09-30,118460,Value,8424000,-7200000,2016000,-5184000
68349,2020-11-15,118460,Distribution,432000,-7200000,2448000,-4752000
68349,2020-12-31,118460,Value,8208000,-7200000,2448000,-4752000
68349,2021-02-14,118460,Distribution,432000,-7200000,2880000,-4320000
68349,2021-03-31,118460,Value,8640000,-7200000,2880000,-4320000
68349,2021-06-30,118460,Value,9072000,-7200000,2880000,-4320000
68349,2021-08-15,118460,Distribution,1296000,-7200000,4176000,-3024000
68349,2021-09-30,118460,Value,7848000,-7200000,4176000,-3024000
68421,2020-03-31,11832,Capital Call,-119760,-3756618,221940,-3534678
68421,2020-03-31,11832,Distribution,342604,-3756618,564544,-3192074
68421,2020-06-30,11832,Value,3017160,-3756618,564544,-3192074
68421,2020-11-14,11832,Capital Call,-1505780,-5262398,564544,-4697854
68421,2021-03-31,11832,Value,4979820,-5262398,564544,-4697854
68421,2021-06-30,11832,Value,5584580,-5262398,564544,-4697854
68424,2020-01-15,11435,Capital Call,-703431,-3546568,0,-3546568
68424,2020-02-29,11435,Value,4674260,-3546568,0,-3546568
68424,2020-04-15,11435,Capital Call,0,-3546568,0,-3546568
68424,2020-05-31,11435,Value,4068440,-3546568,0,-3546568
68424,2020-08-31,11435,Value,4961620,-3546568,0,-3546568
68424,2020-11-30,11435,Value,6551790,-3546568,0,-3546568
68424,2021-01-14,11435,Distribution,196077,-3546568,196077,-3350491
68424,2021-02-28,11435,Value,6355710,-3546568,196077,-3350491
68424,2021-04-15,11435,Capital Call,-1004902,-4551470,196077,-4355393
68424,2021-04-15,11435,Distribution,196077,-4551470,392154,-4159316
68424,2021-05-31,11435,Value,9746730,-4551470,392154,-4159316
68424,2021-07-16,11435,Capital Call,-505076,-5056546,392154,-4664392
68424,2021-07-16,11435,Distribution,1861102,-5056546,2253256,-2803290
68424,2021-08-31,11435,Value,9960100,-5056546,2253256,-2803290
68424,2021-10-16,11435,Capital Call,-1306373,-6362919,2253256,-4109663
68424,2021-10-16,11435,Distribution,0,-6362919,2253256,-4109663
68424,2021-11-30,11435,Value,12848580,-6362919,2253256,-4109663
68447,2020-03-31,221007,Value,2433670,-3172109,220355,-2951754
68447,2020-06-30,221007,Value,2320460,-3172109,220355,-2951754
68447,2020-08-15,221007,Capital Call,-794474,-3966583,220355,-3746228
68447,2020-09-30,221007,Value,3554460,-3966583,220355,-3746228
68447,2020-11-15,221007,Capital Call,-3144854,-7111437,220355,-6891082
68447,2020-12-31,221007,Value,6920590,-7111437,220355,-6891082
68447,2021-02-14,221007,Distribution,251380,-7111437,471735,-6639702
68447,2021-03-31,221007,Value,7269510,-7111437,471735,-6639702
68447,2021-06-30,221007,Value,7449690,-7111437,471735,-6639702
68456,2020-02-15,611,Capital Call,-1785328,-6448891,0,-6448891
68456,2020-03-31,611,Value,8349710,-6448891,0,-6448891
68456,2020-05-16,611,Capital Call,-718232,-7167123,0,-7167123
68456,2020-06-30,611,Value,8461900,-7167123,0,-7167123
68483,2020-03-31,86,Value,2454250,-2567300,0,-2567300
68483,2020-07-01,86,Capital Call,-1386249,-3953549,0,-3953549
68483,2020-09-30,86,Value,3534400,-3953549,0,-3953549
68483,2020-11-15,86,Capital Call,-895180,-4848729,0,-4848729
68483,2020-12-31,86,Value,4458600,-4848729,0,-4848729
68483,2021-03-31,86,Value,5570850,-4848729,0,-4848729
68483,2021-05-16,86,Capital Call,-427283,-5276012,0,-5276012
68483,2021-06-30,86,Value,5832010,-5276012,0,-5276012
68483,2021-09-30,86,Value,5832010,-5276012,0,-5276012
68503,2020-02-15,13322,Capital Call,-1995000,-7390000,53950,-7336050
68503,2020-02-15,13322,Distribution,79070,-7390000,133020,-7256980
68503,2020-03-31,13322,Value,7971590,-7390000,133020,-7256980
68503,2020-05-16,13322,Capital Call,-187000,-7577000,133020,-7443980
68503,2020-05-16,13322,Distribution,-423,-7577000,132597,-7444403
68503,2020-06-30,13322,Value,8605950,-7577000,132597,-7444403
68503,2020-08-15,13322,Capital Call,-223000,-7800000,132597,-7667403
68503,2020-08-15,13322,Distribution,41342,-7800000,173939,-7626061
68503,2020-09-30,13322,Value,8595600,-7800000,173939,-7626061
68503,2020-11-15,13322,Capital Call,-14000,-7814000,173939,-7640061
68503,2020-11-15,13322,Distribution,-8283,-7814000,165656,-7648344
68503,2020-12-31,13322,Value,8782150,-7814000,165656,-7648344
68503,2021-02-14,13322,Capital Call,-273000,-8087000,165656,-7921344
68503,2021-02-14,13322,Distribution,127,-8087000,165783,-7921217
68503,2021-03-31,13322,Value,9611390,-8087000,165783,-7921217
68503,2021-05-16,13322,Capital Call,-202000,-8289000,165783,-8123217
68503,2021-05-16,13322,Distribution,-4,-8289000,165779,-8123221
68503,2021-06-30,13322,Value,11607910,-8289000,165779,-8123221
68503,2021-08-15,13322,Capital Call,-773000,-9062000,165779,-8896221
68503,2021-08-15,13322,Distribution,477622,-9062000,643401,-8418599
68503,2021-09-30,13322,Value,14875270,-9062000,643401,-8418599
68531,2020-02-29,2017,Value,5196410,-5192782,0,-5192782
68531,2020-04-15,2017,Capital Call,-467370,-5660152,0,-5660152
68531,2020-05-31,2017,Value,5882050,-5660152,0,-5660152
68531,2020-07-16,2017,Capital Call,-435384,-6095536,0,-6095536
68531,2020-07-16,2017,Distribution,28951,-6095536,28951,-6066585
68531,2020-08-31,2017,Value,6352720,-6095536,28951,-6066585
68531,2020-10-16,2017,Capital Call,-292263,-6387799,28951,-6358848
68531,2020-10-16,2017,Distribution,228879,-6387799,257830,-6129969
68531,2020-11-30,2017,Value,6796000,-6387799,257830,-6129969
68531,2021-01-14,2017,Capital Call,-461428,-6849227,257830,-6591397
68531,2021-02-28,2017,Value,7828300,-6849227,257830,-6591397
68531,2021-04-15,2017,Capital Call,-234736,-7083963,257830,-6826133
68531,2021-04-15,2017,Distribution,101554,-7083963,359384,-6724579
68531,2021-05-31,2017,Value,8809400,-7083963,359384,-6724579
68531,2021-07-16,2017,Capital Call,-560365,-7644328,359384,-7284944
68531,2021-07-16,2017,Distribution,6524,-7644328,365908,-7278420
68531,2021-08-31,2017,Value,10337850,-7644328,365908,-7278420
68531,2021-10-16,2017,Capital Call,-143865,-7788193,365908,-7422285
68531,2021-10-16,2017,Distribution,2250,-7788193,368158,-7420035
68531,2021-11-30,2017,Value,11361240,-7788193,368158,-7420035
68538,2020-02-15,538,Capital Call,-870000,-6190000,122360,-6067640
68538,2020-02-15,538,Distribution,1440,-6190000,123800,-6066200
68538,2020-03-31,538,Value,7019460,-6190000,123800,-6066200
68538,2020-05-16,538,Capital Call,-600000,-6790000,123800,-6666200
68538,2020-05-16,538,Distribution,-1580,-6790000,122220,-6667780
68538,2020-06-30,538,Value,7937510,-6790000,122220,-6667780
68538,2020-08-15,538,Capital Call,-1200000,-7990000,122220,-7867780
68538,2020-08-15,538,Distribution,5620,-7990000,127840,-7862160
68538,2020-09-30,538,Value,10123330,-7990000,127840,-7862160
68538,2020-11-15,538,Capital Call,-170000,-8160000,127840,-8032160
68538,2020-11-15,538,Distribution,818720,-8160000,946560,-7213440
68538,2020-12-31,538,Value,11211840,-8160000,946560,-7213440
68538,2021-02-14,538,Capital Call,-320000,-8480000,946560,-7533440
68538,2021-02-14,538,Distribution,1902720,-8480000,2849280,-5630720
68538,2021-03-31,538,Value,13279680,-8480000,2849280,-5630720
68538,2021-05-16,538,Capital Call,-600000,-9080000,2849280,-6230720
68538,2021-05-16,538,Distribution,56320,-9080000,2905600,-6174400
68538,2021-06-30,538,Value,15190840,-9080000,2905600,-6174400
68538,2021-08-15,538,Capital Call,-10000,-9090000,2905600,-6184400
68538,2021-08-15,538,Distribution,948560,-9090000,3854160,-5235840
68538,2021-09-30,538,Value,13235040,-9090000,3854160,-5235840
68542,2020-02-15,221096,Distribution,280200,-6000000,2800200,-3199800
68542,2020-03-31,221096,Value,5210400,-6000000,2800200,-3199800
68542,2020-05-16,221096,Capital Call,-2800000,-8800000,2800200,-5999800
68542,2020-05-16,221096,Distribution,-40,-8800000,2800160,-5999840
68542,2020-06-30,221096,Value,8688240,-8800000,2800160,-5999840
68542,2020-08-15,221096,Distribution,623040,-8800000,3423200,-5376800
68542,2020-09-30,221096,Value,10656800,-8800000,3423200,-5376800
68542,2020-11-15,221096,Capital Call,-1200000,-10000000,3423200,-6576800
68542,2020-11-15,221096,Distribution,376800,-10000000,3800000,-6200000
68542,2020-12-31,221096,Value,11700000,-10000000,3800000,-6200000
68542,2021-02-14,221096,Capital Call,-60000,-10060000,3800000,-6260000
68542,2021-02-14,221096,Distribution,22800,-10060000,3822800,-6237200
68542,2021-03-31,221096,Value,12695720,-10060000,3822800,-6237200
68542,2021-05-16,221096,Distribution,1006000,-10060000,4828800,-5231200
68542,2021-06-30,221096,Value,13309380,-10060000,4828800,-5231200
68650,2020-03-31,13234,Value,3838850,-3947000,307472,-3639528
68650,2020-05-16,13234,Capital Call,-338000,-4285000,307472,-3977528
68650,2020-05-16,13234,Distribution,-237,-4285000,307235,-3977765
68650,2020-06-30,13234,Value,4409690,-4285000,307235,-3977765
68650,2020-08-15,13234,Capital Call,-275000,-4560000,307235,-4252765
68650,2020-08-15,13234,Distribution,148766,-4560000,456001,-4103999
68650,2020-09-30,13234,Value,4938480,-4560000,456001,-4103999
68650,2020-12-30,13234,Capital Call,-515000,-5075000,456001,-4618999
68650,2020-12-30,13234,Distribution,-10415,-5075000,445586,-4629414
68650,2021-03-31,13234,Value,6216870,-5075000,445586,-4629414
68650,2021-05-16,13234,Distribution,61915,-5075000,507501,-4567499
68650,2021-06-30,13234,Value,7105000,-5075000,507501,-4567499
68650,2021-08-15,13234,Capital Call,-917000,-5992000,507501,-5484499
68650,2021-08-15,13234,Distribution,690900,-5992000,1198401,-4793599
68650,2021-09-30,13234,Value,7789600,-5992000,1198401,-4793599
68658,2020-02-15,537,Capital Call,-675000,-6700000,179091,-6520909
68658,2020-03-31,537,Value,6873530,-6700000,179091,-6520909
68658,2020-05-16,537,Capital Call,-550000,-7250000,179091,-7070909
68658,2020-06-30,537,Value,8524110,-7250000,179091,-7070909
68658,2020-08-15,537,Capital Call,-375000,-7625000,179091,-7445909
68658,2020-08-15,537,Distribution,124208,-7625000,303299,-7321701
68658,2020-09-30,537,Value,9729200,-7625000,303299,-7321701
68658,2020-11-15,537,Capital Call,-300000,-7925000,303299,-7621701
68658,2020-12-31,537,Value,11082960,-7925000,303299,-7621701
68658,2021-02-14,537,Capital Call,-425000,-8350000,303299,-8046701
68658,2021-03-31,537,Value,13772360,-8350000,303299,-8046701
68658,2021-07-01,537,Capital Call,-100000,-8450000,303299,-8146701
68658,2021-09-30,537,Value,14008790,-8450000,303299,-8146701
68662,2020-02-15,5698,Capital Call,-100000,-2498378,0,-2498378
68662,2020-03-31,5698,Value,2656120,-2498378,0,-2498378
68662,2020-05-16,5698,Capital Call,-1060826,-3559204,0,-3559204
68662,2020-06-30,5698,Value,3594180,-3559204,0,-3559204
68662,2020-08-15,5698,Capital Call,-37493,-3596697,0,-3596697
68662,2020-09-30,5698,Value,3572270,-3596697,0,-3596697
68662,2020-12-31,5698,Value,3572270,-3596697,0,-3596697
68662,2021-02-14,5698,Capital Call,-1474853,-5071550,0,-5071550
68662,2021-03-31,5698,Value,4760860,-5071550,0,-5071550
68662,2021-05-16,5698,Capital Call,-1273012,-6344562,0,-6344562
68662,2021-06-30,5698,Value,6741300,-6344562,0,-6344562
68750,2020-02-15,3951,Capital Call,-689500,-4509013,437134,-4071879
68750,2020-03-31,3951,Value,4746690,-4509013,437134,-4071879
68750,2020-05-16,3951,Capital Call,-180261,-4689274,437134,-4252140
68750,2020-06-30,3951,Value,4926950,-4689274,437134,-4252140
68750,2020-08-15,3951,Capital Call,-184768,-4874042,437134,-4436908
68750,2020-09-30,3951,Value,5500440,-4874042,437134,-4436908
68750,2020-11-15,3951,Capital Call,-576836,-5450878,437134,-5013744
68750,2020-12-31,3951,Value,7416140,-5450878,437134,-5013744
68753,2020-02-15,24,Capital Call,-500000,-6800000,326727,-6473273
68753,2020-02-15,24,Distribution,126471,-6800000,453198,-6346802
68753,2020-03-31,24,Value,8348530,-6800000,453198,-6346802
68753,2020-05-16,24,Capital Call,-701000,-7501000,453198,-7047802
68753,2020-05-16,24,Distribution,-133,-7501000,453065,-7047935
68753,2020-06-30,24,Value,9298980,-7501000,453065,-7047935
68753,2020-08-15,24,Capital Call,-299000,-7800000,453065,-7346935
68753,2020-08-15,24,Distribution,202915,-7800000,655980,-7144020
68753,2020-09-30,24,Value,10168080,-7800000,655980,-7144020
68753,2020-11-15,24,Capital Call,0,-7800000,655980,-7144020
68753,2020-11-15,24,Distribution,342,-7800000,656322,-7143678
68753,2020-12-31,24,Value,10979560,-7800000,656322,-7143678
68753,2021-02-14,24,Capital Call,-550000,-8350000,656322,-7693678
68753,2021-02-14,24,Distribution,303093,-8350000,959415,-7390585
68753,2021-03-31,24,Value,11680810,-8350000,959415,-7390585
68753,2021-05-16,24,Capital Call,-500000,-8850000,959415,-7890585
68753,2021-05-16,24,Distribution,92850,-8850000,1052265,-7797735
68753,2021-06-30,24,Value,14013970,-8850000,1052265,-7797735
68753,2021-08-15,24,Capital Call,-800000,-9650000,1052265,-8597735
68753,2021-08-15,24,Distribution,110560,-9650000,1162825,-8487175
68753,2021-09-30,24,Value,14909250,-9650000,1162825,-8487175
68763,2020-02-15,4936,Capital Call,-484000,-2825000,0,-2825000
68763,2020-03-31,4936,Value,2560010,-2825000,0,-2825000
68763,2020-05-16,4936,Capital Call,-334000,-3159000,0,-3159000
68763,2020-06-30,4936,Value,2995670,-3159000,0,-3159000
68763,2020-08-15,4936,Capital Call,-365000,-3524000,0,-3524000
68763,2020-09-30,4936,Value,3666010,-3524000,0,-3524000
68763,2020-11-15,4936,Capital Call,-958000,-4482000,0,-4482000
68763,2020-12-31,4936,Value,4621390,-4482000,0,-4482000
68763,2021-02-14,4936,Capital Call,-1176000,-5658000,0,-5658000
68763,2021-03-31,4936,Value,5788130,-5658000,0,-5658000
68763,2021-05-16,4936,Capital Call,-180000,-5838000,0,-5838000
68763,2021-05-16,4936,Distribution,304744,-5838000,304744,-5533256
68763,2021-06-30,4936,Value,6145070,-5838000,304744,-5533256
68763,2021-08-15,4936,Capital Call,-855000,-6693000,304744,-6388256
68763,2021-08-15,4936,Distribution,-212,-6693000,304532,-6388468
68763,2021-09-30,4936,Value,8881610,-6693000,304532,-6388468
68787,2020-02-15,571,Capital Call,-580000,-3250000,0,-3250000
68787,2020-03-31,571,Value,2687750,-3250000,0,-3250000
68787,2020-05-16,571,Capital Call,-910000,-4160000,0,-4160000
68787,2020-06-30,571,Value,4060160,-4160000,0,-4160000
68787,2020-08-15,571,Capital Call,-20000,-4180000,0,-4180000
68787,2020-08-15,571,Distribution,20900,-4180000,20900,-4159100
68787,2020-09-30,571,Value,3807980,-4180000,20900,-4159100
68787,2020-11-15,571,Capital Call,-870000,-5050000,20900,-5029100
68787,2020-11-15,571,Distribution,-700,-5050000,20200,-5029800
68787,2020-12-31,571,Value,5206550,-5050000,20200,-5029800
68787,2021-02-14,571,Capital Call,-110000,-5160000,20200,-5139800
68787,2021-02-14,571,Distribution,5600,-5160000,25800,-5134200
68787,2021-03-31,571,Value,5552160,-5160000,25800,-5134200
68787,2021-05-16,571,Capital Call,-180000,-5340000,25800,-5314200
68787,2021-05-16,571,Distribution,900,-5340000,26700,-5313300
68787,2021-06-30,571,Value,6424020,-5340000,26700,-5313300
68787,2021-08-15,571,Capital Call,-490000,-5830000,26700,-5803300
68787,2021-08-15,571,Distribution,346420,-5830000,373120,-5456880
68787,2021-09-30,571,Value,6721990,-5830000,373120,-5456880
68788,2020-02-15,380,Capital Call,-907297,-2054145,17213,-2036932
68788,2020-02-15,380,Distribution,31817,-2054145,49030,-2005115
68788,2020-03-31,380,Value,1811060,-2054145,49030,-2005115
68788,2020-05-16,380,Capital Call,-1011401,-3065546,49030,-3016516
68788,2020-06-30,380,Value,3075330,-3065546,49030,-3016516
68788,2020-08-15,380,Capital Call,-1094111,-4159657,49030,-4110627
68788,2020-09-30,380,Value,4272280,-4159657,49030,-4110627
68788,2020-12-31,380,Value,4503520,-4159657,49030,-4110627
68788,2021-02-14,380,Capital Call,-65829,-4225486,49030,-4176456
68788,2021-02-14,380,Distribution,34189,-4225486,83219,-4142267
68788,2021-03-31,380,Value,4746720,-4225486,83219,-4142267
68788,2021-06-30,380,Value,5218900,-4225486,83219,-4142267
69014,2020-02-15,77,Capital Call,-902000,-6002000,2142001,-3859999
69014,2020-02-15,77,Distribution,6116,-6002000,2148117,-3853883
69014,2020-03-31,77,Value,4832810,-6002000,2148117,-3853883
69014,2020-05-16,77,Distribution,194465,-6002000,2342582,-3659418
69014,2020-06-30,77,Value,4539310,-6002000,2342582,-3659418
69014,2020-09-30,77,Value,4580720,-6002000,2342582,-3659418
69014,2020-11-15,77,Capital Call,-341000,-6343000,2342582,-4000418
69014,2020-11-15,77,Distribution,178762,-6343000,2521344,-3821656
69014,2020-12-31,77,Value,5465120,-6343000,2521344,-3821656
69014,2021-02-14,77,Capital Call,-122000,-6465000,2521344,-3943656
69014,2021-02-14,77,Distribution,121550,-6465000,2642894,-3822106
69014,2021-03-31,77,Value,5976240,-6465000,2642894,-3822106
69014,2021-05-16,77,Distribution,121542,-6465000,2764436,-3700564
69014,2021-06-30,77,Value,6595590,-6465000,2764436,-3700564
69014,2021-08-15,77,Capital Call,-324000,-6789000,2764436,-4024564
69014,2021-08-15,77,Distribution,446084,-6789000,3210520,-3578480
69014,2021-09-30,77,Value,6769990,-6789000,3210520,-3578480
69043,2020-02-15,24,Capital Call,-370000,-4500000,0,-4500000
69043,2020-03-31,24,Value,5289750,-4500000,0,-4500000
69043,2020-05-16,24,Capital Call,-200000,-4700000,0,-4700000
69043,2020-06-30,24,Value,5990150,-4700000,0,-4700000
69043,2020-08-15,24,Capital Call,-385000,-5085000,0,-5085000
69043,2020-08-15,24,Distribution,51359,-5085000,51359,-5033641
69043,2020-09-30,24,Value,6729990,-5085000,51359,-5033641
69043,2020-11-15,24,Capital Call,-422000,-5507000,51359,-5455641
69043,2020-11-15,24,Distribution,-143,-5507000,51216,-5455784
69043,2020-12-31,24,Value,7759360,-5507000,51216,-5455784
69043,2021-03-31,24,Value,8765490,-5507000,51216,-5455784
69043,2021-06-30,24,Value,10325070,-5507000,51216,-5455784
69043,2021-08-15,24,Capital Call,-750000,-6257000,51216,-6205784
69043,2021-08-15,24,Distribution,183422,-6257000,234638,-6022362
69043,2021-09-30,24,Value,11925840,-6257000,234638,-6022362
69054,2020-03-31,5708,Value,2786400,-3817984,204962,-3613022
69054,2020-05-16,5708,Capital Call,-1661427,-5479411,204962,-5274449
69054,2020-06-30,5708,Value,4423050,-5479411,204962,-5274449
69162,2020-02-15,90371,Capital Call,-1640000,-8749999,3419910,-5330089
69162,2020-02-15,90371,Distribution,1637590,-8749999,5057500,-3692499
69162,2020-03-31,90371,Value,6798750,-8749999,5057500,-3692499
69162,2020-05-16,90371,Capital Call,-2294,-8752293,5057500,-3694793
69162,2020-05-16,90371,Distribution,3781,-8752293,5061281,-3691012
69162,2020-06-30,90371,Value,7235980,-8752293,5061281,-3691012
69162,2020-08-15,90371,Capital Call,-259174,-9011467,5061281,-3950186
69162,2020-08-15,90371,Distribution,893249,-9011467,5954530,-3056937
69162,2020-09-30,90371,Value,7029600,-9011467,5954530,-3056937
69162,2020-11-15,90371,Distribution,785351,-9011467,6739881,-2271586
69162,2020-12-31,90371,Value,7530640,-9011467,6739881,-2271586
69162,2021-02-14,90371,Capital Call,-214009,-9225476,6739881,-2485595
69162,2021-02-14,90371,Distribution,1837898,-9225476,8577779,-647697
69162,2021-03-31,90371,Value,7222020,-9225476,8577779,-647697
69162,2021-05-16,90371,Capital Call,-24523,-9249999,8577779,-672220
69162,2021-05-16,90371,Distribution,875721,-9249999,9453500,203501
69162,2021-06-30,90371,Value,6465750,-9249999,9453500,203501
69162,2021-08-15,90371,Capital Call,-4349,-9254348,9453500,199152
69162,2021-08-15,90371,Distribution,4448,-9254348,9457948,203600
69162,2021-09-30,90371,Value,7805510,-9254348,9457948,203600
69230,2020-02-15,2562,Capital Call,-1000000,-8000000,0,-8000000
69230,2020-03-31,2562,Value,10464800,-8000000,0,-8000000
69230,2020-06-30,2562,Value,10700800,-8000000,0,-8000000
69230,2020-09-30,2562,Value,11048000,-8000000,0,-8000000
69239,2020-02-15,9052,Capital Call,-2140000,-8188000,0,-8188000
69239,2020-03-31,9052,Value,10196000,-8188000,0,-8188000
69239,2020-05-16,9052,Capital Call,-166000,-8354000,0,-8354000
69239,2020-06-30,9052,Value,10178000,-8354000,0,-8354000
69239,2020-08-15,9052,Capital Call,-56000,-8410000,0,-8410000
69239,2020-09-30,9052,Value,10188000,-8410000,0,-8410000
69239,2020-11-15,9052,Capital Call,-200000,-8610000,0,-8610000
69239,2020-12-31,9052,Value,12134000,-8610000,0,-8610000
69245,2020-02-15,140,Capital Call,37039,-2675549,40314,-2635235
69245,2020-03-31,140,Value,3306600,-2675549,40314,-2635235
69245,2020-05-16,140,Capital Call,-62804,-2738353,40314,-2698039
69245,2020-06-30,140,Value,3342650,-2738353,40314,-2698039
69245,2020-08-15,140,Capital Call,29540,-2708813,40314,-2668499
69245,2020-09-30,140,Value,3292720,-2708813,40314,-2668499
69245,2020-11-15,140,Capital Call,-3497830,-6206643,40314,-6166329
69245,2020-12-31,140,Value,7159870,-6206643,40314,-6166329
69246,2020-06-30,224833,Value,4867730,-5895976,1005488,-4890488
69246,2020-12-30,224833,Capital Call,-2513255,-8409231,1005488,-7403743
69246,2020-12-30,224833,Distribution,2050956,-8409231,3056444,-5352787
69246,2021-06-30,224833,Value,7438540,-8409231,3056444,-5352787
69310,2020-02-15,14429,Capital Call,-700000,-8900000,0,-8900000
69310,2020-03-31,14429,Value,8472800,-8900000,0,-8900000
69310,2020-09-30,14429,Value,10038310,-8900000,0,-8900000
69310,2020-12-31,14429,Value,10144220,-8900000,0,-8900000
69310,2021-03-31,14429,Value,10825960,-8900000,0,-8900000
69414,2020-06-30,225545,Value,10300000,-8114962,67106,-8047856
69414,2020-12-30,225545,Capital Call,-1000000,-9114962,67106,-9047856
69414,2021-06-30,225545,Value,13514400,-9114962,67106,-9047856
69478,2020-02-15,24,Capital Call,-500000,-3650000,0,-3650000
69478,2020-02-15,24,Distribution,123735,-3650000,123735,-3526265
69478,2020-03-31,24,Value,3997840,-3650000,123735,-3526265
69478,2020-05-16,24,Capital Call,-900000,-4550000,123735,-4426265
69478,2020-05-16,24,Distribution,25,-4550000,123760,-4426240
69478,2020-06-30,24,Value,5427690,-4550000,123760,-4426240
69478,2020-08-15,24,Capital Call,-350000,-4900000,123760,-4776240
69478,2020-08-15,24,Distribution,134470,-4900000,258230,-4641770
69478,2020-09-30,24,Value,6524350,-4900000,258230,-4641770
69478,2020-11-15,24,Capital Call,-800000,-5700000,258230,-5441770
69478,2020-11-15,24,Distribution,-20,-5700000,258210,-5441790
69478,2020-12-31,24,Value,8167530,-5700000,258210,-5441790
69478,2021-02-14,24,Capital Call,-600000,-6300000,258210,-6041790
69478,2021-02-14,24,Distribution,359820,-6300000,618030,-5681970
69478,2021-03-31,24,Value,10682910,-6300000,618030,-5681970
69478,2021-05-16,24,Capital Call,-500000,-6800000,618030,-6181970
69478,2021-05-16,24,Distribution,368650,-6800000,986680,-5813320
69478,2021-06-30,24,Value,11716400,-6800000,986680,-5813320
69478,2021-08-15,24,Capital Call,-800000,-7600000,986680,-6613320
69478,2021-08-15,24,Distribution,699000,-7600000,1685680,-5914320
69478,2021-09-30,24,Value,14535000,-7600000,1685680,-5914320
69508,2020-03-31,1973,Capital Call,-611000,-6548000,0,-6548000
69508,2020-03-31,1973,Distribution,66790,-6548000,66790,-6481210
69508,2020-09-30,1973,Value,4551510,-6548000,66790,-6481210
69508,2020-11-15,1973,Capital Call,-131000,-6679000,66790,-6612210
69508,2020-11-15,1973,Distribution,-66790,-6679000,0,-6679000
69508,2020-12-31,1973,Value,4875670,-6679000,0,-6679000
69508,2021-04-01,1973,Capital Call,-1816954,-8495954,0,-8495954
69508,2021-04-01,1973,Distribution,67493,-8495954,67493,-8428461
69508,2021-06-30,1973,Value,6841050,-8495954,67493,-8428461
69509,2020-02-15,723,Capital Call,-750000,-2900000,193500,-2706500
69509,2020-02-15,723,Distribution,9500,-2900000,203000,-2697000
69509,2020-03-31,723,Value,3045000,-2900000,203000,-2697000
69509,2020-05-16,723,Capital Call,-400000,-3300000,203000,-3097000
69509,2020-05-16,723,Distribution,-5000,-3300000,198000,-3102000
69509,2020-06-30,723,Value,3663000,-3300000,198000,-3102000
69509,2020-08-15,723,Capital Call,-500000,-3800000,198000,-3602000
69509,2020-08-15,723,Distribution,-8000,-3800000,190000,-3610000
69509,2020-09-30,723,Value,4788000,-3800000,190000,-3610000
69509,2020-11-15,723,Capital Call,-700000,-4500000,190000,-4310000
69509,2020-11-15,723,Distribution,215000,-4500000,405000,-4095000
69509,2020-12-31,723,Value,5805000,-4500000,405000,-4095000
69509,2021-02-14,723,Capital Call,-500000,-5000000,405000,-4595000
69509,2021-02-14,723,Distribution,195000,-5000000,600000,-4400000
69509,2021-03-31,723,Value,6900000,-5000000,600000,-4400000
69509,2021-05-16,723,Capital Call,-500000,-5500000,600000,-4900000
69509,2021-05-16,723,Distribution,5000,-5500000,605000,-4895000
69509,2021-06-30,723,Value,8140000,-5500000,605000,-4895000
69509,2021-08-15,723,Capital Call,-1200000,-6700000,605000,-6095000
69509,2021-08-15,723,Distribution,1472000,-6700000,2077000,-4623000
69509,2021-09-30,723,Value,8576000,-6700000,2077000,-4623000
69510,2020-02-15,723,Capital Call,-750000,-2550000,612000,-1938000
69510,2020-03-31,723,Value,2269500,-2550000,612000,-1938000
69510,2020-05-16,723,Capital Call,-500000,-3050000,612000,-2438000
69510,2020-05-16,723,Distribution,-2000,-3050000,610000,-2440000
69510,2020-06-30,723,Value,2867000,-3050000,610000,-2440000
69510,2020-08-15,723,Capital Call,-1000000,-4050000,610000,-3440000
69510,2020-08-15,723,Distribution,362000,-4050000,972000,-3078000
69510,2020-09-30,723,Value,3726000,-4050000,972000,-3078000
69510,2020-11-15,723,Capital Call,-800000,-4850000,972000,-3878000
69510,2020-11-15,723,Distribution,46500,-4850000,1018500,-3831500
69510,2020-12-31,723,Value,5189500,-4850000,1018500,-3831500
69510,2021-02-14,723,Capital Call,-1700000,-6550000,1018500,-5531500
69510,2021-02-14,723,Distribution,1470500,-6550000,2489000,-4061000
69510,2021-03-31,723,Value,7139500,-6550000,2489000,-4061000
69510,2021-05-16,723,Capital Call,-500000,-7050000,2489000,-4561000
69510,2021-05-16,723,Distribution,-374000,-7050000,2115000,-4935000
69510,2021-06-30,723,Value,7896000,-7050000,2115000,-4935000
69510,2021-08-15,723,Capital Call,-1000000,-8050000,2115000,-5935000
69510,2021-08-15,723,Distribution,1185500,-8050000,3300500,-4749500
69510,2021-09-30,723,Value,8211000,-8050000,3300500,-4749500
69520,2020-02-15,17188,Distribution,350000,-7000000,350000,-6650000
69520,2020-03-31,17188,Value,8584490,-7000000,350000,-6650000
69520,2020-06-30,17188,Value,8956950,-7000000,350000,-6650000
69520,2020-09-30,17188,Value,9889990,-7000000,350000,-6650000
69520,2020-11-15,17188,Distribution,350000,-7000000,700000,-6300000
69520,2020-12-31,17188,Value,10171700,-7000000,700000,-6300000
69520,2021-02-14,17188,Distribution,700000,-7000000,1400000,-5600000
69520,2021-03-31,17188,Value,11476500,-7000000,1400000,-5600000
69520,2021-05-16,17188,Distribution,595000,-7000000,1995000,-5005000
69520,2021-06-30,17188,Value,11375000,-7000000,1995000,-5005000
69520,2021-08-15,17188,Distribution,525000,-7000000,2520000,-4480000
69520,2021-09-30,17188,Value,11732700,-7000000,2520000,-4480000
69520,2021-11-15,17188,Distribution,385000,-7000000,2905000,-4095000
69520,2021-12-31,17188,Value,11720800,-7000000,2905000,-4095000
69539,2020-03-31,8235,Value,1595750,-2010750,33750,-1977000
69539,2020-06-30,8235,Value,1852750,-2010750,33750,-1977000
69539,2020-08-15,8235,Capital Call,-100750,-2111500,33750,-2077750
69539,2020-08-15,8235,Distribution,11250,-2111500,45000,-2066500
69539,2020-09-30,8235,Value,1942750,-2111500,45000,-2066500
69539,2020-11-15,8235,Distribution,190250,-2111500,235250,-1876250
69539,2020-12-31,8235,Value,2342000,-2111500,235250,-1876250
69550,2020-02-15,785,Capital Call,-49718,-2427796,6225,-2421571
69550,2020-02-15,785,Distribution,1829,-2427796,8054,-2419742
69550,2020-03-31,785,Value,2158040,-2427796,8054,-2419742
69550,2020-08-16,785,Capital Call,-130940,-2558736,8054,-2550682
69550,2020-08-16,785,Distribution,0,-2558736,8054,-2550682
69550,2020-12-31,785,Value,2918550,-2558736,8054,-2550682
69550,2021-02-14,785,Capital Call,-100654,-2659390,8054,-2651336
69550,2021-02-14,785,Distribution,0,-2659390,8054,-2651336
69550,2021-03-31,785,Value,3019210,-2659390,8054,-2651336
69550,2021-05-16,785,Capital Call,-796604,-3455994,8054,-3447940
69550,2021-06-30,785,Value,4426700,-3455994,8054,-3447940
69550,2021-08-15,785,Capital Call,-1958709,-5414703,8054,-5406649
69550,2021-09-30,785,Value,6856720,-5414703,8054,-5406649
69553,2020-02-15,40,Capital Call,-384615,-7223975,18620,-7205355
69553,2020-02-15,40,Distribution,6083225,-7223975,6101845,-1122130
69553,2020-03-31,40,Value,19831240,-7223975,6101845,-1122130
69553,2020-05-16,40,Capital Call,-380915,-7604890,6101845,-1503045
69553,2020-05-16,40,Distribution,2159689,-7604890,8261534,656644
69553,2020-06-30,40,Value,22328050,-7604890,8261534,656644
69553,2020-09-30,40,Value,24451780,-7604890,8261534,656644
69553,2020-11-15,40,Capital Call,-561538,-8166428,8261534,95106
69553,2020-12-31,40,Value,37424980,-8166428,8261534,95106
69553,2021-02-14,40,Capital Call,-307692,-8474120,8261534,-212586
69553,2021-02-14,40,Distribution,4153777,-8474120,12415311,3941191
69553,2021-03-31,40,Value,37467670,-8474120,12415311,3941191
69553,2021-05-16,40,Distribution,1474576,-8474120,13889887,5415767
69553,2021-06-30,40,Value,31955370,-8474120,13889887,5415767
69553,2021-09-30,40,Value,34420870,-8474120,13889887,5415767
69634,2020-03-31,18,Value,5909810,-5630000,720077,-4909923
69634,2020-05-16,18,Capital Call,-460000,-6090000,720077,-5369923
69634,2020-05-16,18,Distribution,-239,-6090000,719838,-5370162
69634,2020-06-30,18,Value,6909100,-6090000,719838,-5370162
69634,2020-08-15,18,Distribution,248472,-6090000,968310,-5121690
69634,2020-09-30,18,Value,7286070,-6090000,968310,-5121690
69634,2020-11-15,18,Capital Call,-350000,-6440000,968310,-5471690
69634,2020-11-15,18,Distribution,266,-6440000,968576,-5471424
69634,2020-12-31,18,Value,9591090,-6440000,968576,-5471424
69634,2021-02-14,18,Capital Call,-237853,-6677853,968576,-5709277
69634,2021-02-14,18,Distribution,-1909,-6677853,966667,-5711186
69634,2021-03-31,18,Value,10756160,-6677853,966667,-5711186
69634,2021-05-16,18,Capital Call,-12147,-6690000,966667,-5723333
69634,2021-05-16,18,Distribution,372002,-6690000,1338669,-5351331
69634,2021-06-30,18,Value,12562480,-6690000,1338669,-5351331
69634,2021-09-30,18,Value,13570660,-6690000,1338669,-5351331
69635,2020-03-31,18,Value,4926630,-4839999,641784,-4198215
69635,2020-05-16,18,Capital Call,-1000000,-5839999,641784,-5198215
69635,2020-05-16,18,Distribution,32,-5839999,641816,-5198183
69635,2020-06-30,18,Value,6475390,-5839999,641816,-5198183
69635,2020-08-15,18,Distribution,249952,-5839999,891768,-4948231
69635,2020-09-30,18,Value,6816440,-5839999,891768,-4948231
69635,2020-11-15,18,Capital Call,-350000,-6189999,891768,-5298231
69635,2020-11-15,18,Distribution,211,-6189999,891979,-5298020
69635,2020-12-31,18,Value,8442540,-6189999,891979,-5298020
69635,2021-02-14,18,Capital Call,-250000,-6439999,891979,-5548020
69635,2021-02-14,18,Distribution,22501,-6439999,914480,-5525519
69635,2021-03-31,18,Value,9839670,-6439999,914480,-5525519
69635,2021-05-16,18,Capital Call,-320000,-6759999,914480,-5845519
69635,2021-05-16,18,Distribution,510528,-6759999,1425008,-5334991
69635,2021-06-30,18,Value,11223620,-6759999,1425008,-5334991
69635,2021-09-30,18,Value,12479630,-6759999,1425008,-5334991
69656,2020-03-31,2264,Value,3600000,-4000000,0,-4000000
69656,2020-08-16,2264,Distribution,120000,-4000000,120000,-3880000
69656,2020-12-31,2264,Value,3680000,-4000000,120000,-3880000
69656,2021-02-14,2264,Capital Call,-1000000,-5000000,120000,-4880000
69656,2021-02-14,2264,Distribution,130000,-5000000,250000,-4750000
69656,2021-03-31,2264,Value,5400000,-5000000,250000,-4750000
69656,2021-06-30,2264,Value,5850000,-5000000,250000,-4750000
69656,2021-08-15,2264,Capital Call,-800000,-5800000,250000,-5550000
69656,2021-08-15,2264,Distribution,40000,-5800000,290000,-5510000
69656,2021-09-30,2264,Value,6786000,-5800000,290000,-5510000
69746,2020-03-31,126830,Capital Call,-3080000,-7430000,0,-7430000
69746,2020-06-30,126830,Value,7132800,-7430000,0,-7430000
69746,2020-08-15,126830,Capital Call,230000,-7200000,0,-7200000
69746,2020-09-30,126830,Value,6912000,-7200000,0,-7200000
69784,2020-02-15,350,Capital Call,-343330,-5589957,229075,-5360882
69784,2020-03-31,350,Value,7398720,-5589957,229075,-5360882
69784,2020-05-16,350,Capital Call,-602900,-6192857,229075,-5963782
69784,2020-06-30,350,Value,8001630,-6192857,229075,-5963782
69784,2020-08-15,350,Capital Call,-457608,-6650465,229075,-6421390
69784,2020-09-30,350,Value,8984020,-6650465,229075,-6421390
69784,2020-11-15,350,Capital Call,-984716,-7635181,229075,-7406106
69784,2020-11-15,350,Distribution,544127,-7635181,773202,-6861979
69784,2020-12-31,350,Value,10792810,-7635181,773202,-6861979
69784,2021-03-31,350,Value,13176970,-7635181,773202,-6861979
69784,2021-06-30,350,Value,14624920,-7635181,773202,-6861979
69785,2020-03-31,1480,Value,10555490,-8998716,0,-8998716
69785,2020-05-16,1480,Capital Call,-399943,-9398659,0,-9398659
69785,2020-06-30,1480,Value,12302840,-9398659,0,-9398659
69785,2020-09-30,1480,Capital Call,-401340,-9799999,0,-9799999
69785,2020-09-30,1480,Distribution,715400,-9799999,715400,-9084599
69785,2020-12-31,1480,Value,19511800,-9799999,715400,-9084599
69785,2021-02-14,1480,Capital Call,-200000,-9999999,715400,-9284599
69785,2021-02-14,1480,Distribution,244600,-9999999,960000,-9039999
69785,2021-03-31,1480,Value,21460000,-9999999,960000,-9039999
69785,2021-07-01,1480,Distribution,738000,-9999999,1698000,-8301999
69785,2021-09-30,1480,Value,25300000,-9999999,1698000,-8301999
69785,2021-11-15,1480,Distribution,1385000,-9999999,3083000,-6916999
69785,2021-12-31,1480,Value,28636000,-9999999,3083000,-6916999
69876,2020-02-15,2562,Capital Call,-1000000,-6000000,0,-6000000
69876,2020-03-31,2562,Value,7528800,-6000000,0,-6000000
69876,2020-06-30,2562,Value,7917000,-6000000,0,-6000000
69876,2020-09-30,2562,Value,7434000,-6000000,0,-6000000
69876,2021-02-14,2562,Capital Call,-1500000,-7500000,0,-7500000
69876,2021-02-14,2562,Distribution,1057500,-7500000,1057500,-6442500
69876,2021-06-30,2562,Value,10852500,-7500000,1057500,-6442500
69876,2021-09-30,2562,Distribution,442500,-7500000,1500000,-6000000
69876,2021-12-31,2562,Value,12862500,-7500000,1500000,-6000000
70131,2020-02-15,455,Capital Call,-87500,-5770114,2628742,-3141372
70131,2020-02-15,455,Distribution,18936,-5770114,2647678,-3122436
70131,2020-03-31,455,Value,3374000,-5770114,2647678,-3122436
70131,2020-05-16,455,Distribution,17740,-5770114,2665418,-3104696
70131,2020-06-30,455,Value,3356260,-5770114,2665418,-3104696
70131,2020-08-15,455,Capital Call,-1722529,-7492643,2665418,-4827225
70131,2020-08-15,455,Distribution,22067,-7492643,2687485,-4805158
70131,2020-09-30,455,Value,4877790,-7492643,2687485,-4805158
70131,2020-11-15,455,Capital Call,-918934,-8411577,2687485,-5724092
70131,2020-11-15,455,Distribution,188692,-8411577,2876177,-5535400
70131,2020-12-31,455,Value,5910600,-8411577,2876177,-5535400
70131,2021-02-14,455,Capital Call,-86408,-8497985,2876177,-5621808
70131,2021-02-14,455,Distribution,292411,-8497985,3168588,-5329397
70131,2021-03-31,455,Value,5885310,-8497985,3168588,-5329397
70131,2021-05-16,455,Capital Call,686726,-7811259,3168588,-4642671
70131,2021-06-30,455,Value,6250970,-7811259,3168588,-4642671
70263,2020-03-31,143499,Value,12351680,-10000000,0,-10000000
70263,2020-06-30,143499,Value,12195590,-10000000,0,-10000000
70263,2020-09-30,143499,Value,12603900,-10000000,0,-10000000
70271,2020-03-31,19246,Value,5322180,-10171954,8118613,-2053341
70271,2020-06-30,19246,Value,5426900,-10171954,8118613,-2053341
70271,2020-09-30,19246,Value,5600000,-10171954,8118613,-2053341
70271,2020-11-15,19246,Capital Call,-385012,-10556966,8118613,-2438353
70271,2020-11-15,19246,Distribution,2424007,-10556966,10542620,-14346
70271,2020-12-31,19246,Value,3739580,-10556966,10542620,-14346
70271,2021-04-01,19246,Distribution,138233,-10556966,10680853,123887
70271,2021-06-30,19246,Value,3528720,-10556966,10680853,123887
70367,2020-03-31,71806,Value,3336200,-4127630,0,-4127630
70367,2020-05-16,71806,Capital Call,-1165568,-5293198,0,-5293198
70367,2020-06-30,71806,Value,4545170,-5293198,0,-5293198
70367,2020-08-15,71806,Capital Call,748022,-4545176,0,-4545176
70367,2020-09-30,71806,Value,4632850,-4545176,0,-4545176
70367,2020-11-15,71806,Capital Call,-1788683,-6333859,0,-6333859
70367,2020-12-31,71806,Value,5892080,-6333859,0,-6333859
70435,2020-02-15,7379,Capital Call,-100000,-4930000,96600,-4833400
70435,2020-02-15,7379,Distribution,2000,-4930000,98600,-4831400
70435,2020-03-31,7379,Value,2701640,-4930000,98600,-4831400
70435,2020-06-30,7379,Value,2997440,-4930000,98600,-4831400
70435,2020-08-15,7379,Capital Call,-130000,-5060000,98600,-4961400
70435,2020-08-15,7379,Distribution,-2460,-5060000,96140,-4963860
70435,2020-09-30,7379,Value,2995520,-5060000,96140,-4963860
70435,2020-11-15,7379,Distribution,35420,-5060000,131560,-4928440
70435,2020-12-31,7379,Value,3795000,-5060000,131560,-4928440
70435,2021-02-14,7379,Capital Call,-160000,-5220000,131560,-5088440
70435,2021-02-14,7379,Distribution,25040,-5220000,156600,-5063400
70435,2021-03-31,7379,Value,3633120,-5220000,156600,-5063400
70435,2021-05-16,7379,Capital Call,-610000,-5830000,156600,-5673400
70435,2021-05-16,7379,Distribution,35790,-5830000,192390,-5637610
70435,2021-06-30,7379,Value,4599870,-5830000,192390,-5637610
70435,2021-08-15,7379,Capital Call,-1050000,-6880000,192390,-6687610
70435,2021-08-15,7379,Distribution,250,-6880000,192640,-6687360
70435,2021-09-30,7379,Value,6123200,-6880000,192640,-6687360
70435,2021-11-15,7379,Capital Call,-60000,-6940000,192640,-6747360
70435,2021-11-15,7379,Distribution,15560,-6940000,208200,-6731800
70435,2021-12-31,7379,Value,5885120,-6940000,208200,-6731800
70492,2020-02-15,8729,Capital Call,-167000,-8610000,54880,-8555120
70492,2020-02-15,8729,Distribution,-3220,-8610000,51660,-8558340
70492,2020-03-31,8729,Value,10349220,-8610000,51660,-8558340
70492,2020-05-16,8729,Capital Call,-938578,-9548578,51660,-9496918
70492,2020-05-16,8729,Distribution,795344,-9548578,847004,-8701574
70492,2020-06-30,8729,Value,10142040,-9548578,847004,-8701574
70492,2020-08-15,8729,Capital Call,-80648,-9629226,847004,-8782222
70492,2020-08-15,8729,Distribution,16358,-9629226,863362,-8765864
70492,2020-09-30,8729,Value,13640850,-9629226,863362,-8765864
70492,2020-11-15,8729,Capital Call,-2355,-9631581,863362,-8768219
70492,2020-11-15,8729,Distribution,43999,-9631581,907361,-8724220
70492,2020-12-31,8729,Value,14056210,-9631581,907361,-8724220
70492,2021-04-01,8729,Capital Call,-368420,-10000001,907361,-9092640
70492,2021-04-01,8729,Distribution,12640,-10000001,920001,-9080000
70492,2021-06-30,8729,Value,18640000,-10000001,920001,-9080000
70492,2021-08-15,8729,Distribution,-2745,-10000001,917256,-9082745
70492,2021-09-30,8729,Value,20841380,-10000001,917256,-9082745
70508,2020-02-15,1314,Capital Call,-300000,-3473001,97093,-3375908
70508,2020-02-15,1314,Distribution,150,-3473001,97243,-3375758
70508,2020-03-31,1314,Value,3529260,-3473001,97243,-3375758
70508,2020-05-16,1314,Capital Call,-500000,-3973001,97243,-3875758
70508,2020-05-16,1314,Distribution,-303,-3973001,96940,-3876061
70508,2020-06-30,1314,Value,4164100,-3973001,96940,-3876061
70508,2020-08-15,1314,Capital Call,-702000,-4675001,96940,-4578061
70508,2020-08-15,1314,Distribution,299,-4675001,97239,-4577762
70508,2020-09-30,1314,Value,5226650,-4675001,97239,-4577762
70508,2020-11-15,1314,Capital Call,-799000,-5474001,97239,-5376762
70508,2020-11-15,1314,Distribution,-350,-5474001,96889,-5377112
70508,2020-12-31,1314,Value,7209800,-5474001,96889,-5377112
70508,2021-02-14,1314,Capital Call,-801000,-6275001,96889,-6178112
70508,2021-02-14,1314,Distribution,62495,-6275001,159384,-6115617
70508,2021-03-31,1314,Value,9719970,-6275001,159384,-6115617
70508,2021-05-16,1314,Capital Call,-594000,-6869001,159384,-6709617
70508,2021-05-16,1314,Distribution,-24,-6869001,159360,-6709641
70508,2021-06-30,1314,Value,11791320,-6869001,159360,-6709641
70508,2021-08-15,1314,Capital Call,-601000,-7470001,159360,-7310641
70508,2021-08-15,1314,Distribution,-40588,-7470001,118772,-7351229
70508,2021-09-30,1314,Value,14355090,-7470001,118772,-7351229
70609,2020-02-15,11324,Capital Call,-760000,-8202000,0,-8202000
70609,2020-03-31,11324,Value,9616020,-8202000,0,-8202000
70609,2020-05-16,11324,Capital Call,-163000,-8365000,0,-8365000
70609,2020-06-30,11324,Value,9787050,-8365000,0,-8365000
70609,2020-08-15,11324,Capital Call,-125000,-8490000,0,-8490000
70609,2020-09-30,11324,Value,10127720,-8490000,0,-8490000
70609,2020-11-15,11324,Distribution,1641117,-8490000,1641117,-6848883
70609,2020-12-31,11324,Value,8135960,-8490000,1641117,-6848883
70609,2021-02-14,11324,Capital Call,-500000,-8990000,1641117,-7348883
70609,2021-02-14,11324,Distribution,14841,-8990000,1655958,-7334042
70609,2021-03-31,11324,Value,9259700,-8990000,1655958,-7334042
70609,2021-05-16,11324,Distribution,847757,-8990000,2503715,-6486285
70609,2021-06-30,11324,Value,8614210,-8990000,2503715,-6486285
70609,2021-08-15,11324,Capital Call,-811000,-9801000,2503715,-7297285
70609,2021-08-15,11324,Distribution,-540,-9801000,2503175,-7297825
70609,2021-09-30,11324,Value,9607920,-9801000,2503175,-7297825
70624,2020-02-15,8787,Capital Call,-1184000,-5073000,0,-5073000
70624,2020-03-31,8787,Value,7124520,-5073000,0,-5073000
70624,2020-05-16,8787,Capital Call,-55000,-5128000,0,-5128000
70624,2020-06-30,8787,Value,7600200,-5128000,0,-5128000
70624,2020-08-15,8787,Capital Call,-57000,-5185000,0,-5185000
70624,2020-09-30,8787,Value,12680430,-5185000,0,-5185000
70624,2020-11-15,8787,Capital Call,-1189000,-6374000,0,-6374000
70624,2020-12-31,8787,Value,17062560,-6374000,0,-6374000
70624,2021-02-14,8787,Capital Call,-51000,-6425000,0,-6425000
70624,2021-02-14,8787,Distribution,1258015,-6425000,1258015,-5166985
70624,2021-03-31,8787,Value,17064800,-6425000,1258015,-5166985
70624,2021-05-16,8787,Capital Call,-770000,-7195000,1258015,-5936985
70624,2021-05-16,8787,Distribution,1115616,-7195000,2373631,-4821369
70624,2021-06-30,8787,Value,20428760,-7195000,2373631,-4821369
70624,2021-08-15,8787,Capital Call,-1142000,-8337000,2373631,-5963369
70624,2021-08-15,8787,Distribution,-87,-8337000,2373544,-5963456
70624,2021-09-30,8787,Value,27387870,-8337000,2373544,-5963456
70625,2020-02-15,710,Capital Call,-1645141,-7279040,4667416,-2611624
70625,2020-03-31,710,Value,5419010,-7279040,4667416,-2611624
70625,2020-05-16,710,Capital Call,-806268,-8085308,4667416,-3417892
70625,2020-06-30,710,Value,6446340,-8085308,4667416,-3417892
70625,2020-08-15,710,Distribution,1475792,-8085308,6143208,-1942100
70625,2020-09-30,710,Value,6064080,-8085308,6143208,-1942100
70625,2020-11-15,710,Capital Call,-517743,-8603051,6143208,-2459843
70625,2020-12-31,710,Value,6843650,-8603051,6143208,-2459843
70625,2021-02-14,710,Capital Call,-1210034,-9813085,6143208,-3669877
70625,2021-03-31,710,Value,7992410,-9813085,6143208,-3669877
70774,2020-02-15,613,Capital Call,-1078095,-2856006,23327,-2832679
70774,2020-02-15,613,Distribution,266190,-2856006,289517,-2566489
70774,2020-03-31,613,Value,2097910,-2856006,289517,-2566489
70774,2020-05-16,613,Capital Call,-83030,-2939036,289517,-2649519
70774,2020-06-30,613,Value,2210330,-2939036,289517,-2649519
70774,2020-08-15,613,Capital Call,-876927,-3815963,289517,-3526446
70774,2020-08-15,613,Distribution,56376,-3815963,345893,-3470070
70774,2020-09-30,613,Value,3214550,-3815963,345893,-3470070
70774,2020-11-15,613,Capital Call,-790978,-4606941,345893,-4261048
70774,2020-11-15,613,Distribution,207599,-4606941,553492,-4053449
70774,2020-12-31,613,Value,4309780,-4606941,553492,-4053449
70774,2021-02-14,613,Capital Call,-976705,-5583646,553492,-5030154
70774,2021-02-14,613,Distribution,716147,-5583646,1269639,-4314007
70774,2021-03-31,613,Value,4962940,-5583646,1269639,-4314007
70774,2021-05-16,613,Capital Call,-899742,-6483388,1269639,-5213749
70774,2021-05-16,613,Distribution,244399,-6483388,1514038,-4969350
70774,2021-06-30,613,Value,6182670,-6483388,1514038,-4969350
71136,2020-03-31,5682,Capital Call,-1080000,-3750000,470454,-3279546
71136,2020-03-31,5682,Distribution,1023921,-3750000,1494375,-2255625
71136,2020-06-30,5682,Value,1963870,-3750000,1494375,-2255625
71136,2020-09-30,5682,Distribution,383625,-3750000,1878000,-1872000
71136,2020-12-31,5682,Value,1448250,-3750000,1878000,-1872000
71307,2020-03-31,190539,Value,10403210,-9999998,120617,-9879381
71307,2020-06-30,190539,Value,10382810,-9999998,120617,-9879381
71307,2020-09-30,190539,Value,10401330,-9999998,120617,-9879381
71307,2020-12-31,190539,Value,10520670,-9999998,120617,-9879381
71307,2021-03-29,190539,Distribution,79193,-9999998,199810,-9800188
71307,2021-03-31,190539,Value,10345610,-9999998,199810,-9800188
71307,2021-06-30,190539,Value,11467760,-9999998,199810,-9800188
71307,2021-09-30,190539,Value,10896480,-9999998,199810,-9800188
71359,2020-03-31,4963,Value,8274000,-7000000,553000,-6447000
71359,2020-06-30,4963,Value,8806000,-7000000,553000,-6447000
71359,2020-08-15,4963,Capital Call,-550000,-7550000,553000,-6997000
71359,2020-08-15,4963,Distribution,-1850,-7550000,551150,-6998850
71359,2020-09-30,4963,Value,10018850,-7550000,551150,-6998850
71359,2020-12-30,4963,Capital Call,-150000,-7700000,551150,-7148850
71359,2020-12-30,4963,Distribution,1512450,-7700000,2063600,-5636400
71359,2021-03-31,4963,Value,10679900,-7700000,2063600,-5636400
71425,2020-01-15,102023,Capital Call,-26057,-2454691,0,-2454691
71425,2020-02-29,102023,Value,2658380,-2454691,0,-2454691
71425,2020-04-15,102023,Capital Call,-56250,-2510941,0,-2510941
71425,2020-05-31,102023,Value,2603420,-2510941,0,-2510941
71425,2020-07-16,102023,Capital Call,-1109546,-3620487,0,-3620487
71425,2020-08-31,102023,Value,3964500,-3620487,0,-3620487
71425,2020-10-16,102023,Capital Call,-1010498,-4630985,0,-4630985
71425,2020-11-30,102023,Value,5100380,-4630985,0,-4630985
71425,2021-01-14,102023,Capital Call,-59158,-4690143,0,-4690143
71425,2021-02-28,102023,Value,5159540,-4690143,0,-4690143
71425,2021-04-15,102023,Capital Call,-1519996,-6210139,0,-6210139
71425,2021-05-31,102023,Value,7747730,-6210139,0,-6210139
71425,2021-07-16,102023,Capital Call,-1508677,-7718816,0,-7718816
71425,2021-08-31,102023,Value,9639610,-7718816,0,-7718816
71425,2021-10-16,102023,Capital Call,-56250,-7775066,0,-7775066
71425,2021-11-30,102023,Value,10093910,-7775066,0,-7775066
71454,2020-02-15,231995,Capital Call,-188922,-2722197,94461,-2627736
71454,2020-03-31,231995,Value,2683550,-2722197,94461,-2627736
71454,2020-06-30,231995,Value,2709310,-2722197,94461,-2627736
71454,2020-08-15,231995,Capital Call,-98755,-2820952,94461,-2726491
71454,2020-09-30,231995,Value,3048510,-2820952,94461,-2726491
71454,2020-12-31,231995,Value,4031770,-2820952,94461,-2726491
71454,2021-02-14,231995,Capital Call,-1721769,-4542721,94461,-4448260
71454,2021-03-31,231995,Value,5624730,-4542721,94461,-4448260
71454,2021-05-16,231995,Capital Call,-768570,-5311291,94461,-5216830
71454,2021-06-30,231995,Value,6436230,-5311291,94461,-5216830
71454,2021-08-15,231995,Capital Call,-1704594,-7015885,94461,-6921424
71454,2021-09-30,231995,Value,7960490,-7015885,94461,-6921424
71459,2020-02-15,416,Capital Call,-200000,-7700000,902250,-6797750
71459,2020-02-15,416,Distribution,-216950,-7700000,685300,-7014700
71459,2020-03-31,416,Value,9771300,-7700000,685300,-7014700
71459,2020-05-16,416,Capital Call,-200000,-7900000,685300,-7214700
71459,2020-05-16,416,Distribution,-44610,-7900000,640690,-7259310
71459,2020-06-30,416,Value,10834850,-7900000,640690,-7259310
71459,2020-08-15,416,Capital Call,-1800000,-9700000,640690,-9059310
71459,2020-08-15,416,Distribution,164410,-9700000,805100,-8894900
71459,2020-09-30,416,Value,16907100,-9700000,805100,-8894900
71459,2020-11-15,416,Capital Call,-250000,-9950000,805100,-9144900
71459,2020-11-15,416,Distribution,677450,-9950000,1482550,-8467450
71459,2020-12-31,416,Value,16288150,-9950000,1482550,-8467450
71459,2021-02-14,416,Capital Call,20000,-9930000,1482550,-8447450
71459,2021-02-14,416,Distribution,-261160,-9930000,1221390,-8708610
71459,2021-03-31,416,Value,15957510,-9930000,1221390,-8708610
71459,2021-05-16,416,Distribution,3574800,-9930000,4796190,-5133810
71459,2021-06-30,416,Value,13484940,-9930000,4796190,-5133810
71459,2021-08-15,416,Capital Call,-10000,-9940000,4796190,-5143810
71459,2021-08-15,416,Distribution,44590,-9940000,4840780,-5099220
71459,2021-09-30,416,Value,14244020,-9940000,4840780,-5099220
71463,2020-02-15,437,Capital Call,-39000,-2800000,0,-2800000
71463,2020-03-31,437,Value,2212000,-2800000,0,-2800000
71463,2020-05-16,437,Capital Call,-1760000,-4560000,0,-4560000
71463,2020-06-30,437,Value,3885120,-4560000,0,-4560000
71463,2020-08-15,437,Capital Call,-40000,-4600000,0,-4600000
71463,2020-09-30,437,Value,4508000,-4600000,0,-4600000
71463,2020-11-15,437,Capital Call,-1327000,-5927000,0,-5927000
71463,2020-11-15,437,Distribution,1541020,-5927000,1541020,-4385980
71463,2020-12-31,437,Value,6341890,-5927000,1541020,-4385980
71463,2021-02-14,437,Capital Call,27000,-5900000,1541020,-4358980
71463,2021-02-14,437,Distribution,-7020,-5900000,1534000,-4366000
71463,2021-03-31,437,Value,6667000,-5900000,1534000,-4366000
71463,2021-06-30,437,Value,8673000,-5900000,1534000,-4366000
71463,2021-08-15,437,Capital Call,-1200000,-7100000,1534000,-5566000
71463,2021-08-15,437,Distribution,738000,-7100000,2272000,-4828000
71463,2021-09-30,437,Value,8946000,-7100000,2272000,-4828000
71463,2021-11-15,437,Capital Call,-1613800,-8713800,2272000,-6441800
71463,2021-11-15,437,Distribution,-6412,-8713800,2265588,-6448212
71463,2021-12-31,437,Value,10543690,-8713800,2265588,-6448212
71534,2020-02-15,110814,Capital Call,-1435000,-4515001,187572,-4327429
71534,2020-02-15,110814,Distribution,-200,-4515001,187372,-4327629
71534,2020-03-31,110814,Value,3893280,-4515001,187372,-4327629
71534,2020-06-30,110814,Value,3845420,-4515001,187372,-4327629
71534,2020-08-15,110814,Capital Call,-99000,-4614001,187372,-4426629
71534,2020-08-15,110814,Distribution,-44,-4614001,187328,-4426673
71534,2020-09-30,110814,Value,3898360,-4614001,187328,-4426673
71534,2020-11-15,110814,Distribution,-2768,-4614001,184560,-4429441
71534,2020-12-31,110814,Value,3850840,-4614001,184560,-4429441
71534,2021-02-14,110814,Capital Call,-1240000,-5854001,184560,-5669441
71534,2021-02-14,110814,Distribution,2768,-5854001,187328,-5666673
71534,2021-03-31,110814,Value,5049660,-5854001,187328,-5666673
71534,2021-06-30,110814,Value,6798830,-5854001,187328,-5666673
71534,2021-08-15,110814,Capital Call,-82000,-5936001,187328,-5748673
71534,2021-08-15,110814,Distribution,250,-5936001,187578,-5748423
71534,2021-09-30,110814,Value,7331550,-5936001,187578,-5748423
71544,2020-03-31,871,Value,4295840,-8244999,15783830,7538831
71676,2020-02-15,496,Capital Call,-1500000,-7500000,1290946,-6209054
71676,2020-03-31,496,Value,8487700,-7500000,1290946,-6209054
71676,2020-05-16,496,Capital Call,-500000,-8000000,1290946,-6709054
71676,2020-05-16,496,Distribution,555090,-8000000,1846036,-6153964
71676,2020-06-30,496,Value,8860380,-8000000,1846036,-6153964
71676,2020-08-15,496,Distribution,550947,-8000000,2396983,-5603017
71676,2020-09-30,496,Value,11358990,-8000000,2396983,-5603017
71676,2020-11-15,496,Capital Call,-1000000,-9000000,2396983,-6603017
71676,2020-11-15,496,Distribution,684342,-9000000,3081325,-5918675
71676,2020-12-31,496,Value,13740080,-9000000,3081325,-5918675
71676,2021-02-14,496,Capital Call,-500000,-9500000,3081325,-6418675
71676,2021-03-31,496,Value,15909760,-9500000,3081325,-6418675
71676,2021-06-30,496,Value,16721230,-9500000,3081325,-6418675
71725,2020-07-01,2304,Capital Call,-2707855,-7974495,819320,-7155175
71725,2020-07-01,2304,Distribution,-723775,-7974495,95545,-7878950
71725,2020-12-31,2304,Value,9380900,-7974495,95545,-7878950
71725,2021-02-14,2304,Capital Call,-89650,-8064145,95545,-7968600
71725,2021-02-14,2304,Distribution,2714355,-8064145,2809900,-5254245
71725,2021-03-31,2304,Value,9239730,-8064145,2809900,-5254245
71769,2020-02-15,673,Capital Call,-1160000,-6150000,0,-6150000
71769,2020-03-31,673,Value,6243800,-6150000,0,-6150000
71769,2020-05-16,673,Capital Call,-605000,-6755000,0,-6755000
71769,2020-06-30,673,Value,6764080,-6755000,0,-6755000
71769,2020-08-15,673,Capital Call,-615000,-7370000,0,-7370000
71769,2020-09-30,673,Value,7440660,-7370000,0,-7370000
71769,2020-11-15,673,Capital Call,-275000,-7645000,0,-7645000
71769,2020-12-31,673,Value,7887300,-7645000,0,-7645000
71769,2021-03-31,673,Value,9102880,-7645000,0,-7645000
71882,2020-02-15,2074,Capital Call,-82051,-3008511,0,-3008511
71882,2020-03-31,2074,Value,2327050,-3008511,0,-3008511
71882,2020-05-16,2074,Capital Call,-310181,-3318692,0,-3318692
71882,2020-06-30,2074,Value,2007180,-3318692,0,-3318692
71882,2020-09-30,2074,Capital Call,-552488,-3871180,0,-3871180
71882,2020-12-31,2074,Value,2554680,-3871180,0,-3871180
71882,2021-02-14,2074,Capital Call,-407805,-4278985,0,-4278985
71882,2021-03-31,2074,Value,3768800,-4278985,0,-4278985
71882,2021-05-16,2074,Capital Call,-443665,-4722650,0,-4722650
71882,2021-05-16,2074,Distribution,4751,-4722650,4751,-4717899
71882,2021-06-30,2074,Value,4516660,-4722650,4751,-4717899
72188,2020-03-31,14052,Value,5427420,-4865990,0,-4865990
72188,2020-05-16,14052,Capital Call,-1153712,-6019702,0,-6019702
72188,2020-06-30,14052,Value,6801560,-6019702,0,-6019702
72188,2020-08-15,14052,Capital Call,-665168,-6684870,0,-6684870
72188,2020-09-30,14052,Value,7854020,-6684870,0,-6684870
72188,2020-12-31,14052,Value,8488190,-6684870,0,-6684870
72188,2021-03-31,14052,Value,8969330,-6684870,0,-6684870
72188,2021-05-16,14052,Capital Call,-965171,-7650041,0,-7650041
72188,2021-06-30,14052,Value,12771720,-7650041,0,-7650041
72216,2020-03-31,107000,Capital Call,-7702702,-7702702,0,-7702702
72216,2020-03-31,107000,Value,7617890,-7702702,0,-7702702
72216,2020-05-16,107000,Capital Call,-25000,-7727702,0,-7727702
72216,2020-06-30,107000,Value,6937840,-7727702,0,-7727702
72216,2020-08-15,107000,Capital Call,-1285000,-9012702,0,-9012702
72216,2020-09-30,107000,Value,9514080,-9012702,0,-9012702
72216,2020-11-15,107000,Capital Call,-2150510,-11163212,0,-11163212
72216,2020-11-15,107000,Distribution,2439843,-11163212,2439843,-8723369
72216,2020-12-31,107000,Value,9224750,-11163212,2439843,-8723369
72216,2021-02-14,107000,Capital Call,-114170,-11277382,2439843,-8837539
72216,2021-02-14,107000,Distribution,669475,-11277382,3109318,-8168064
72216,2021-03-31,107000,Value,9446910,-11277382,3109318,-8168064
72295,2020-03-31,20411,Capital Call,-500000,-4000000,0,-4000000
72295,2020-06-30,20411,Value,5880000,-4000000,0,-4000000
72295,2020-09-30,20411,Capital Call,-500000,-4500000,0,-4500000
72295,2020-12-31,20411,Value,6525000,-4500000,0,-4500000
72295,2021-04-01,20411,Capital Call,-500000,-5000000,0,-5000000
72295,2021-06-30,20411,Value,7100000,-5000000,0,-5000000
72458,2020-02-15,302,Capital Call,-75000,-5200000,0,-5200000
72458,2020-03-31,302,Value,5634990,-5200000,0,-5200000
72458,2020-06-30,302,Value,5880000,-5200000,0,-5200000
72458,2020-08-15,302,Capital Call,-1900000,-7100000,0,-7100000
72458,2020-09-30,302,Value,8329990,-7100000,0,-7100000
72458,2020-11-15,302,Capital Call,-850000,-7950000,0,-7950000
72458,2020-12-31,302,Value,10214990,-7950000,0,-7950000
72458,2021-02-14,302,Capital Call,-1125000,-9075000,0,-9075000
72458,2021-03-31,302,Value,12479990,-9075000,0,-9075000
72458,2021-06-30,302,Value,13844990,-9075000,0,-9075000
72458,2021-08-15,302,Distribution,955000,-9075000,955000,-8120000
72458,2021-09-30,302,Value,14324990,-9075000,955000,-8120000
72525,2020-03-31,58200,Value,27600300,-9100001,0,-9100001
72525,2020-05-16,58200,Capital Call,-310000,-9410001,0,-9410001
72525,2020-06-30,58200,Value,28533940,-9410001,0,-9410001
72525,2020-09-30,58200,Value,28528290,-9410001,0,-9410001
72525,2020-11-15,58200,Capital Call,-415000,-9825001,0,-9825001
72525,2020-12-31,58200,Value,34187060,-9825001,0,-9825001
72525,2021-03-31,58200,Value,35342490,-9825001,0,-9825001
72527,2020-03-31,14052,Value,4195140,-3080857,0,-3080857
72527,2020-05-16,14052,Capital Call,-2021707,-5102564,0,-5102564
72527,2020-06-30,14052,Value,5983090,-5102564,0,-5102564
72527,2020-08-15,14052,Capital Call,-1213562,-6316126,0,-6316126
72527,2020-09-30,14052,Value,7457920,-6316126,0,-6316126
72527,2020-12-31,14052,Value,8029480,-6316126,0,-6316126
72527,2021-03-31,14052,Value,8572990,-6316126,0,-6316126
72527,2021-06-30,14052,Value,9755400,-6316126,0,-6316126
72563,2020-01-17,190539,Capital Call,-192653,-7870672,0,-7870672
72563,2020-03-31,190539,Value,8995870,-7870672,0,-7870672
72563,2020-06-30,190539,Value,8971680,-7870672,0,-7870672
72584,2020-03-31,375,Value,4997830,-4810000,0,-4810000
72584,2020-05-16,375,Capital Call,-608000,-5418000,0,-5418000
72584,2020-06-30,375,Value,5566860,-5418000,0,-5418000
72584,2020-08-15,375,Capital Call,-553000,-5971000,0,-5971000
72584,2020-09-30,375,Value,6414110,-5971000,0,-5971000
72584,2020-11-15,375,Capital Call,-629000,-6600000,0,-6600000
72584,2020-12-31,375,Value,7644990,-6600000,0,-6600000
72584,2021-02-14,375,Capital Call,-709000,-7309000,0,-7309000
72584,2021-03-31,375,Value,9450250,-7309000,0,-7309000
72785,2020-01-17,190539,Capital Call,-448189,-7842020,0,-7842020
72785,2020-03-31,190539,Value,11065710,-7842020,0,-7842020
72785,2020-05-28,190539,Capital Call,-2779784,-10621804,0,-10621804
72785,2020-06-30,190539,Value,13911530,-10621804,0,-10621804
72786,2020-02-15,264,Capital Call,-140174,-5984790,2171611,-3813179
72786,2020-03-31,264,Value,4872410,-5984790,2171611,-3813179
72786,2020-05-16,264,Capital Call,-1753893,-7738683,2171611,-5567072
72786,2020-05-16,264,Distribution,301487,-7738683,2473098,-5265585
72786,2020-06-30,264,Value,6457110,-7738683,2473098,-5265585
72786,2020-08-15,264,Capital Call,-82213,-7820896,2473098,-5347798
72786,2020-09-30,264,Value,7977100,-7820896,2473098,-5347798
72786,2020-12-31,264,Value,9094130,-7820896,2473098,-5347798
72786,2021-02-14,264,Capital Call,-923928,-8744824,2473098,-6271726
72786,2021-03-31,264,Value,10547700,-8744824,2473098,-6271726
72786,2021-05-16,264,Capital Call,-825774,-9570598,2473098,-7097500
72786,2021-05-16,264,Distribution,1002553,-9570598,3475651,-6094947
72786,2021-06-30,264,Value,10457850,-9570598,3475651,-6094947
72984,2020-03-31,10770,Value,9297000,-7605000,1139333,-6465667
72984,2020-05-16,10770,Capital Call,-595000,-8200000,1139333,-7060667
72984,2020-06-30,10770,Value,11260660,-8200000,1139333,-7060667
72984,2020-08-15,10770,Capital Call,-120000,-8320000,1139333,-7180667
72984,2020-09-30,10770,Value,12027660,-8320000,1139333,-7180667
72984,2020-11-15,10770,Capital Call,-1160000,-9480000,1139333,-8340667
72984,2020-12-31,10770,Value,21631660,-9480000,1139333,-8340667
72984,2021-02-14,10770,Capital Call,-520000,-10000000,1139333,-8860667
72984,2021-03-31,10770,Value,26271330,-10000000,1139333,-8860667
72984,2021-05-16,10770,Distribution,2852333,-10000000,3991666,-6008334
72984,2021-06-30,10770,Value,22485330,-10000000,3991666,-6008334
73098,2020-02-15,28684,Capital Call,-1086349,-2841676,0,-2841676
73098,2020-03-31,28684,Value,2939820,-2841676,0,-2841676
73098,2020-06-30,28684,Value,3197880,-2841676,0,-2841676
73098,2020-09-30,28684,Value,3784950,-2841676,0,-2841676
73098,2020-11-15,28684,Capital Call,-592531,-3434207,0,-3434207
73098,2020-12-31,28684,Value,5267800,-3434207,0,-3434207
73098,2021-02-14,28684,Capital Call,-366949,-3801156,0,-3801156
73098,2021-02-14,28684,Distribution,1338722,-3801156,1338722,-2462434
73098,2021-03-31,28684,Value,4976380,-3801156,1338722,-2462434
73098,2021-05-16,28684,Capital Call,-2218967,-6020123,1338722,-4681401
73098,2021-05-16,28684,Distribution,524869,-6020123,1863591,-4156532
73098,2021-06-30,28684,Value,7634030,-6020123,1863591,-4156532
73238,2020-02-15,8710,Capital Call,-1090667,-6061333,1810666,-4250667
73238,2020-02-15,8710,Distribution,28667,-6061333,1839333,-4222000
73238,2020-03-31,8710,Value,7356660,-6061333,1839333,-4222000
73238,2020-05-16,8710,Distribution,668000,-6061333,2507333,-3554000
73238,2020-06-30,8710,Value,8215330,-6061333,2507333,-3554000
73238,2020-08-15,8710,Capital Call,-250000,-6311333,2507333,-3804000
73238,2020-09-30,8710,Value,8325330,-6311333,2507333,-3804000
73238,2020-11-15,8710,Capital Call,-300000,-6611333,2507333,-4104000
73238,2020-12-31,8710,Value,9458000,-6611333,2507333,-4104000
73238,2021-02-14,8710,Capital Call,-450000,-7061333,2507333,-4554000
73238,2021-03-31,8710,Value,9576660,-7061333,2507333,-4554000
73238,2021-06-30,8710,Value,10006660,-7061333,2507333,-4554000
73279,2020-02-15,264,Capital Call,-493000,-7613000,0,-7613000
73279,2020-03-31,264,Value,8340800,-7613000,0,-7613000
73281,2020-02-15,475912,Capital Call,-509919,-6028960,91935,-5937025
73281,2020-03-31,475912,Value,5933500,-6028960,91935,-5937025
73281,2020-05-16,475912,Capital Call,-249413,-6278373,91935,-6186438
73281,2020-05-16,475912,Distribution,2098,-6278373,94033,-6184340
73281,2020-06-30,475912,Value,6425050,-6278373,94033,-6184340
73281,2020-08-15,475912,Capital Call,-473188,-6751561,94033,-6657528
73281,2020-08-15,475912,Distribution,931,-6751561,94964,-6656597
73281,2020-09-30,475912,Value,7917530,-6751561,94964,-6656597
73281,2020-11-15,475912,Capital Call,-672852,-7424413,94964,-7329449
73281,2020-11-15,475912,Distribution,75354,-7424413,170318,-7254095
73281,2020-12-31,475912,Value,9759950,-7424413,170318,-7254095
73281,2021-02-14,475912,Capital Call,-1356015,-8780428,170318,-8610110
73281,2021-02-14,475912,Distribution,1618,-8780428,171936,-8608492
73281,2021-03-31,475912,Value,13191550,-8780428,171936,-8608492
73355,2020-03-31,428403,Value,718470,-987505,366276,-621229
73355,2020-05-16,428403,Capital Call,-250000,-1237505,366276,-871229
73355,2020-05-16,428403,Distribution,40295,-1237505,406571,-830934
73355,2020-06-30,428403,Value,964430,-1237505,406571,-830934
73355,2020-08-15,428403,Capital Call,-800000,-2037505,406571,-1630934
73355,2020-08-15,428403,Distribution,73903,-2037505,480474,-1557031
73355,2020-09-30,428403,Value,1770510,-2037505,480474,-1557031
73355,2020-11-15,428403,Capital Call,-1052672,-3090177,480474,-2609703
73355,2020-11-15,428403,Distribution,79998,-3090177,560472,-2529705
73355,2020-12-31,428403,Value,2823180,-3090177,560472,-2529705
73355,2021-02-14,428403,Capital Call,-400844,-3491021,560472,-2930549
73355,2021-02-14,428403,Distribution,1464862,-3491021,2025334,-1465687
73355,2021-03-31,428403,Value,3383560,-3491021,2025334,-1465687
73355,2021-05-16,428403,Capital Call,-761283,-4252304,2025334,-2226970
73355,2021-05-16,428403,Distribution,80179,-4252304,2105513,-2146791
73355,2021-06-30,428403,Value,5251380,-4252304,2105513,-2146791
73355,2021-08-15,428403,Capital Call,-412204,-4664508,2105513,-2558995
73355,2021-08-15,428403,Distribution,455920,-4664508,2561433,-2103075
73355,2021-09-30,428403,Value,5726910,-4664508,2561433,-2103075
73388,2020-03-31,67055,Value,11876770,-9501423,95015,-9406408
73388,2020-05-16,67055,Distribution,380057,-9501423,475072,-9026351
73388,2020-06-30,67055,Value,12731900,-9501423,475072,-9026351
73388,2020-08-15,67055,Capital Call,1422,-9500001,475072,-9024929
73388,2020-08-15,67055,Distribution,5629,-9500001,480701,-9019300
73388,2020-09-30,67055,Value,14734500,-9500001,480701,-9019300
73388,2020-11-15,67055,Capital Call,-200000,-9700001,480701,-9219300
73388,2020-11-15,67055,Distribution,4300,-9700001,485001,-9215000
73388,2020-12-31,67055,Value,19206000,-9700001,485001,-9215000
73410,2020-02-15,9343,Capital Call,-133867,-3043934,353798,-2690136
73410,2020-03-31,9343,Value,2840020,-3043934,353798,-2690136
73410,2020-05-16,9343,Capital Call,-1041509,-4085443,353798,-3731645
73410,2020-06-30,9343,Value,3287120,-4085443,353798,-3731645
73410,2020-08-15,9343,Capital Call,-982541,-5067984,353798,-4714186
73410,2020-09-30,9343,Value,4175060,-5067984,353798,-4714186
73410,2020-11-15,9343,Capital Call,-357802,-5425786,353798,-5071988
73410,2020-11-15,9343,Distribution,5164,-5425786,358962,-5066824
73410,2020-12-31,9343,Value,4389250,-5425786,358962,-5066824
73410,2021-02-14,9343,Capital Call,-232756,-5658542,358962,-5299580
73410,2021-02-14,9343,Distribution,4389,-5658542,363351,-5295191
73410,2021-03-31,9343,Value,4928780,-5658542,363351,-5295191
73410,2021-05-16,9343,Distribution,175109,-5658542,538460,-5120082
73410,2021-06-30,9343,Value,4175900,-5658542,538460,-5120082
73471,2020-03-31,116384,Value,2002000,-3500000,0,-3500000
73471,2020-07-01,116384,Capital Call,-2000000,-5500000,0,-5500000
73471,2020-07-01,116384,Distribution,275000,-5500000,275000,-5225000
73471,2020-09-30,116384,Value,4125000,-5500000,275000,-5225000
73492,2020-02-15,733,Capital Call,-373520,-5555653,13404,-5542249
73492,2020-02-15,733,Distribution,71797,-5555653,85201,-5470452
73492,2020-03-31,733,Value,5448300,-5555653,85201,-5470452
73492,2020-05-16,733,Capital Call,-607316,-6162969,85201,-6077768
73492,2020-06-30,733,Value,5673850,-6162969,85201,-6077768
73492,2020-08-15,733,Capital Call,-1126770,-7289739,85201,-7204538
73492,2020-08-15,733,Distribution,27007,-7289739,112208,-7177531
73492,2020-09-30,733,Value,6773610,-7289739,112208,-7177531
73492,2020-11-15,733,Capital Call,-21060,-7310799,112208,-7198591
73492,2020-11-15,733,Distribution,93162,-7310799,205370,-7105429
73492,2020-12-31,733,Value,7077040,-7310799,205370,-7105429
73492,2021-02-14,733,Capital Call,-322613,-7633412,205370,-7428042
73492,2021-02-14,733,Distribution,179341,-7633412,384711,-7248701
73492,2021-03-31,733,Value,7518530,-7633412,384711,-7248701
73585,2020-02-15,80,Capital Call,-488000,-5052000,20000,-5032000
73585,2020-03-31,80,Value,4396000,-5052000,20000,-5032000
73585,2020-05-16,80,Capital Call,-272000,-5324000,20000,-5304000
73585,2020-06-30,80,Value,4727990,-5324000,20000,-5304000
73585,2020-08-15,80,Capital Call,-876000,-6200000,20000,-6180000
73585,2020-09-30,80,Value,5224000,-6200000,20000,-6180000
73585,2020-11-15,80,Capital Call,-1164000,-7364000,20000,-7344000
73585,2020-11-15,80,Distribution,496000,-7364000,516000,-6848000
73585,2020-12-31,80,Value,7543990,-7364000,516000,-6848000
73585,2021-02-14,80,Capital Call,-872000,-8236000,516000,-7720000
73585,2021-02-14,80,Distribution,324000,-8236000,840000,-7396000
73585,2021-03-31,80,Value,8267990,-8236000,840000,-7396000
73585,2021-05-16,80,Capital Call,-504000,-8740000,840000,-7900000
73585,2021-05-16,80,Distribution,616000,-8740000,1456000,-7284000
73585,2021-06-30,80,Value,9471990,-8740000,1456000,-7284000
73585,2021-08-15,80,Capital Call,150000,-8590000,1456000,-7134000
73585,2021-08-15,80,Distribution,8000,-8590000,1464000,-7126000
73585,2021-09-30,80,Value,9851190,-8590000,1464000,-7126000
73698,2020-01-15,47277,Capital Call,-7578,-9901988,13435211,3533223
73698,2020-01-15,47277,Distribution,23875,-9901988,13459086,3557098
73698,2020-02-29,47277,Value,7494830,-9901988,13459086,3557098
73698,2020-04-15,47277,Capital Call,-305199,-10207187,13459086,3251899
73698,2020-04-15,47277,Distribution,217301,-10207187,13676387,3469200
73698,2020-05-31,47277,Value,4783930,-10207187,13676387,3469200
73698,2020-07-16,47277,Capital Call,-16857,-10224044,13676387,3452343
73698,2020-07-16,47277,Distribution,16857,-10224044,13693244,3469200
73698,2020-08-31,47277,Value,5032090,-10224044,13693244,3469200
73698,2020-10-16,47277,Capital Call,-20103,-10244147,13693244,3449097
73698,2020-10-16,47277,Distribution,87024,-10244147,13780268,3536121
73698,2020-11-30,47277,Value,5281490,-10244147,13780268,3536121
73698,2021-01-14,47277,Capital Call,-11198,-10255345,13780268,3524923
73698,2021-01-14,47277,Distribution,32014,-10255345,13812282,3556937
73698,2021-02-28,47277,Value,5252580,-10255345,13812282,3556937
73698,2021-04-15,47277,Capital Call,-5994,-10261339,13812282,3550943
73698,2021-05-31,47277,Value,5934470,-10261339,13812282,3550943
73698,2021-07-16,47277,Capital Call,-16884,-10278223,13812282,3534059
73698,2021-07-16,47277,Distribution,10198,-10278223,13822480,3544257
73698,2021-08-31,47277,Value,6389160,-10278223,13822480,3544257
73698,2021-10-16,47277,Capital Call,-5575,-10283798,13822480,3538682
73698,2021-10-16,47277,Distribution,195182,-10283798,14017662,3733864
73698,2021-11-30,47277,Value,6847530,-10283798,14017662,3733864
73701,2020-03-31,94243,Value,14700000,-10000000,0,-10000000
73701,2020-09-30,94243,Value,14900000,-10000000,0,-10000000
73701,2021-03-31,94243,Value,18900000,-10000000,0,-10000000
73701,2021-09-30,94243,Value,22900000,-10000000,0,-10000000
73713,2020-03-31,346,Value,4433780,-4355000,195338,-4159662
73713,2020-05-16,346,Capital Call,-250000,-4605000,195338,-4409662
73713,2020-06-30,346,Value,4431440,-4605000,195338,-4409662
73713,2020-08-15,346,Capital Call,-1305000,-5910000,195338,-5714662
73713,2020-08-15,346,Distribution,36466,-5910000,231804,-5678196
73713,2020-09-30,346,Value,6472740,-5910000,231804,-5678196
73713,2020-11-15,346,Capital Call,-636734,-6546734,231804,-6314930
73713,2020-11-15,346,Distribution,1682810,-6546734,1914614,-4632120
73713,2020-12-31,346,Value,6471400,-6546734,1914614,-4632120
73713,2021-04-01,346,Capital Call,-43959,-6590693,1914614,-4676079
73713,2021-04-01,346,Distribution,-497128,-6590693,1417486,-5173207
73713,2021-06-30,346,Value,8167520,-6590693,1417486,-5173207
73786,2020-03-31,13158,Value,4707710,-4700000,0,-4700000
73786,2020-05-16,13158,Capital Call,-800000,-5500000,0,-5500000
73786,2020-06-30,13158,Value,5568060,-5500000,0,-5500000
73786,2020-08-15,13158,Capital Call,-800000,-6300000,0,-6300000
73786,2020-09-30,13158,Value,6784860,-6300000,0,-6300000
73786,2020-11-15,13158,Capital Call,-800000,-7100000,0,-7100000
73786,2020-12-31,13158,Value,8244970,-7100000,0,-7100000
73786,2021-02-14,13158,Capital Call,-800000,-7900000,0,-7900000
73786,2021-03-31,13158,Value,11190890,-7900000,0,-7900000
73795,2020-03-31,1314,Value,1673820,-1700000,0,-1700000
73795,2020-05-16,1314,Capital Call,-750000,-2450000,0,-2450000
73795,2020-06-30,1314,Value,2600180,-2450000,0,-2450000
73795,2020-08-15,1314,Capital Call,-300000,-2750000,0,-2750000
73795,2020-09-30,1314,Value,3246920,-2750000,0,-2750000
73795,2020-11-15,1314,Capital Call,-450000,-3200000,0,-3200000
73795,2020-12-31,1314,Value,4699200,-3200000,0,-3200000
73795,2021-02-14,1314,Capital Call,-225000,-3425000,0,-3425000
73795,2021-03-31,1314,Value,5149830,-3425000,0,-3425000
73795,2021-05-16,1314,Capital Call,-750000,-4175000,0,-4175000
73795,2021-05-16,1314,Distribution,84335,-4175000,84335,-4090665
73795,2021-06-30,1314,Value,6700040,-4175000,84335,-4090665
73795,2021-08-15,1314,Capital Call,-500000,-4675000,84335,-4590665
73795,2021-08-15,1314,Distribution,81160,-4675000,165495,-4509505
73795,2021-09-30,1314,Value,7329930,-4675000,165495,-4509505
73801,2020-03-31,10869,Value,8514000,-7400000,0,-7400000
73801,2020-05-16,10869,Capital Call,-600000,-8000000,0,-8000000
73801,2020-06-30,10869,Value,9018330,-8000000,0,-8000000
73801,2020-09-30,10869,Value,9364660,-8000000,0,-8000000
73801,2020-11-15,10869,Capital Call,-500000,-8500000,0,-8500000
73801,2020-12-31,10869,Value,16008330,-8500000,0,-8500000
73801,2021-03-31,10869,Value,16941330,-8500000,0,-8500000
73801,2021-05-16,10869,Capital Call,-400000,-8900000,0,-8900000
73801,2021-06-30,10869,Value,18769330,-8900000,0,-8900000
74000,2020-03-31,4955,Value,948850,-1179000,0,-1179000
74000,2020-05-16,4955,Capital Call,-994000,-2173000,0,-2173000
74000,2020-06-30,4955,Value,2371820,-2173000,0,-2173000
74000,2020-08-15,4955,Capital Call,-1073000,-3246000,0,-3246000
74000,2020-09-30,4955,Value,4088660,-3246000,0,-3246000
74000,2020-11-15,4955,Capital Call,-939000,-4185000,0,-4185000
74000,2020-12-31,4955,Value,5237100,-4185000,0,-4185000
74000,2021-02-14,4955,Capital Call,-51000,-4236000,0,-4236000
74000,2021-02-14,4955,Distribution,4236,-4236000,4236,-4231764
74000,2021-03-31,4955,Value,5698260,-4236000,4236,-4231764
74000,2021-05-16,4955,Distribution,424,-4236000,4660,-4231340
74000,2021-06-30,4955,Value,6842830,-4236000,4660,-4231340
74000,2021-08-15,4955,Capital Call,-250000,-4486000,4660,-4481340
74000,2021-08-15,4955,Distribution,1998788,-4486000,2003448,-2482552
74000,2021-09-30,4955,Value,7230080,-4486000,2003448,-2482552
74006,2020-02-15,1430,Capital Call,-900000,-5300000,0,-5300000
74006,2020-03-31,1430,Value,6710630,-5300000,0,-5300000
74006,2020-05-16,1430,Capital Call,-450000,-5750000,0,-5750000
74006,2020-06-30,1430,Value,7096090,-5750000,0,-5750000
74006,2020-08-15,1430,Capital Call,-550000,-6300000,0,-6300000
74006,2020-09-30,1430,Value,7828010,-6300000,0,-6300000
74006,2020-11-15,1430,Capital Call,-550000,-6850000,0,-6850000
74006,2020-12-31,1430,Value,10776950,-6850000,0,-6850000
74006,2021-02-14,1430,Capital Call,-650000,-7500000,0,-7500000
74006,2021-03-31,1430,Value,16259570,-7500000,0,-7500000
74006,2021-05-16,1430,Capital Call,-500000,-8000000,0,-8000000
74006,2021-06-30,1430,Value,17932970,-8000000,0,-8000000
74196,2020-02-15,736,Capital Call,-1293986,-6242201,0,-6242201
74196,2020-03-31,736,Value,6441430,-6242201,0,-6242201
74196,2020-05-16,736,Capital Call,-732008,-6974209,0,-6974209
74196,2020-06-30,736,Value,5359030,-6974209,0,-6974209
74196,2020-09-30,736,Value,5725980,-6974209,0,-6974209
74196,2020-11-15,736,Capital Call,-1349847,-8324056,0,-8324056
74196,2020-12-31,736,Value,6633200,-8324056,0,-8324056
74196,2021-02-14,736,Capital Call,-1349847,-9673903,0,-9673903
74196,2021-03-31,736,Value,9843420,-9673903,0,-9673903
74196,2021-05-16,736,Capital Call,-1349847,-11023750,0,-11023750
74196,2021-06-30,736,Value,11193280,-11023750,0,-11023750
74196,2021-08-15,736,Capital Call,-224974,-11248724,0,-11248724
74196,2021-08-15,736,Distribution,154974,-11248724,154974,-11093750
74196,2021-09-30,736,Value,11305760,-11248724,154974,-11093750
74212,2020-02-15,18,Capital Call,-625199,-4075074,209822,-3865252
74212,2020-02-15,18,Distribution,11,-4075074,209833,-3865241
74212,2020-03-31,18,Value,3929630,-4075074,209833,-3865241
74212,2020-05-16,18,Capital Call,-500009,-4575083,209833,-4365250
74212,2020-06-30,18,Value,4866250,-4575083,209833,-4365250
74212,2020-09-30,18,Value,5474680,-4575083,209833,-4365250
74212,2020-12-31,18,Value,6563120,-4575083,209833,-4365250
74212,2021-02-14,18,Capital Call,-250005,-4825088,209833,-4615255
74212,2021-03-31,18,Value,7429380,-4825088,209833,-4615255
74212,2021-05-16,18,Capital Call,-499912,-5325000,209833,-5115167
74212,2021-05-16,18,Distribution,148324,-5325000,358157,-4966843
74212,2021-06-30,18,Value,8999620,-5325000,358157,-4966843
74212,2021-08-15,18,Capital Call,-500000,-5825000,358157,-5466843
74212,2021-08-15,18,Distribution,250000,-5825000,608157,-5216843
74212,2021-09-30,18,Value,9950410,-5825000,608157,-5216843
74231,2020-02-15,18,Capital Call,-900098,-5700000,222984,-5477016
74231,2020-02-15,18,Distribution,5,-5700000,222989,-5477011
74231,2020-03-31,18,Value,5669540,-5700000,222989,-5477011
74231,2020-05-16,18,Capital Call,-500000,-6200000,222989,-5977011
74231,2020-06-30,18,Value,6678990,-6200000,222989,-5977011
74231,2020-09-30,18,Value,7367280,-6200000,222989,-5977011
74231,2020-12-31,18,Value,8576190,-6200000,222989,-5977011
74231,2021-02-14,18,Capital Call,-250000,-6450000,222989,-6227011
74231,2021-03-31,18,Value,10123250,-6450000,222989,-6227011
74231,2021-05-16,18,Capital Call,-349861,-6799861,222989,-6576872
74231,2021-05-16,18,Distribution,99099,-6799861,322088,-6477773
74231,2021-06-30,18,Value,12685910,-6799861,322088,-6477773
74231,2021-08-15,18,Capital Call,-499990,-7299851,322088,-6977763
74231,2021-08-15,18,Distribution,249995,-7299851,572083,-6727768
74231,2021-09-30,18,Value,14715130,-7299851,572083,-6727768
74242,2020-03-31,434,Value,4168890,-3585628,190196,-3395432
74242,2020-05-16,434,Capital Call,-425249,-4010877,190196,-3820681
74242,2020-06-30,434,Value,4880470,-4010877,190196,-3820681
74242,2020-08-15,434,Capital Call,-492583,-4503460,190196,-4313264
74242,2020-09-30,434,Value,5462590,-4503460,190196,-4313264
74253,2020-02-15,268672,Capital Call,-1610000,-6910000,0,-6910000
74253,2020-03-31,268672,Value,8222900,-6910000,0,-6910000
74253,2020-06-30,268672,Value,8361100,-6910000,0,-6910000
74253,2020-09-30,268672,Value,10503200,-6910000,0,-6910000
74253,2020-11-15,268672,Capital Call,-290000,-7200000,0,-7200000
74253,2020-12-31,268672,Value,10944000,-7200000,0,-7200000
74253,2021-02-14,268672,Capital Call,-420000,-7620000,0,-7620000
74253,2021-03-31,268672,Value,11582400,-7620000,0,-7620000
74253,2021-06-30,268672,Value,12420600,-7620000,0,-7620000
74253,2021-08-15,268672,Capital Call,-300000,-7920000,0,-7920000
74253,2021-09-30,268672,Value,14414400,-7920000,0,-7920000
74325,2020-03-31,3795,Capital Call,-1700000,-5600000,0,-5600000
74325,2020-06-30,3795,Value,8167600,-5600000,0,-5600000
74325,2020-08-15,3795,Capital Call,-300000,-5900000,0,-5900000
74325,2020-09-30,3795,Value,9428200,-5900000,0,-5900000
74325,2020-11-15,3795,Capital Call,-100000,-6000000,0,-6000000
74325,2020-12-31,3795,Value,10474200,-6000000,0,-6000000
74325,2021-02-14,3795,Capital Call,-200000,-6200000,0,-6200000
74325,2021-03-31,3795,Value,12837100,-6200000,0,-6200000
74325,2021-05-16,3795,Capital Call,-500000,-6700000,0,-6700000
74325,2021-06-30,3795,Value,15276000,-6700000,0,-6700000
74325,2021-08-15,3795,Capital Call,-200000,-6900000,0,-6900000
74325,2021-09-30,3795,Value,16097700,-6900000,0,-6900000
74325,2021-11-15,3795,Capital Call,-200000,-7100000,0,-7100000
74325,2021-12-31,3795,Value,15923170,-7100000,0,-7100000
74350,2020-03-31,367,Value,925930,-892630,287,-892343
74350,2020-05-16,367,Capital Call,-17461,-910091,287,-909804
74350,2020-06-30,367,Value,732460,-910091,287,-909804
74350,2020-09-30,367,Value,795630,-910091,287,-909804
74350,2020-11-15,367,Capital Call,-1047689,-1957780,287,-1957493
74350,2020-12-31,367,Value,1997740,-1957780,287,-1957493
74350,2021-03-31,367,Value,2175200,-1957780,287,-1957493
74395,2020-02-15,111,Capital Call,-37500,-3754582,227730,-3526852
74395,2020-03-31,111,Value,4015690,-3754582,227730,-3526852
74395,2020-05-16,111,Capital Call,-839569,-4594151,227730,-4366421
74395,2020-06-30,111,Value,4983080,-4594151,227730,-4366421
74395,2020-08-15,111,Capital Call,-582124,-5176275,227730,-4948545
74395,2020-09-30,111,Value,6541660,-5176275,227730,-4948545
74395,2020-11-15,111,Capital Call,-37500,-5213775,227730,-4986045
74395,2020-11-15,111,Distribution,378954,-5213775,606684,-4607091
74395,2020-12-31,111,Value,7181380,-5213775,606684,-4607091
74395,2021-02-14,111,Capital Call,-37500,-5251275,606684,-4644591
74395,2021-03-31,111,Value,8264840,-5251275,606684,-4644591
74395,2021-05-16,111,Capital Call,-37500,-5288775,606684,-4682091
74395,2021-06-30,111,Value,12645440,-5288775,606684,-4682091
74420,2020-03-31,140,Value,1546620,-1632744,0,-1632744
74420,2020-06-30,140,Value,1425410,-1632744,0,-1632744
74420,2020-08-15,140,Capital Call,-115132,-1747876,0,-1747876
74420,2020-08-15,140,Distribution,7845,-1747876,7845,-1740031
74420,2020-09-30,140,Value,1736470,-1747876,7845,-1740031
74420,2020-12-31,140,Value,2652280,-1747876,7845,-1740031
74420,2021-02-14,140,Capital Call,-1189624,-2937500,7845,-2929655
74420,2021-03-31,140,Value,4160850,-2937500,7845,-2929655
74420,2021-05-16,140,Distribution,713471,-2937500,721316,-2216184
74420,2021-06-30,140,Value,3951900,-2937500,721316,-2216184
74420,2021-08-15,140,Capital Call,-300181,-3237681,721316,-2516365
74420,2021-08-15,140,Distribution,272075,-3237681,993391,-2244290
74420,2021-09-30,140,Value,4966690,-3237681,993391,-2244290
74438,2020-03-31,672,Value,8914050,-8370000,2326860,-6043140
74438,2020-05-16,672,Capital Call,-50000,-8420000,2326860,-6093140
74438,2020-05-16,672,Distribution,140200,-8420000,2467060,-5952940
74438,2020-06-30,672,Value,9683000,-8420000,2467060,-5952940
74438,2020-08-15,672,Distribution,496780,-8420000,2963840,-5456160
74438,2020-09-30,672,Value,9565120,-8420000,2963840,-5456160
74438,2020-11-15,672,Capital Call,-90000,-8510000,2963840,-5546160
74438,2020-11-15,672,Distribution,-2360,-8510000,2961480,-5548520
74438,2020-12-31,672,Value,12186320,-8510000,2961480,-5548520
74438,2021-02-14,672,Capital Call,-200000,-8710000,2961480,-5748520
74438,2021-02-14,672,Distribution,722850,-8710000,3684330,-5025670
74438,2021-03-31,672,Value,11915280,-8710000,3684330,-5025670
74438,2021-05-16,672,Distribution,435500,-8710000,4119830,-4590170
74438,2021-06-30,672,Value,14850550,-8710000,4119830,-4590170
74438,2021-08-15,672,Distribution,313560,-8710000,4433390,-4276610
74438,2021-09-30,672,Value,14249560,-8710000,4433390,-4276610
74446,2020-03-31,140,Value,2099400,-2565607,21170,-2544437
74446,2020-05-16,140,Capital Call,-1444304,-4009911,21170,-3988741
74446,2020-06-30,140,Value,3085610,-4009911,21170,-3988741
74446,2020-08-15,140,Distribution,24459,-4009911,45629,-3964282
74446,2020-09-30,140,Value,3601770,-4009911,45629,-3964282
74446,2020-11-15,140,Capital Call,-880288,-4890199,45629,-4844570
74446,2020-11-15,140,Distribution,125611,-4890199,171240,-4718959
74446,2020-12-31,140,Value,4297300,-4890199,171240,-4718959
74446,2021-02-14,140,Capital Call,-243305,-5133504,171240,-4962264
74446,2021-03-31,140,Value,4969780,-5133504,171240,-4962264
74453,2020-02-15,161,Capital Call,-26951,-3333502,2927,-3330575
74453,2020-02-15,161,Distribution,157637,-3333502,160564,-3172938
74453,2020-03-31,161,Value,2249980,-3333502,160564,-3172938
74453,2020-05-16,161,Capital Call,-936225,-4269727,160564,-4109163
74453,2020-06-30,161,Value,4507310,-4269727,160564,-4109163
74453,2020-08-15,161,Capital Call,-411844,-4681571,160564,-4521007
74453,2020-08-15,161,Distribution,732,-4681571,161296,-4520275
74453,2020-09-30,161,Value,5294990,-4681571,161296,-4520275
74453,2020-11-15,161,Capital Call,-1858665,-6540236,161296,-6378940
74453,2020-11-15,161,Distribution,1886717,-6540236,2048013,-4492223
74453,2020-12-31,161,Value,5435460,-6540236,2048013,-4492223
74453,2021-02-14,161,Capital Call,-666698,-7206934,2048013,-5158921
74453,2021-02-14,161,Distribution,159489,-7206934,2207502,-4999432
74453,2021-03-31,161,Value,6180340,-7206934,2207502,-4999432
74457,2020-02-15,140,Capital Call,-93333,-1596666,20000,-1576666
74457,2020-02-15,140,Distribution,-6667,-1596666,13333,-1583333
74457,2020-03-31,140,Value,1263330,-1596666,13333,-1583333
74457,2020-06-30,140,Value,1230000,-1596666,13333,-1583333
74457,2020-08-15,140,Capital Call,-830000,-2426666,13333,-2413333
74457,2020-09-30,140,Value,1920000,-2426666,13333,-2413333
74457,2020-12-31,140,Value,1920000,-2426666,13333,-2413333
74457,2021-02-14,140,Capital Call,-636667,-3063333,13333,-3050000
74457,2021-03-31,140,Value,2913330,-3063333,13333,-3050000
74457,2021-06-30,140,Value,3163330,-3063333,13333,-3050000
74457,2021-08-15,140,Distribution,1000,-3063333,14333,-3049000
74457,2021-09-30,140,Value,3945330,-3063333,14333,-3049000
74596,2020-02-15,47870,Capital Call,-450000,-2140000,0,-2140000
74596,2020-03-31,47870,Value,2410710,-2140000,0,-2140000
74596,2020-09-30,47870,Value,2788420,-2140000,0,-2140000
74596,2020-11-15,47870,Capital Call,-190000,-2330000,0,-2330000
74596,2020-12-31,47870,Value,3553250,-2330000,0,-2330000
74596,2021-02-14,47870,Capital Call,-80000,-2410000,0,-2410000
74596,2021-03-31,47870,Value,4174120,-2410000,0,-2410000
74596,2021-05-16,47870,Capital Call,-290000,-2700000,0,-2700000
74596,2021-06-30,47870,Value,5184000,-2700000,0,-2700000
74596,2021-08-15,47870,Capital Call,-390000,-3090000,0,-3090000
74596,2021-09-30,47870,Value,6439560,-3090000,0,-3090000
74596,2021-11-15,47870,Capital Call,-740000,-3830000,0,-3830000
74596,2021-12-31,47870,Value,7556590,-3830000,0,-3830000
74645,2020-03-31,10266,Value,4926770,-5378521,269051,-5109470
74645,2020-05-16,10266,Capital Call,-134148,-5512669,269051,-5243618
74645,2020-05-16,10266,Distribution,29067,-5512669,298118,-5214551
74645,2020-06-30,10266,Value,4985050,-5512669,298118,-5214551
74645,2020-08-15,10266,Capital Call,-113305,-5625974,298118,-5327856
74645,2020-08-15,10266,Distribution,32602,-5625974,330720,-5295254
74645,2020-09-30,10266,Value,5075150,-5625974,330720,-5295254
74645,2020-12-31,10266,Value,6513670,-5625974,330720,-5295254
74645,2021-02-14,10266,Capital Call,-2338868,-7964842,330720,-7634122
74645,2021-02-14,10266,Distribution,56744,-7964842,387464,-7577378
74645,2021-03-31,10266,Value,10097860,-7964842,387464,-7577378
74645,2021-05-16,10266,Distribution,415239,-7964842,802703,-7162139
74645,2021-06-30,10266,Value,11326690,-7964842,802703,-7162139
74712,2020-02-15,18,Capital Call,-850000,-7640000,0,-7640000
74712,2020-03-31,18,Value,8781180,-7640000,0,-7640000
74712,2020-05-16,18,Capital Call,-500000,-8140000,0,-8140000
74712,2020-06-30,18,Value,11506550,-8140000,0,-8140000
74712,2020-09-30,18,Value,11583830,-8140000,0,-8140000
74712,2020-12-31,18,Value,13584290,-8140000,0,-8140000
74712,2021-02-14,18,Capital Call,-300000,-8440000,0,-8440000
74712,2021-03-31,18,Value,16974790,-8440000,0,-8440000
74712,2021-07-01,18,Capital Call,58,-8439942,0,-8439942
74712,2021-07-01,18,Distribution,335910,-8439942,335910,-8104032
74712,2021-09-30,18,Value,22926250,-8439942,335910,-8104032
74715,2020-02-15,8985,Capital Call,-526834,-3636067,297667,-3338400
74715,2020-02-15,8985,Distribution,80583,-3636067,378250,-3257817
74715,2020-03-31,8985,Value,3226660,-3636067,378250,-3257817
74715,2020-05-16,8985,Capital Call,-50000,-3686067,378250,-3307817
74715,2020-06-30,8985,Value,3292520,-3686067,378250,-3307817
74715,2020-08-15,8985,Capital Call,-1374429,-5060496,378250,-4682246
74715,2020-08-15,8985,Distribution,32709,-5060496,410959,-4649537
74715,2020-09-30,8985,Value,4963170,-5060496,410959,-4649537
74750,2020-03-31,105572,Value,3416170,-5900279,2698733,-3201546
74767,2020-02-15,20804,Capital Call,-85000,-5940000,0,-5940000
74767,2020-03-31,20804,Value,6214420,-5940000,0,-5940000
74767,2020-06-30,20804,Value,6865450,-5940000,0,-5940000
74767,2020-08-15,20804,Capital Call,-84000,-6024000,0,-6024000
74767,2020-09-30,20804,Value,7392050,-6024000,0,-6024000
74767,2020-12-31,20804,Value,7617340,-6024000,0,-6024000
74767,2021-02-14,20804,Capital Call,-2663000,-8687000,0,-8687000
74767,2021-02-14,20804,Distribution,3122977,-8687000,3122977,-5564023
74767,2021-03-31,20804,Value,8577540,-8687000,3122977,-5564023
74797,2020-02-15,832,Capital Call,-146161,-8169348,4319683,-3849665
74797,2020-02-15,832,Distribution,-3000,-8169348,4316683,-3852665
74797,2020-03-31,832,Value,5935840,-8169348,4316683,-3852665
74797,2020-05-16,832,Capital Call,-169651,-8338999,4316683,-4022316
74797,2020-05-16,832,Distribution,1006100,-8338999,5322783,-3016216
74797,2020-06-30,832,Value,5424510,-8338999,5322783,-3016216
74797,2020-08-15,832,Capital Call,207998,-8131001,5322783,-2808218
74797,2020-08-15,832,Distribution,-4296,-8131001,5318487,-2812514
74797,2020-09-30,832,Value,6050270,-8131001,5318487,-2812514
74797,2020-11-15,832,Distribution,91880,-8131001,5410367,-2720634
74797,2020-12-31,832,Value,6772300,-8131001,5410367,-2720634
74797,2021-02-14,832,Capital Call,-241000,-8372001,5410367,-2961634
74797,2021-02-14,832,Distribution,-381,-8372001,5409986,-2962015
74797,2021-03-31,832,Value,7976000,-8372001,5409986,-2962015
74797,2021-05-16,832,Distribution,66139,-8372001,5476125,-2895876
74797,2021-06-30,832,Value,7071820,-8372001,5476125,-2895876
74797,2021-08-15,832,Capital Call,-39000,-8411001,5476125,-2934876
74797,2021-08-15,832,Distribution,277,-8411001,5476402,-2934599
74797,2021-09-30,832,Value,7741480,-8411001,5476402,-2934599
74797,2021-11-15,832,Capital Call,-151000,-8562001,5476402,-3085599
74797,2021-11-15,832,Distribution,1637764,-8562001,7114166,-1447835
74797,2021-12-31,832,Value,7171530,-8562001,7114166,-1447835
74815,2020-02-15,141,Capital Call,-310000,-3550000,233175,-3316825
74815,2020-02-15,141,Distribution,-2425,-3550000,230750,-3319250
74815,2020-03-31,141,Value,3052290,-3550000,230750,-3319250
74815,2020-05-16,141,Capital Call,-580000,-4130000,230750,-3899250
74815,2020-05-16,141,Distribution,530,-4130000,231280,-3898720
74815,2020-06-30,141,Value,3686430,-4130000,231280,-3898720
74815,2020-09-30,141,Capital Call,-490000,-4620000,231280,-4388720
74815,2020-09-30,141,Distribution,-384,-4620000,230896,-4389104
74815,2020-12-31,141,Value,6070680,-4620000,230896,-4389104
74815,2021-02-14,141,Capital Call,-990000,-5610000,230896,-5379104
74815,2021-02-14,141,Distribution,2480,-5610000,233376,-5376624
74815,2021-03-31,141,Value,8000420,-5610000,233376,-5376624
74815,2021-05-16,141,Capital Call,-1004000,-6614000,233376,-6380624
74815,2021-05-16,141,Distribution,98,-6614000,233474,-6380526
74815,2021-06-30,141,Value,12259710,-6614000,233474,-6380526
74863,2020-02-15,6733,Capital Call,-268996,-5936629,1130974,-4805655
74863,2020-02-15,6733,Distribution,1578116,-5936629,2709090,-3227539
74863,2020-03-31,6733,Value,3620820,-5936629,2709090,-3227539
74863,2020-05-16,6733,Capital Call,-564697,-6501326,2709090,-3792236
74863,2020-05-16,6733,Distribution,58898,-6501326,2767988,-3733338
74863,2020-06-30,6733,Value,4502080,-6501326,2767988,-3733338
74863,2020-08-15,6733,Capital Call,-2688948,-9190274,2767988,-6422286
74863,2020-08-15,6733,Distribution,353563,-9190274,3121551,-6068723
74863,2020-09-30,6733,Value,6854760,-9190274,3121551,-6068723
74863,2020-11-15,6733,Capital Call,-50597,-9240871,3121551,-6119320
74863,2020-11-15,6733,Distribution,1736462,-9240871,4858013,-4382858
74863,2020-12-31,6733,Value,5417800,-9240871,4858013,-4382858
74863,2021-02-14,6733,Capital Call,-974853,-10215724,4858013,-5357711
74863,2021-02-14,6733,Distribution,509135,-10215724,5367148,-4848576
74863,2021-03-31,6733,Value,5846020,-10215724,5367148,-4848576
74863,2021-05-16,6733,Capital Call,-415905,-10631629,5367148,-5264481
74863,2021-05-16,6733,Distribution,507239,-10631629,5874387,-4757242
74863,2021-06-30,6733,Value,6039600,-10631629,5874387,-4757242
74863,2021-08-15,6733,Capital Call,-203132,-10834761,5874387,-4960374
74863,2021-08-15,6733,Distribution,322706,-10834761,6197093,-4637668
74863,2021-09-30,6733,Value,6097750,-10834761,6197093,-4637668
74955,2020-02-15,123760,Capital Call,-860000,-3890000,0,-3890000
74955,2020-02-15,123760,Distribution,136150,-3890000,136150,-3753850
74955,2020-03-31,123760,Value,3944460,-3890000,136150,-3753850
74955,2020-12-30,123760,Capital Call,-3600000,-7490000,136150,-7353850
74955,2020-12-30,123760,Distribution,208390,-7490000,344540,-7145460
74955,2021-09-30,123760,Value,14006300,-7490000,344540,-7145460
74976,2020-03-31,161,Value,5359590,-5213896,0,-5213896
74976,2020-05-16,161,Capital Call,-1111702,-6325598,0,-6325598
74976,2020-06-30,161,Value,8166030,-6325598,0,-6325598
74976,2020-09-30,161,Value,9557530,-6325598,0,-6325598
74976,2020-11-15,161,Capital Call,-1935553,-8261151,0,-8261151
74976,2020-11-15,161,Distribution,3918464,-8261151,3918464,-4342687
74976,2020-12-31,161,Value,7922160,-8261151,3918464,-4342687
74976,2021-02-14,161,Capital Call,-555889,-8817040,3918464,-4898576
74976,2021-02-14,161,Distribution,918126,-8817040,4836590,-3980450
74976,2021-03-31,161,Value,7849390,-8817040,4836590,-3980450
75035,2020-02-15,9110,Capital Call,-828511,-4367512,62287,-4305225
75035,2020-02-15,9110,Distribution,57744,-4367512,120031,-4247481
75035,2020-03-31,9110,Value,4294350,-4367512,120031,-4247481
75035,2020-05-16,9110,Capital Call,-852489,-5220001,120031,-5099970
75035,2020-05-16,9110,Distribution,24564,-5220001,144595,-5075406
75035,2020-06-30,9110,Value,5519100,-5220001,144595,-5075406
75035,2020-08-15,9110,Capital Call,-485000,-5705001,144595,-5560406
75035,2020-08-15,9110,Distribution,79042,-5705001,223637,-5481364
75035,2020-09-30,9110,Value,6176800,-5705001,223637,-5481364
75035,2020-11-15,9110,Capital Call,-826000,-6531001,223637,-6307364
75035,2020-11-15,9110,Distribution,98342,-6531001,321979,-6209022
75035,2020-12-31,9110,Value,7888790,-6531001,321979,-6209022
75035,2021-02-14,9110,Capital Call,-1156000,-7687001,321979,-7365022
75035,2021-02-14,9110,Distribution,140779,-7687001,462758,-7224243
75035,2021-03-31,9110,Value,10036910,-7687001,462758,-7224243
75035,2021-05-16,9110,Capital Call,-113000,-7800001,462758,-7337243
75035,2021-05-16,9110,Distribution,-217,-7800001,462541,-7337460
75035,2021-06-30,9110,Value,10333440,-7800001,462541,-7337460
75035,2021-08-15,9110,Capital Call,-609000,-8409001,462541,-7946460
75035,2021-08-15,9110,Distribution,586062,-8409001,1048603,-7360398
75035,2021-09-30,9110,Value,10267380,-8409001,1048603,-7360398
75042,2020-02-15,54107,Capital Call,-1329440,-3765433,614232,-3151201
75042,2020-02-15,54107,Distribution,0,-3765433,614232,-3151201
75042,2020-03-31,54107,Value,2967490,-3765433,614232,-3151201
75042,2020-05-16,54107,Capital Call,-50395,-3815828,614232,-3201596
75042,2020-05-16,54107,Distribution,10567,-3815828,624799,-3191029
75042,2020-06-30,54107,Value,3295220,-3815828,624799,-3191029
75042,2020-08-15,54107,Capital Call,-2988892,-6804720,624799,-6179921
75042,2020-09-30,54107,Value,6676370,-6804720,624799,-6179921
75042,2020-11-15,54107,Capital Call,0,-6804720,624799,-6179921
75042,2020-11-15,54107,Distribution,0,-6804720,624799,-6179921
75042,2020-12-31,54107,Value,7872740,-6804720,624799,-6179921
75101,2020-02-15,395,Capital Call,-1100000,-6000000,0,-6000000
75101,2020-02-15,395,Distribution,268333,-6000000,268333,-5731667
75101,2020-03-31,395,Value,7761330,-6000000,268333,-5731667
75101,2020-05-16,395,Capital Call,-1000000,-7000000,268333,-6731667
75101,2020-05-16,395,Distribution,738333,-7000000,1006666,-5993334
75101,2020-06-30,395,Value,9462330,-7000000,1006666,-5993334
75101,2020-08-15,395,Capital Call,-600000,-7600000,1006666,-6593334
75101,2020-08-15,395,Distribution,470000,-7600000,1476666,-6123334
75101,2020-09-30,395,Value,11321000,-7600000,1476666,-6123334
75101,2020-11-15,395,Capital Call,-200000,-7800000,1476666,-6323334
75101,2020-11-15,395,Distribution,199333,-7800000,1675999,-6124001
75101,2020-12-31,395,Value,14665000,-7800000,1675999,-6124001
75101,2021-02-14,395,Capital Call,-1000000,-8800000,1675999,-7124001
75101,2021-03-31,395,Value,18507000,-8800000,1675999,-7124001
75101,2021-05-16,395,Capital Call,-700000,-9500000,1675999,-7824001
75101,2021-06-30,395,Value,21585660,-9500000,1675999,-7824001
75112,2020-03-31,14411,Value,10599240,-8244883,4242959,-4001924
75112,2020-05-16,14411,Capital Call,-199698,-8444581,4242959,-4201622
75112,2020-05-16,14411,Distribution,643809,-8444581,4886768,-3557813
75112,2020-06-30,14411,Value,11122930,-8444581,4886768,-3557813
75112,2020-09-30,14411,Capital Call,-1456081,-9900662,4886768,-5013894
75112,2020-09-30,14411,Distribution,2193897,-9900662,7080665,-2819997
75112,2020-12-31,14411,Value,14110230,-9900662,7080665,-2819997
75112,2021-02-14,14411,Capital Call,-360,-9901022,7080665,-2820357
75112,2021-02-14,14411,Distribution,385856,-9901022,7466521,-2434501
75112,2021-03-31,14411,Value,14516950,-9901022,7466521,-2434501
75112,2021-05-16,14411,Capital Call,-8248,-9909270,7466521,-2442749
75112,2021-05-16,14411,Distribution,1480297,-9909270,8946818,-962452
75112,2021-06-30,14411,Value,13489020,-9909270,8946818,-962452
75113,2020-01-15,515145,Capital Call,-1502146,-4506438,0,-4506438
75113,2020-02-24,515145,Capital Call,-1394850,-5901288,0,-5901288
75113,2020-03-31,515145,Value,7069360,-5901288,0,-5901288
75115,2020-02-15,739,Capital Call,-1657160,-6743766,0,-6743766
75115,2020-03-31,739,Value,6859060,-6743766,0,-6743766
75115,2020-06-30,739,Value,6284770,-6743766,0,-6743766
75115,2020-09-30,739,Value,6972410,-6743766,0,-6743766
75115,2020-11-15,739,Capital Call,-1720615,-8464381,0,-8464381
75115,2020-11-15,739,Distribution,139781,-8464381,139781,-8324600
75115,2020-12-31,739,Value,9205250,-8464381,139781,-8324600
75115,2021-02-14,739,Capital Call,-1138889,-9603270,139781,-9463489
75115,2021-03-31,739,Value,11039270,-9603270,139781,-9463489
75142,2020-02-14,9522,Capital Call,-1549893,-6946039,1079,-6944960
75142,2020-02-14,9522,Distribution,-385,-6946039,694,-6945345
75142,2020-09-30,9522,Value,8645730,-6946039,694,-6945345
75142,2020-11-15,9522,Capital Call,-473662,-7419701,694,-7419007
75142,2020-11-15,9522,Distribution,1222814,-7419701,1223508,-6196193
75142,2020-12-31,9522,Value,9178160,-7419701,1223508,-6196193
75142,2021-02-14,9522,Capital Call,-533453,-7953154,1223508,-6729646
75142,2021-02-14,9522,Distribution,615,-7953154,1224123,-6729031
75142,2021-03-31,9522,Value,10636380,-7953154,1224123,-6729031
75142,2021-05-16,9522,Capital Call,-45847,-7999001,1224123,-6774878
75142,2021-05-16,9522,Distribution,-277,-7999001,1223846,-6775155
75142,2021-06-30,9522,Value,14634970,-7999001,1223846,-6775155
75142,2021-08-15,9522,Capital Call,-125,-7999126,1223846,-6775280
75142,2021-08-15,9522,Distribution,277,-7999126,1224123,-6775003
75142,2021-09-30,9522,Value,16315630,-7999126,1224123,-6775003
75149,2020-03-31,167467,Value,9972600,-8712200,0,-8712200
75149,2020-06-30,167467,Value,9857400,-8712200,0,-8712200
75149,2020-09-30,167467,Value,8738800,-8712200,0,-8712200
75149,2020-11-15,167467,Capital Call,-372800,-9085000,0,-9085000
75149,2020-12-31,167467,Value,10566200,-9085000,0,-9085000
75149,2021-02-14,167467,Capital Call,-262600,-9347600,0,-9347600
75149,2021-03-31,167467,Value,13009800,-9347600,0,-9347600
75149,2021-06-30,167467,Value,13955000,-9347600,0,-9347600
75201,2020-03-31,1357,Value,9995930,-8600000,2198137,-6401863
75201,2020-06-30,1357,Value,9857290,-8600000,2198137,-6401863
75201,2020-08-15,1357,Capital Call,-200000,-8800000,2198137,-6601863
75201,2020-09-30,1357,Value,10639840,-8800000,2198137,-6601863
75201,2020-11-15,1357,Capital Call,-300000,-9100000,2198137,-6901863
75201,2020-12-31,1357,Value,10798870,-9100000,2198137,-6901863
75201,2021-02-14,1357,Capital Call,-200000,-9300000,2198137,-7101863
75201,2021-03-31,1357,Value,13088300,-9300000,2198137,-7101863
75201,2021-06-30,1357,Value,14277100,-9300000,2198137,-7101863
75201,2021-09-30,1357,Value,16937240,-9300000,2198137,-7101863
75218,2020-01-16,1357,Capital Call,-1500000,-8400000,150000,-8250000
75218,2020-03-31,1357,Value,9469350,-8400000,150000,-8250000
75218,2020-04-15,1357,Capital Call,-600000,-9000000,150000,-8850000
75218,2020-04-15,1357,Distribution,350000,-9000000,500000,-8500000
75218,2020-06-15,1357,Distribution,437500,-9000000,937500,-8062500
75218,2020-06-30,1357,Value,10892830,-9000000,937500,-8062500
75218,2020-08-15,1357,Distribution,1300000,-9000000,2237500,-6762500
75218,2020-09-30,1357,Value,10686980,-9000000,2237500,-6762500
75218,2020-11-15,1357,Capital Call,-500000,-9500000,2237500,-7262500
75218,2020-11-15,1357,Distribution,-237500,-9500000,2000000,-7500000
75218,2020-12-31,1357,Value,10886980,-9500000,2000000,-7500000
75218,2021-01-16,1357,Capital Call,-300000,-9800000,2000000,-7800000
75218,2021-02-14,1357,Distribution,350000,-9800000,2350000,-7450000
75218,2021-03-16,1357,Distribution,225000,-9800000,2575000,-7225000
75218,2021-03-31,1357,Value,13750490,-9800000,2575000,-7225000
75218,2021-04-15,1357,Distribution,300000,-9800000,2875000,-6925000
75218,2021-06-15,1357,Distribution,850000,-9800000,3725000,-6075000
75218,2021-06-30,1357,Value,25485700,-9800000,3725000,-6075000
75218,2021-08-15,1357,Distribution,2341059,-9800000,6066059,-3733941
75218,2021-09-30,1357,Value,25485700,-9800000,6066059,-3733941
75337,2020-02-15,5777,Capital Call,-832000,-4448000,0,-4448000
75337,2020-02-15,5777,Distribution,96000,-4448000,96000,-4352000
75337,2020-03-31,5777,Value,3888000,-4448000,96000,-4352000
75337,2020-06-30,5777,Value,4336000,-4448000,96000,-4352000
75337,2020-08-15,5777,Capital Call,296000,-4152000,96000,-4056000
75337,2020-08-15,5777,Distribution,8000,-4152000,104000,-4048000
75337,2020-09-30,5777,Value,5328000,-4152000,104000,-4048000
75337,2020-11-15,5777,Capital Call,-1344000,-5496000,104000,-5392000
75337,2020-11-15,5777,Distribution,32000,-5496000,136000,-5360000
75337,2020-12-31,5777,Value,7088000,-5496000,136000,-5360000
75337,2021-02-14,5777,Capital Call,-656000,-6152000,136000,-6016000
75337,2021-03-31,5777,Value,8688000,-6152000,136000,-6016000
75337,2021-05-16,5777,Capital Call,-256000,-6408000,136000,-6272000
75337,2021-06-30,5777,Value,9736000,-6408000,136000,-6272000
75337,2021-08-15,5777,Capital Call,-142400,-6550400,136000,-6414400
75337,2021-08-15,5777,Distribution,47200,-6550400,183200,-6367200
75337,2021-09-30,5777,Value,11166400,-6550400,183200,-6367200
75406,2020-03-31,528,Distribution,23500,-3732185,616136,-3116049
75406,2020-06-30,528,Value,8242100,-3732185,616136,-3116049
75406,2020-08-15,528,Distribution,54192,-3732185,670328,-3061857
75406,2020-09-30,528,Value,8511200,-3732185,670328,-3061857
75406,2020-12-30,528,Distribution,1288585,-3732185,1958913,-1773272
75406,2021-03-31,528,Value,11203070,-3732185,1958913,-1773272
75406,2021-05-16,528,Distribution,569505,-3732185,2528418,-1203767
75406,2021-06-30,528,Value,11882250,-3732185,2528418,-1203767
75449,2020-12-31,1220,Value,6606020,-5570000,0,-5570000
75449,2021-04-01,1220,Capital Call,-2000000,-7570000,0,-7570000
75449,2021-06-30,1220,Value,9744100,-7570000,0,-7570000
75449,2021-08-15,1220,Capital Call,-172000,-7742000,0,-7742000
75449,2021-09-30,1220,Value,10803180,-7742000,0,-7742000
75456,2020-02-15,124,Capital Call,-467576,-1972109,0,-1972109
75456,2020-03-31,124,Value,2064280,-1972109,0,-1972109
75456,2020-05-16,124,Capital Call,-1408746,-3380855,0,-3380855
75456,2020-06-30,124,Value,3201070,-3380855,0,-3380855
75456,2020-08-15,124,Capital Call,-807357,-4188212,0,-4188212
75456,2020-08-15,124,Distribution,292570,-4188212,292570,-3895642
75456,2020-09-30,124,Value,4258600,-4188212,292570,-3895642
75456,2020-11-15,124,Capital Call,0,-4188212,292570,-3895642
75456,2020-11-15,124,Distribution,513827,-4188212,806397,-3381815
75456,2020-12-31,124,Value,4286180,-4188212,806397,-3381815
75456,2021-02-14,124,Capital Call,0,-4188212,806397,-3381815
75456,2021-02-14,124,Distribution,0,-4188212,806397,-3381815
75456,2021-03-31,124,Value,3903060,-4188212,806397,-3381815
75456,2021-05-16,124,Capital Call,-1009787,-5197999,806397,-4391602
75456,2021-05-16,124,Distribution,-43850,-5197999,762547,-4435452
75456,2021-06-30,124,Value,5225020,-5197999,762547,-4435452
75456,2021-08-15,124,Capital Call,-381000,-5578999,762547,-4816452
75456,2021-08-15,124,Distribution,7913,-5578999,770460,-4808539
75456,2021-09-30,124,Value,5809410,-5578999,770460,-4808539
75488,2020-06-30,401,Value,4221650,-4000000,0,-4000000
75575,2020-03-31,451,Value,4274630,-4300000,200000,-4100000
75575,2020-05-16,451,Capital Call,-750000,-5050000,200000,-4850000
75575,2020-06-30,451,Value,5067970,-5050000,200000,-4850000
75575,2020-09-30,451,Value,5295580,-5050000,200000,-4850000
75575,2020-11-15,451,Capital Call,-350000,-5400000,200000,-5200000
75575,2020-12-31,451,Value,6896150,-5400000,200000,-5200000
75575,2021-02-14,451,Capital Call,-400000,-5800000,200000,-5600000
75575,2021-03-31,451,Value,7476100,-5800000,200000,-5600000
75575,2021-05-16,451,Capital Call,-900000,-6700000,200000,-6500000
75575,2021-06-30,451,Value,10716310,-6700000,200000,-6500000
75575,2021-09-30,451,Value,12540830,-6700000,200000,-6500000
75587,2020-03-31,9740,Value,2676970,-3095582,0,-3095582
75587,2020-05-16,9740,Capital Call,-667674,-3763256,0,-3763256
75587,2020-06-30,9740,Value,3293950,-3763256,0,-3763256
75595,2020-02-15,122276,Capital Call,-22608,-5859393,130496,-5728897
75595,2020-03-31,122276,Value,7334280,-5859393,130496,-5728897
75595,2020-05-16,122276,Capital Call,-16667,-5876060,130496,-5745564
75595,2020-05-16,122276,Distribution,1814207,-5876060,1944703,-3931357
75595,2020-06-30,122276,Value,7720200,-5876060,1944703,-3931357
75595,2020-08-15,122276,Capital Call,-15072,-5891132,1944703,-3946429
75595,2020-08-15,122276,Distribution,344731,-5891132,2289434,-3601698
75595,2020-09-30,122276,Value,7607720,-5891132,2289434,-3601698
75636,2020-02-15,32423,Capital Call,-1000000,-4800000,0,-4800000
75636,2020-03-31,32423,Value,4800000,-4800000,0,-4800000
75636,2020-06-30,32423,Value,4800000,-4800000,0,-4800000
75636,2020-08-15,32423,Capital Call,-1200000,-6000000,0,-6000000
75636,2020-09-30,32423,Value,6000000,-6000000,0,-6000000
75636,2020-11-15,32423,Capital Call,-1200000,-7200000,0,-7200000
75636,2020-11-15,32423,Distribution,573120,-7200000,573120,-6626880
75636,2020-12-31,32423,Value,7785360,-7200000,573120,-6626880
75636,2021-03-31,32423,Value,8151840,-7200000,573120,-6626880
75636,2021-06-30,32423,Value,8591040,-7200000,573120,-6626880
75636,2021-08-15,32423,Capital Call,-1350000,-8550000,573120,-7976880
75636,2021-08-15,32423,Distribution,1802925,-8550000,2376045,-6173955
75636,2021-09-30,32423,Value,11286850,-8550000,2376045,-6173955
75646,2020-02-15,1314,Capital Call,0,-4400000,0,-4400000
75646,2020-03-31,1314,Value,5148280,-4400000,0,-4400000
75646,2020-05-16,1314,Capital Call,-616667,-5016667,0,-5016667
75646,2020-06-30,1314,Value,6089820,-5016667,0,-5016667
75646,2020-08-15,1314,Capital Call,-583333,-5600000,0,-5600000
75646,2020-09-30,1314,Value,7117040,-5600000,0,-5600000
75646,2020-11-15,1314,Capital Call,-395238,-5995238,0,-5995238
75646,2020-12-31,1314,Value,9042860,-5995238,0,-5995238
75646,2021-02-14,1314,Capital Call,-679762,-6675000,0,-6675000
75646,2021-02-14,1314,Distribution,445094,-6675000,445094,-6229906
75646,2021-03-31,1314,Value,9931590,-6675000,445094,-6229906
75646,2021-05-16,1314,Capital Call,-488095,-7163095,445094,-6718001
75646,2021-06-30,1314,Value,11419540,-7163095,445094,-6718001
75646,2021-08-15,1314,Capital Call,-297619,-7460714,445094,-7015620
75646,2021-08-15,1314,Distribution,-113022,-7460714,332072,-7128642
75646,2021-09-30,1314,Value,12563890,-7460714,332072,-7128642
75648,2020-02-15,1314,Capital Call,-534000,-2225000,0,-2225000
75648,2020-03-31,1314,Value,1519000,-2225000,0,-2225000
75648,2020-05-16,1314,Capital Call,-500000,-2725000,0,-2725000
75648,2020-06-30,1314,Value,2120050,-2725000,0,-2725000
75648,2020-08-15,1314,Capital Call,-400000,-3125000,0,-3125000
75648,2020-09-30,1314,Value,2522810,-3125000,0,-3125000
75648,2020-11-15,1314,Capital Call,-199000,-3324000,0,-3324000
75648,2020-12-31,1314,Value,2760910,-3324000,0,-3324000
75648,2021-02-14,1314,Capital Call,-225000,-3549000,0,-3549000
75648,2021-03-31,1314,Value,10929500,-3549000,0,-3549000
75648,2021-05-16,1314,Capital Call,-294000,-3843000,0,-3843000
75648,2021-06-30,1314,Value,11238850,-3843000,0,-3843000
75648,2021-08-15,1314,Capital Call,-603000,-4446000,0,-4446000
75648,2021-09-30,1314,Value,5010190,-4446000,0,-4446000
75652,2020-02-15,1314,Capital Call,-65000,-2865000,154840,-2710160
75652,2020-02-15,1314,Distribution,64906,-2865000,219746,-2645254
75652,2020-03-31,1314,Value,3251480,-2865000,219746,-2645254
75652,2020-05-16,1314,Capital Call,-250000,-3115000,219746,-2895254
75652,2020-05-16,1314,Distribution,173,-3115000,219919,-2895081
75652,2020-06-30,1314,Value,3708400,-3115000,219919,-2895081
75652,2020-08-15,1314,Capital Call,-325000,-3440000,219919,-3220081
75652,2020-08-15,1314,Distribution,-103,-3440000,219816,-3220184
75652,2020-09-30,1314,Value,4385310,-3440000,219816,-3220184
75652,2020-11-15,1314,Capital Call,-600000,-4040000,219816,-3820184
75652,2020-11-15,1314,Distribution,-40,-4040000,219776,-3820224
75652,2020-12-31,1314,Value,5890720,-4040000,219776,-3820224
75652,2021-02-14,1314,Capital Call,-200000,-4240000,219776,-4020224
75652,2021-02-14,1314,Distribution,267400,-4240000,487176,-3752824
75652,2021-03-31,1314,Value,6345160,-4240000,487176,-3752824
75652,2021-05-16,1314,Capital Call,-490000,-4730000,487176,-4242824
75652,2021-05-16,1314,Distribution,490042,-4730000,977218,-3752782
75652,2021-06-30,1314,Value,7349940,-4730000,977218,-3752782
75656,2020-02-15,1314,Capital Call,-16000,-2765000,0,-2765000
75656,2020-03-31,1314,Value,3180850,-2765000,0,-2765000
75656,2020-05-16,1314,Capital Call,-497000,-3262000,0,-3262000
75656,2020-06-30,1314,Value,3891560,-3262000,0,-3262000
75656,2020-09-30,1314,Capital Call,-909000,-4171000,0,-4171000
75656,2020-12-31,1314,Value,6180580,-4171000,0,-4171000
75656,2021-02-14,1314,Capital Call,-211000,-4382000,0,-4382000
75656,2021-02-14,1314,Distribution,134966,-4382000,134966,-4247034
75656,2021-03-31,1314,Value,6718920,-4382000,134966,-4247034
75656,2021-05-16,1314,Capital Call,-542000,-4924000,134966,-4789034
75656,2021-05-16,1314,Distribution,-48,-4924000,134918,-4789082
75656,2021-06-30,1314,Value,8228000,-4924000,134918,-4789082
75677,2020-02-15,270,Capital Call,-3530976,-6570000,120000,-6450000
75677,2020-02-15,270,Distribution,44250,-6570000,164250,-6405750
75677,2020-03-31,270,Value,5269140,-6570000,164250,-6405750
75677,2020-05-16,270,Capital Call,-1965354,-8535354,164250,-8371104
75677,2020-05-16,270,Distribution,157720,-8535354,321970,-8213384
75677,2020-06-30,270,Value,6887620,-8535354,321970,-8213384
75677,2020-08-15,270,Capital Call,-1516646,-10052000,321970,-9730030
75677,2020-08-15,270,Distribution,138412,-10052000,460382,-9591618
75677,2020-09-30,270,Value,8812580,-10052000,460382,-9591618
75677,2020-11-15,270,Capital Call,2000,-10050000,460382,-9589618
75677,2020-11-15,270,Distribution,52168,-10050000,512550,-9537450
75677,2020-12-31,270,Value,8351550,-10050000,512550,-9537450
75741,2020-02-15,2305,Capital Call,-550272,-2310223,63420,-2246803
75741,2020-03-31,2305,Value,794440,-2310223,63420,-2246803
75741,2020-05-16,2305,Capital Call,-1343512,-3653735,63420,-3590315
75741,2020-05-16,2305,Distribution,102547,-3653735,165967,-3487768
75741,2020-06-30,2305,Value,1927080,-3653735,165967,-3487768
75741,2020-08-15,2305,Capital Call,-166694,-3820429,165967,-3654462
75741,2020-09-30,2305,Value,2416670,-3820429,165967,-3654462
75741,2020-11-15,2305,Capital Call,-973616,-4794045,165967,-4628078
75741,2020-12-31,2305,Value,3806180,-4794045,165967,-4628078
75742,2020-03-31,588,Capital Call,-90000,-750001,0,-750001
75742,2020-06-30,588,Value,1154250,-750001,0,-750001
75742,2020-08-15,588,Capital Call,-220000,-970001,0,-970001
75742,2020-09-30,588,Value,1917690,-970001,0,-970001
75742,2020-11-15,588,Capital Call,-190000,-1160001,0,-1160001
75742,2020-12-31,588,Value,2802560,-1160001,0,-1160001
75742,2021-02-14,588,Capital Call,-1240000,-2400001,0,-2400001
75742,2021-03-31,588,Value,4833600,-2400001,0,-2400001
75742,2021-05-16,588,Capital Call,-600000,-3000001,0,-3000001
75742,2021-05-16,588,Distribution,501000,-3000001,501000,-2499001
75742,2021-06-30,588,Value,5748000,-3000001,501000,-2499001
75742,2021-08-15,588,Capital Call,-1000000,-4000001,501000,-3499001
75742,2021-08-15,588,Distribution,1031000,-4000001,1532000,-2468001
75742,2021-09-30,588,Value,6404000,-4000001,1532000,-2468001
75787,2020-03-31,6544,Value,379790,-387198,0,-387198
75787,2020-05-16,6544,Capital Call,-282322,-669520,0,-669520
75787,2020-05-16,6544,Distribution,5175,-669520,5175,-664345
75787,2020-06-30,6544,Value,625290,-669520,5175,-664345
75787,2020-09-30,6544,Value,680470,-669520,5175,-664345
75787,2020-12-30,6544,Capital Call,-499221,-1168741,5175,-1163566
75787,2020-12-30,6544,Distribution,2322,-1168741,7497,-1161244
75787,2021-03-31,6544,Value,1187410,-1168741,7497,-1161244
75816,2020-02-15,628,Capital Call,-649351,-4545456,448147,-4097309
75816,2020-03-31,628,Value,5068120,-4545456,448147,-4097309
75816,2020-05-16,628,Capital Call,-649351,-5194807,448147,-4746660
75816,2020-06-30,628,Value,5677520,-5194807,448147,-4746660
75816,2020-09-30,628,Value,5636340,-5194807,448147,-4746660
75816,2020-11-15,628,Capital Call,-1038961,-6233768,448147,-5785621
75816,2020-12-31,628,Value,15232520,-6233768,448147,-5785621
75816,2021-02-14,628,Capital Call,-2129870,-8363638,448147,-7915491
75816,2021-02-14,628,Distribution,4830920,-8363638,5279067,-3084571
75816,2021-03-31,628,Value,14770710,-8363638,5279067,-3084571
75837,2020-03-31,211,Value,3757900,-3436632,210768,-3225864
75837,2020-06-30,211,Value,3918480,-3436632,210768,-3225864
75837,2020-08-15,211,Capital Call,-845639,-4282271,210768,-4071503
75837,2020-09-30,211,Value,4074790,-4282271,210768,-4071503
75837,2020-12-31,211,Value,4128170,-4282271,210768,-4071503
75837,2021-03-31,211,Value,4602120,-4282271,210768,-4071503
75837,2021-05-16,211,Capital Call,-592070,-4874341,210768,-4663573
75837,2021-06-30,211,Value,6707390,-4874341,210768,-4663573
75837,2021-08-15,211,Distribution,488509,-4874341,699277,-4175064
75837,2021-09-30,211,Value,7281850,-4874341,699277,-4175064
75871,2020-05-16,246895,Capital Call,-1355000,-1660000,55000,-1605000
75871,2020-06-30,246895,Value,960000,-1660000,55000,-1605000
75871,2020-09-30,246895,Value,1295000,-1660000,55000,-1605000
75871,2020-11-15,246895,Capital Call,-1185000,-2845000,55000,-2790000
75871,2020-12-31,246895,Value,2795000,-2845000,55000,-2790000
75871,2021-02-14,246895,Capital Call,-100000,-2945000,55000,-2890000
75871,2021-03-31,246895,Value,3760000,-2945000,55000,-2890000
75871,2021-05-16,246895,Capital Call,-150000,-3095000,55000,-3040000
75871,2021-06-30,246895,Value,3894990,-3095000,55000,-3040000
75871,2021-08-15,246895,Capital Call,-577500,-3672500,55000,-3617500
75871,2021-08-15,246895,Distribution,-1500,-3672500,53500,-3619000
75871,2021-09-30,246895,Value,4449500,-3672500,53500,-3619000
75918,2020-02-15,9110,Capital Call,-966000,-5115000,110364,-5004636
75918,2020-02-15,9110,Distribution,57920,-5115000,168284,-4946716
75918,2020-03-31,9110,Value,5110900,-5115000,168284,-4946716
75918,2020-05-16,9110,Capital Call,-267000,-5382000,168284,-5213716
75918,2020-05-16,9110,Distribution,7170,-5382000,175454,-5206546
75918,2020-06-30,9110,Value,5681770,-5382000,175454,-5206546
75918,2020-08-15,9110,Capital Call,-543000,-5925000,175454,-5749546
75918,2020-08-15,9110,Distribution,98282,-5925000,273736,-5651264
75918,2020-09-30,9110,Value,6462990,-5925000,273736,-5651264
75918,2020-11-15,9110,Capital Call,-1083000,-7008000,273736,-6734264
75918,2020-11-15,9110,Distribution,75263,-7008000,348999,-6659001
75918,2020-12-31,9110,Value,8641560,-7008000,348999,-6659001
75918,2021-02-14,9110,Capital Call,-1288000,-8296000,348999,-7947001
75918,2021-02-14,9110,Distribution,89860,-8296000,438859,-7857141
75918,2021-03-31,9110,Value,10878540,-8296000,438859,-7857141
75918,2021-05-16,9110,Capital Call,-829000,-9125000,438859,-8686141
75918,2021-05-16,9110,Distribution,54,-9125000,438913,-8686087
75918,2021-06-30,9110,Value,11896260,-9125000,438913,-8686087
75918,2021-08-15,9110,Capital Call,-319000,-9444000,438913,-9005087
75918,2021-08-15,9110,Distribution,475267,-9444000,914180,-8529820
75918,2021-09-30,9110,Value,11797440,-9444000,914180,-8529820
75933,2020-03-31,355,Value,1106100,-1300000,37640,-1262360
75933,2020-05-16,355,Capital Call,-200000,-1500000,37640,-1462360
75933,2020-06-30,355,Value,1414060,-1500000,37640,-1462360
75933,2020-08-15,355,Capital Call,-150000,-1650000,37640,-1612360
75933,2020-08-15,355,Distribution,40040,-1650000,77680,-1572320
75933,2020-09-30,355,Value,1717220,-1650000,77680,-1572320
75933,2020-11-15,355,Capital Call,-300000,-1950000,77680,-1872320
75933,2020-11-15,355,Distribution,32040,-1950000,109720,-1840280
75933,2020-12-31,355,Value,2460300,-1950000,109720,-1840280
75933,2021-02-14,355,Capital Call,-300000,-2250000,109720,-2140280
75933,2021-02-14,355,Distribution,64060,-2250000,173780,-2076220
75933,2021-03-31,355,Value,3435740,-2250000,173780,-2076220
75933,2021-05-16,355,Capital Call,-600000,-2850000,173780,-2676220
75933,2021-05-16,355,Distribution,240260,-2850000,414040,-2435960
75933,2021-06-30,355,Value,4297360,-2850000,414040,-2435960
75953,2020-02-15,307,Capital Call,-1300000,-3550000,233550,-3316450
75953,2020-02-15,307,Distribution,395,-3550000,233945,-3316055
75953,2020-03-31,307,Value,3696260,-3550000,233945,-3316055
75953,2020-06-30,307,Value,3693770,-3550000,233945,-3316055
75953,2020-09-30,307,Value,4035640,-3550000,233945,-3316055
75953,2020-11-15,307,Capital Call,-1420000,-4970000,233945,-4736055
75953,2020-11-15,307,Distribution,142,-4970000,234087,-4735913
75953,2020-12-31,307,Value,6097690,-4970000,234087,-4735913
75953,2021-03-31,307,Value,7474880,-4970000,234087,-4735913
75953,2021-05-16,307,Capital Call,-1540000,-6510000,234087,-6275913
75953,2021-05-16,307,Distribution,273,-6510000,234360,-6275640
75953,2021-06-30,307,Value,11164650,-6510000,234360,-6275640
75953,2021-09-30,307,Value,13323360,-6510000,234360,-6275640
75954,2020-02-15,690,Capital Call,-500000,-7225000,0,-7225000
75954,2020-03-31,690,Value,6628400,-7225000,0,-7225000
75954,2020-05-16,690,Capital Call,-1550000,-8775000,0,-8775000
75954,2020-06-30,690,Value,8126800,-8775000,0,-8775000
75954,2020-08-15,690,Capital Call,-225000,-9000000,0,-9000000
75954,2020-09-30,690,Value,8573200,-9000000,0,-9000000
75954,2020-12-30,690,Distribution,5409600,-9000000,5409600,-3590400
75954,2021-03-31,690,Value,13166600,-9000000,5409600,-3590400
75954,2021-05-16,690,Distribution,1406200,-9000000,6815800,-2184200
75954,2021-06-30,690,Value,11924000,-9000000,6815800,-2184200
76010,2020-02-15,5296,Capital Call,-370000,-6060000,0,-6060000
76010,2020-03-31,5296,Value,6787200,-6060000,0,-6060000
76010,2020-05-16,5296,Capital Call,-840000,-6900000,0,-6900000
76010,2020-06-30,5296,Value,7383000,-6900000,0,-6900000
76010,2020-08-15,5296,Capital Call,-150000,-7050000,0,-7050000
76010,2020-09-30,5296,Value,7614000,-7050000,0,-7050000
76010,2020-11-15,5296,Capital Call,-850000,-7900000,0,-7900000
76010,2020-12-31,5296,Value,10586000,-7900000,0,-7900000
76010,2021-02-14,5296,Capital Call,-450000,-8350000,0,-8350000
76010,2021-03-31,5296,Value,11105500,-8350000,0,-8350000
76010,2021-05-16,5296,Capital Call,-80000,-8430000,0,-8430000
76010,2021-06-30,5296,Value,12645000,-8430000,0,-8430000
76010,2021-08-15,5296,Capital Call,-780000,-9210000,0,-9210000
76010,2021-09-30,5296,Value,13815000,-9210000,0,-9210000
76105,2020-02-15,102485,Capital Call,-799666,-3153666,0,-3153666
76105,2020-03-31,102485,Value,2844600,-3153666,0,-3153666
76105,2020-05-16,102485,Capital Call,-724000,-3877666,0,-3877666
76105,2020-06-30,102485,Value,3613980,-3877666,0,-3877666
76105,2020-08-15,102485,Capital Call,-500500,-4378166,0,-4378166
76105,2020-09-30,102485,Value,3865920,-4378166,0,-4378166
76105,2020-11-15,102485,Capital Call,-505000,-4883166,0,-4883166
76105,2020-12-31,102485,Value,4365550,-4883166,0,-4883166
76105,2021-03-31,102485,Value,4455680,-4883166,0,-4883166
76105,2021-05-16,102485,Capital Call,-128000,-5011166,0,-5011166
76105,2021-06-30,102485,Value,4641580,-5011166,0,-5011166
76105,2021-09-30,102485,Value,4641580,-5011166,0,-5011166
76109,2020-02-15,60408,Capital Call,-107860,-1463640,0,-1463640
76109,2020-03-31,60408,Value,960160,-1463640,0,-1463640
76109,2020-06-30,60408,Value,921070,-1463640,0,-1463640
76109,2020-08-15,60408,Capital Call,-150101,-1613741,0,-1613741
76109,2020-09-30,60408,Value,1071180,-1613741,0,-1613741
76109,2020-11-15,60408,Capital Call,-789562,-2403303,0,-2403303
76109,2020-12-31,60408,Value,1757040,-2403303,0,-2403303
76109,2021-02-14,60408,Capital Call,-849152,-3252455,0,-3252455
76109,2021-03-31,60408,Value,2849030,-3252455,0,-3252455
76237,2020-03-31,23839,Value,1705040,-2454557,590654,-1863903
76237,2020-05-16,23839,Capital Call,-576835,-3031392,590654,-2440738
76237,2020-05-16,23839,Distribution,138807,-3031392,729461,-2301931
76237,2020-06-30,23839,Value,1709340,-3031392,729461,-2301931
76237,2020-08-15,23839,Capital Call,-132395,-3163787,729461,-2434326
76237,2020-08-15,23839,Distribution,1773,-3163787,731234,-2432553
76237,2020-09-30,23839,Value,1995920,-3163787,731234,-2432553
76237,2020-12-31,23839,Value,2192550,-3163787,731234,-2432553
76237,2021-02-14,23839,Capital Call,-150351,-3314138,731234,-2582904
76237,2021-03-31,23839,Value,2400400,-3314138,731234,-2582904
76237,2021-05-16,23839,Capital Call,-966194,-4280332,731234,-3549098
76237,2021-05-16,23839,Distribution,515,-4280332,731749,-3548583
76237,2021-06-30,23839,Value,3417590,-4280332,731749,-3548583
76237,2021-08-15,23839,Capital Call,-1757033,-6037365,731749,-5305616
76237,2021-08-15,23839,Distribution,125427,-6037365,857176,-5180189
76237,2021-09-30,23839,Value,5522950,-6037365,857176,-5180189
76240,2020-02-29,44,Capital Call,-1471127,-1471127,0,-1471127
76240,2020-02-29,44,Value,1287350,-1471127,0,-1471127
76240,2020-05-31,44,Value,936390,-1471127,0,-1471127
76240,2020-07-16,44,Capital Call,-631738,-2102865,0,-2102865
76240,2020-08-31,44,Value,1767990,-2102865,0,-2102865
76240,2020-10-16,44,Capital Call,-71223,-2174088,0,-2174088
76240,2020-10-16,44,Distribution,11687,-2174088,11687,-2162401
76240,2020-11-30,44,Value,1956200,-2174088,11687,-2162401
76240,2021-01-14,44,Capital Call,-82543,-2256631,11687,-2244944
76240,2021-01-14,44,Distribution,62153,-2256631,73840,-2182791
76240,2021-02-28,44,Value,1980340,-2256631,73840,-2182791
76240,2021-05-31,44,Capital Call,-1964275,-4220906,73840,-4147066
76240,2021-05-31,44,Distribution,11401,-4220906,85241,-4135665
76240,2021-08-31,44,Value,4791530,-4220906,85241,-4135665
76240,2021-10-16,44,Capital Call,-1078832,-5299738,85241,-5214497
76240,2021-10-16,44,Distribution,1555,-5299738,86796,-5212942
76240,2021-11-30,44,Value,6567430,-5299738,86796,-5212942
76280,2020-03-31,436,Capital Call,-1138412,-1138412,0,-1138412
76280,2020-03-31,436,Value,1006000,-1138412,0,-1138412
76280,2020-05-16,436,Capital Call,-1131305,-2269717,0,-2269717
76280,2020-06-30,436,Value,1814990,-2269717,0,-2269717
76280,2020-08-15,436,Capital Call,-967029,-3236746,0,-3236746
76280,2020-09-30,436,Value,3162390,-3236746,0,-3236746
76280,2020-11-15,436,Capital Call,-895707,-4132453,0,-4132453
76280,2020-12-31,436,Value,4462920,-4132453,0,-4132453
76280,2021-02-14,436,Distribution,164937,-4132453,164937,-3967516
76280,2021-03-31,436,Value,4474530,-4132453,164937,-3967516
76280,2021-05-16,436,Capital Call,-1984991,-6117444,164937,-5952507
76280,2021-05-16,436,Distribution,18414,-6117444,183351,-5934093
76280,2021-06-30,436,Value,6461970,-6117444,183351,-5934093
76280,2021-08-15,436,Distribution,361895,-6117444,545246,-5572198
76280,2021-09-30,436,Value,6829250,-6117444,545246,-5572198
76323,2020-02-15,1718,Capital Call,-1300000,-4950000,0,-4950000
76323,2020-03-31,1718,Value,4653000,-4950000,0,-4950000
76323,2020-05-16,1718,Capital Call,-750000,-5700000,0,-5700000
76323,2020-06-30,1718,Value,5700000,-5700000,0,-5700000
76323,2020-09-30,1718,Value,5643000,-5700000,0,-5700000
76323,2020-11-15,1718,Capital Call,-650000,-6350000,0,-6350000
76323,2020-12-31,1718,Value,8255000,-6350000,0,-6350000
76323,2021-02-14,1718,Capital Call,-300000,-6650000,0,-6650000
76323,2021-02-14,1718,Distribution,2460500,-6650000,2460500,-4189500
76323,2021-03-31,1718,Value,6384000,-6650000,2460500,-4189500
76323,2021-05-16,1718,Capital Call,-600000,-7250000,2460500,-4789500
76323,2021-05-16,1718,Distribution,4500,-7250000,2465000,-4785000
76323,2021-06-30,1718,Value,8265000,-7250000,2465000,-4785000
76323,2021-08-15,1718,Capital Call,-900000,-8150000,2465000,-5685000
76323,2021-08-15,1718,Distribution,1773000,-8150000,4238000,-3912000
76323,2021-09-30,1718,Value,7253500,-8150000,4238000,-3912000
76323,2021-12-31,1718,Value,8313000,-8150000,4238000,-3912000
76389,2020-02-15,743,Capital Call,-688807,-3041871,182355,-2859516
76389,2020-02-15,743,Distribution,556941,-3041871,739296,-2302575
76389,2020-03-31,743,Value,2656970,-3041871,739296,-2302575
76389,2020-05-16,743,Capital Call,-1334139,-4376010,739296,-3636714
76389,2020-06-30,743,Value,4063080,-4376010,739296,-3636714
76389,2020-08-15,743,Capital Call,-576264,-4952274,739296,-4212978
76389,2020-09-30,743,Value,5772310,-4952274,739296,-4212978
76389,2020-12-31,743,Value,6231130,-4952274,739296,-4212978
76389,2021-02-14,743,Capital Call,-782189,-5734463,739296,-4995167
76389,2021-03-31,743,Value,7013320,-5734463,739296,-4995167
76389,2021-05-16,743,Distribution,1326237,-5734463,2065533,-3668930
76389,2021-06-30,743,Value,10134130,-5734463,2065533,-3668930
76389,2021-08-15,743,Capital Call,-2223099,-7957562,2065533,-5892029
76389,2021-09-30,743,Value,12451040,-7957562,2065533,-5892029
76399,2020-02-15,6198,Capital Call,-2525000,-5700000,0,-5700000
76399,2020-03-31,6198,Value,5256540,-5700000,0,-5700000
76399,2020-05-16,6198,Capital Call,-135000,-5835000,0,-5835000
76399,2020-06-30,6198,Value,5405540,-5835000,0,-5835000
76399,2020-08-15,6198,Capital Call,-820000,-6655000,0,-6655000
76399,2020-09-30,6198,Value,6380140,-6655000,0,-6655000
76399,2020-11-15,6198,Capital Call,-2175000,-8830000,0,-8830000
76399,2020-12-31,6198,Value,8460020,-8830000,0,-8830000
76399,2021-03-31,6198,Value,9992910,-8830000,0,-8830000
76399,2021-05-16,6198,Capital Call,-25000,-8855000,0,-8855000
76399,2021-05-16,6198,Distribution,1771,-8855000,1771,-8853229
76399,2021-06-30,6198,Value,10219550,-8855000,1771,-8853229
76399,2021-08-15,6198,Capital Call,-465000,-9320000,1771,-9318229
76399,2021-08-15,6198,Distribution,93,-9320000,1864,-9318136
76399,2021-09-30,6198,Value,11114100,-9320000,1864,-9318136
76423,2020-02-15,6657,Capital Call,-44000,-2260000,0,-2260000
76423,2020-03-31,6657,Value,2852000,-2260000,0,-2260000
76423,2020-05-16,6657,Capital Call,-452000,-2712000,0,-2712000
76423,2020-06-30,6657,Value,3168000,-2712000,0,-2712000
76423,2020-08-15,6657,Capital Call,-876000,-3588000,0,-3588000
76423,2020-09-30,6657,Value,4128000,-3588000,0,-3588000
76423,2020-11-15,6657,Capital Call,-4136000,-7724000,0,-7724000
76423,2020-12-31,6657,Value,9192000,-7724000,0,-7724000
76423,2021-02-14,6657,Capital Call,-64000,-7788000,0,-7788000
76423,2021-02-14,6657,Distribution,4000,-7788000,4000,-7784000
76423,2021-03-31,6657,Value,9467990,-7788000,4000,-7784000
76423,2021-05-16,6657,Capital Call,-568000,-8356000,4000,-8352000
76423,2021-05-16,6657,Distribution,1176000,-8356000,1180000,-7176000
76423,2021-06-30,6657,Value,11064000,-8356000,1180000,-7176000
76423,2021-08-15,6657,Capital Call,-24000,-8380000,1180000,-7200000
76423,2021-09-30,6657,Value,11040000,-8380000,1180000,-7200000
76445,2020-03-31,190539,Value,25562720,-10000006,329916,-9670090
76445,2020-06-30,190539,Value,25521090,-10000006,329916,-9670090
76445,2020-09-30,190539,Value,26204080,-10000006,329916,-9670090
76445,2020-12-31,190539,Value,26337580,-10000006,329916,-9670090
76445,2021-03-31,190539,Value,26309710,-10000006,329916,-9670090
76445,2021-06-30,190539,Value,23361210,-10000006,329916,-9670090
76445,2021-09-30,190539,Value,23177920,-10000006,329916,-9670090
76449,2020-03-31,16570,Value,26759030,-9305000,0,-9305000
76449,2020-05-16,16570,Capital Call,-48000,-9353000,0,-9353000
76449,2020-06-30,16570,Value,25225740,-9353000,0,-9353000
76449,2020-09-30,16570,Value,38718220,-9353000,0,-9353000
76449,2020-11-15,16570,Capital Call,-55000,-9408000,0,-9408000
76449,2020-12-31,16570,Value,39506640,-9408000,0,-9408000
76449,2021-03-31,16570,Value,46131710,-9408000,0,-9408000
76449,2021-05-16,16570,Capital Call,-48000,-9456000,0,-9456000
76449,2021-06-30,16570,Value,47940310,-9456000,0,-9456000
76449,2021-09-30,16570,Value,66492560,-9456000,0,-9456000
76507,2020-03-31,68841,Value,4000000,-5000000,0,-5000000
76507,2020-06-30,68841,Value,4000000,-5000000,0,-5000000
76507,2020-09-30,68841,Capital Call,-1000000,-6000000,0,-6000000
76507,2020-12-31,68841,Value,5311040,-6000000,0,-6000000
76573,2020-02-15,82397,Capital Call,-33522,-4861625,0,-4861625
76573,2020-03-31,82397,Value,5472820,-4861625,0,-4861625
76573,2020-05-16,82397,Capital Call,-32941,-4894566,0,-4894566
76573,2020-06-30,82397,Value,5348350,-4894566,0,-4894566
76573,2020-08-15,82397,Capital Call,-66667,-4961233,0,-4961233
76573,2020-09-30,82397,Value,5703050,-4961233,0,-4961233
76573,2020-11-15,82397,Capital Call,-2185049,-7146282,0,-7146282
76573,2020-12-31,82397,Value,8182110,-7146282,0,-7146282
76573,2021-02-14,82397,Capital Call,-1748874,-8895156,0,-8895156
76573,2021-03-31,82397,Value,10304050,-8895156,0,-8895156
76573,2021-06-30,82397,Value,10877090,-8895156,0,-8895156
76691,2020-02-15,813,Capital Call,-1057866,-2324807,0,-2324807
76691,2020-03-31,813,Value,2261360,-2324807,0,-2324807
76691,2020-05-16,813,Capital Call,-1006563,-3331370,0,-3331370
76691,2020-05-16,813,Distribution,120690,-3331370,120690,-3210680
76691,2020-06-30,813,Value,2942360,-3331370,120690,-3210680
76691,2020-08-15,813,Capital Call,-40625,-3371995,120690,-3251305
76691,2020-09-30,813,Value,2980100,-3371995,120690,-3251305
76691,2020-11-15,813,Capital Call,-40625,-3412620,120690,-3291930
76691,2020-12-31,813,Value,3084820,-3412620,120690,-3291930
76691,2021-02-14,813,Capital Call,62771,-3349849,120690,-3229159
76691,2021-03-31,813,Value,3022050,-3349849,120690,-3229159
76691,2021-05-16,813,Capital Call,-786602,-4136451,120690,-4015761
76691,2021-06-30,813,Value,3971920,-4136451,120690,-4015761
76691,2021-08-15,813,Capital Call,-33783,-4170234,120690,-4049544
76691,2021-09-30,813,Value,4492110,-4170234,120690,-4049544
76721,2020-03-01,554,Capital Call,-1785714,-2992856,0,-2992856
76721,2020-08-31,554,Value,2845880,-2992856,0,-2992856
76721,2020-10-16,554,Capital Call,-857143,-3849999,0,-3849999
76721,2020-11-30,554,Value,3995710,-3849999,0,-3849999
76721,2021-01-14,554,Capital Call,-1453571,-5303570,0,-5303570
76721,2021-01-14,554,Distribution,185714,-5303570,185714,-5117856
76721,2021-02-28,554,Value,5297240,-5303570,185714,-5117856
76721,2021-04-15,554,Capital Call,-1028571,-6332141,185714,-6146427
76721,2021-05-31,554,Value,6364290,-6332141,185714,-6146427
76721,2021-07-16,554,Capital Call,-1950000,-8282141,185714,-8096427
76721,2021-08-31,554,Value,7950480,-8282141,185714,-8096427
76721,2021-10-16,554,Capital Call,-1514643,-9796784,185714,-9611070
76721,2021-10-16,554,Distribution,137857,-9796784,323571,-9473213
76721,2021-11-30,554,Value,9557770,-9796784,323571,-9473213
76723,2020-02-15,303,Capital Call,-1255000,-6855000,0,-6855000
76723,2020-03-31,303,Value,10870180,-6855000,0,-6855000
76723,2020-05-16,303,Capital Call,-340000,-7195000,0,-7195000
76723,2020-05-16,303,Distribution,1766065,-7195000,1766065,-5428935
76723,2020-06-30,303,Value,12940060,-7195000,1766065,-5428935
76723,2020-08-15,303,Capital Call,-215000,-7410000,1766065,-5643935
76723,2020-09-30,303,Value,11856560,-7410000,1766065,-5643935
76723,2020-11-15,303,Capital Call,-565000,-7975000,1766065,-6208935
76723,2020-12-31,303,Value,15413050,-7975000,1766065,-6208935
76723,2021-02-14,303,Capital Call,-190000,-8165000,1766065,-6398935
76723,2021-03-31,303,Value,15293840,-8165000,1766065,-6398935
76723,2021-05-16,303,Capital Call,-145000,-8310000,1766065,-6543935
76723,2021-05-16,303,Distribution,539894,-8310000,2305959,-6004041
76723,2021-06-30,303,Value,14007270,-8310000,2305959,-6004041
76877,2020-03-31,76568,Value,6199990,-6999999,0,-6999999
76877,2020-05-16,76568,Capital Call,-1000000,-7999999,0,-7999999
76877,2020-06-30,76568,Value,7200000,-7999999,0,-7999999
76877,2020-09-30,76568,Value,5520000,-7999999,0,-7999999
76877,2020-11-15,76568,Capital Call,-800000,-8799999,0,-8799999
76877,2020-12-31,76568,Value,7832000,-8799999,0,-8799999
76877,2021-03-31,76568,Value,7832000,-8799999,0,-8799999
76877,2021-06-30,76568,Value,8800000,-8799999,0,-8799999
76877,2021-08-15,76568,Capital Call,-500000,-9299999,0,-9299999
76877,2021-09-30,76568,Value,8556000,-9299999,0,-9299999
76953,2021-06-30,12384,Capital Call,-6000000,-6000000,0,-6000000
76953,2021-06-30,12384,Value,6451200,-6000000,0,-6000000
76959,2020-02-15,613,Capital Call,-90453,-7371033,1460124,-5910909
76959,2020-02-15,613,Distribution,276885,-7371033,1737009,-5634024
76959,2020-03-31,613,Value,6392600,-7371033,1737009,-5634024
76959,2020-05-16,613,Capital Call,-126551,-7497584,1737009,-5760575
76959,2020-05-16,613,Distribution,238472,-7497584,1975481,-5522103
76959,2020-06-30,613,Value,6629760,-7497584,1975481,-5522103
76959,2020-09-30,613,Value,7805360,-7497584,1975481,-5522103
76959,2020-11-15,613,Capital Call,-97564,-7595148,1975481,-5619667
76959,2020-11-15,613,Distribution,524770,-7595148,2500251,-5094897
76959,2020-12-31,613,Value,8801850,-7595148,2500251,-5094897
76959,2021-03-31,613,Value,10719550,-7595148,2500251,-5094897
76972,2020-02-15,372,Capital Call,-537949,-3063801,445130,-2618671
76972,2020-03-31,372,Value,2406890,-3063801,445130,-2618671
76972,2020-06-30,372,Value,2578080,-3063801,445130,-2618671
76972,2020-08-15,372,Capital Call,-2013032,-5076833,445130,-4631703
76972,2020-09-30,372,Value,5592570,-5076833,445130,-4631703
76972,2020-11-15,372,Capital Call,-607245,-5684078,445130,-5238948
76972,2020-11-15,372,Distribution,115633,-5684078,560763,-5123315
76972,2020-12-31,372,Value,8028050,-5684078,560763,-5123315
76972,2021-02-14,372,Capital Call,-65443,-5749521,560763,-5188758
76972,2021-02-14,372,Distribution,677577,-5749521,1238340,-4511181
76972,2021-03-31,372,Value,7522690,-5749521,1238340,-4511181
76972,2021-06-30,372,Value,8544030,-5749521,1238340,-4511181
76972,2021-08-15,372,Capital Call,-1371852,-7121373,1238340,-5883033
76972,2021-08-15,372,Distribution,717200,-7121373,1955540,-5165833
76972,2021-09-30,372,Value,9645770,-7121373,1955540,-5165833
76991,2020-02-15,1314,Capital Call,-11000,-3600000,0,-3600000
76991,2020-03-31,1314,Value,5090760,-3600000,0,-3600000
76991,2020-05-16,1314,Capital Call,-473,-3600473,0,-3600473
76991,2020-06-30,1314,Value,5662850,-3600473,0,-3600473
76991,2020-08-15,1314,Capital Call,473,-3600000,0,-3600000
76991,2020-09-30,1314,Value,6361560,-3600000,0,-3600000
76991,2020-11-15,1314,Capital Call,-986000,-4586000,0,-4586000
76991,2020-12-31,1314,Value,9296730,-4586000,0,-4586000
76991,2021-02-14,1314,Capital Call,-1115000,-5701000,0,-5701000
76991,2021-02-14,1314,Distribution,1100293,-5701000,1100293,-4600707
76991,2021-03-31,1314,Value,10143210,-5701000,1100293,-4600707
76991,2021-05-16,1314,Capital Call,-9000,-5710000,1100293,-4609707
76991,2021-05-16,1314,Distribution,1737,-5710000,1102030,-4607970
76991,2021-06-30,1314,Value,11396580,-5710000,1102030,-4607970
76991,2021-08-15,1314,Capital Call,-706000,-6416000,1102030,-5313970
76991,2021-08-15,1314,Distribution,63116,-6416000,1165146,-5250854
76991,2021-09-30,1314,Value,11918360,-6416000,1165146,-5250854
77002,2020-02-15,50443,Distribution,287203,-13215223,11373889,-1841334
77002,2020-03-31,50443,Value,2025620,-13215223,11373889,-1841334
77002,2020-05-16,50443,Distribution,75305,-13215223,11449194,-1766029
77002,2020-06-30,50443,Value,1964860,-13215223,11449194,-1766029
77002,2020-08-15,50443,Capital Call,-1911971,-15127194,11449194,-3678000
77002,2020-08-15,50443,Distribution,96321,-15127194,11545515,-3581679
77002,2020-09-30,50443,Value,3950140,-15127194,11545515,-3581679
77002,2020-11-15,50443,Distribution,40946,-15127194,11586461,-3540733
77002,2020-12-31,50443,Value,4059950,-15127194,11586461,-3540733
77002,2021-02-14,50443,Capital Call,-1102870,-16230064,11586461,-4643603
77002,2021-02-14,50443,Distribution,197147,-16230064,11783608,-4446456
77002,2021-03-31,50443,Value,5179590,-16230064,11783608,-4446456
77011,2020-02-15,192910,Capital Call,-813699,-6635800,21869,-6613931
77011,2020-03-31,192910,Value,7236440,-6635800,21869,-6613931
77011,2020-06-30,192910,Value,9294530,-6635800,21869,-6613931
77011,2020-08-15,192910,Capital Call,-1128971,-7764771,21869,-7742902
77011,2020-09-30,192910,Value,11650950,-7764771,21869,-7742902
77011,2020-12-31,192910,Value,12374130,-7764771,21869,-7742902
77011,2021-02-14,192910,Capital Call,-225319,-7990090,21869,-7968221
77011,2021-02-14,192910,Distribution,-21869,-7990090,0,-7990090
77011,2021-03-31,192910,Value,14013300,-7990090,0,-7990090
77011,2021-05-16,192910,Capital Call,-1162411,-9152501,0,-9152501
77011,2021-06-30,192910,Value,15268530,-9152501,0,-9152501
77051,2020-03-31,109604,Value,6016000,-6400000,0,-6400000
77051,2020-05-16,109604,Capital Call,-1000000,-7400000,0,-7400000
77051,2020-06-30,109604,Value,7030000,-7400000,0,-7400000
77051,2020-09-30,109604,Capital Call,-400000,-7800000,0,-7800000
77051,2020-12-31,109604,Value,7800000,-7800000,0,-7800000
77060,2020-02-15,192093,Capital Call,-906301,-6396942,48317,-6348625
77060,2020-03-31,192093,Value,6749760,-6396942,48317,-6348625
77060,2020-05-16,192093,Capital Call,-178505,-6575447,48317,-6527130
77060,2020-06-30,192093,Value,7215900,-6575447,48317,-6527130
77060,2020-08-15,192093,Capital Call,-307686,-6883133,48317,-6834816
77060,2020-08-15,192093,Distribution,41906,-6883133,90223,-6792910
77060,2020-09-30,192093,Value,7978380,-6883133,90223,-6792910
77060,2020-11-15,192093,Capital Call,-485174,-7368307,90223,-7278084
77060,2020-12-31,192093,Value,9404990,-7368307,90223,-7278084
77060,2021-02-14,192093,Capital Call,-260999,-7629306,90223,-7539083
77060,2021-03-31,192093,Value,10687250,-7629306,90223,-7539083
77060,2021-05-16,192093,Capital Call,-586258,-8215564,90223,-8125341
77060,2021-05-16,192093,Distribution,460605,-8215564,550828,-7664736
77060,2021-06-30,192093,Value,14215670,-8215564,550828,-7664736
77141,2020-03-31,109923,Value,5148170,-5289615,879947,-4409668
77141,2020-06-30,109923,Value,5218570,-5289615,879947,-4409668
77141,2020-08-15,109923,Capital Call,-11900,-5301515,879947,-4421568
77141,2020-08-15,109923,Distribution,1189946,-5301515,2069893,-3231622
77141,2020-09-30,109923,Value,3850880,-5301515,2069893,-3231622
77141,2020-11-15,109923,Distribution,922365,-5301515,2992258,-2309257
77141,2020-12-31,109923,Value,4329630,-5301515,2992258,-2309257
77141,2021-02-14,109923,Distribution,438646,-5301515,3430904,-1870611
77141,2021-03-31,109923,Value,2870500,-5301515,3430904,-1870611
77141,2021-06-30,109923,Value,2542150,-5301515,3430904,-1870611
77170,2020-03-31,1886,Value,12395290,-8200000,1350000,-6850000
77170,2020-05-16,1886,Capital Call,-250000,-8450000,1350000,-7100000
77170,2020-06-30,1886,Value,14166540,-8450000,1350000,-7100000
77170,2020-09-30,1886,Value,15816140,-8450000,1350000,-7100000
77170,2020-11-15,1886,Capital Call,-99988,-8549988,1350000,-7199988
77170,2020-11-15,1886,Distribution,1249996,-8549988,2599996,-5949992
77170,2020-12-31,1886,Value,18184570,-8549988,2599996,-5949992
77170,2021-02-14,1886,Capital Call,-500012,-9050000,2599996,-6450004
77170,2021-02-14,1886,Distribution,1700004,-9050000,4300000,-4750000
77170,2021-03-31,1886,Value,19742400,-9050000,4300000,-4750000
77170,2021-05-16,1886,Capital Call,11,-9049989,4300000,-4749989
77170,2021-05-16,1886,Distribution,1099993,-9049989,5399993,-3649996
77170,2021-06-30,1886,Value,21850100,-9049989,5399993,-3649996
77170,2021-08-15,1886,Capital Call,-11,-9050000,5399993,-3650007
77170,2021-08-15,1886,Distribution,2700007,-9050000,8100000,-950000
77170,2021-09-30,1886,Value,21516000,-9050000,8100000,-950000
77171,2020-02-15,1886,Capital Call,-400000,-7520000,750000,-6770000
77171,2020-02-15,1886,Distribution,500000,-7520000,1250000,-6270000
77171,2020-03-31,1886,Value,7974150,-7520000,1250000,-6270000
77171,2020-05-16,1886,Capital Call,-650000,-8170000,1250000,-6920000
77171,2020-06-30,1886,Value,9270520,-8170000,1250000,-6920000
77171,2020-09-30,1886,Value,9693990,-8170000,1250000,-6920000
77171,2020-11-15,1886,Capital Call,7,-8169993,1250000,-6919993
77171,2020-11-15,1886,Distribution,-1,-8169993,1249999,-6919994
77171,2020-12-31,1886,Value,10322460,-8169993,1249999,-6919994
77171,2021-02-14,1886,Capital Call,-200007,-8370000,1249999,-7120001
77171,2021-02-14,1886,Distribution,300001,-8370000,1550000,-6820000
77171,2021-03-31,1886,Value,10626850,-8370000,1550000,-6820000
77171,2021-05-16,1886,Capital Call,7,-8369993,1550000,-6819993
77171,2021-05-16,1886,Distribution,299998,-8369993,1849998,-6519995
77171,2021-06-30,1886,Value,11094300,-8369993,1849998,-6519995
77171,2021-08-15,1886,Capital Call,-7,-8370000,1849998,-6520002
77171,2021-08-15,1886,Distribution,500002,-8370000,2350000,-6020000
77171,2021-09-30,1886,Value,11144580,-8370000,2350000,-6020000
77173,2020-02-15,1886,Capital Call,-350000,-5850000,860000,-4990000
77173,2020-03-31,1886,Value,6095140,-5850000,860000,-4990000
77173,2020-05-16,1886,Capital Call,-450000,-6300000,860000,-5440000
77173,2020-06-30,1886,Value,6779250,-6300000,860000,-5440000
77173,2020-09-30,1886,Value,6794440,-6300000,860000,-5440000
77173,2020-11-15,1886,Capital Call,-449994,-6749994,860000,-5889994
77173,2020-11-15,1886,Distribution,-1,-6749994,859999,-5889995
77173,2020-12-31,1886,Value,7675920,-6749994,859999,-5889995
77173,2021-02-14,1886,Capital Call,-6,-6750000,859999,-5890001
77173,2021-02-14,1886,Distribution,200001,-6750000,1060000,-5690000
77173,2021-03-31,1886,Value,7937640,-6750000,1060000,-5690000
77173,2021-05-16,1886,Capital Call,-399994,-7149994,1060000,-6089994
77173,2021-05-16,1886,Distribution,449999,-7149994,1509999,-5639995
77173,2021-06-30,1886,Value,8639330,-7149994,1509999,-5639995
77173,2021-08-15,1886,Capital Call,-500006,-7650000,1509999,-6140001
77173,2021-08-15,1886,Distribution,200001,-7650000,1710000,-5940000
77173,2021-09-30,1886,Value,9439910,-7650000,1710000,-5940000
77302,2020-07-01,8062,Capital Call,-778571,-3951428,0,-3951428
77302,2020-12-31,8062,Value,5060510,-3951428,0,-3951428
77364,2020-02-15,77,Distribution,579420,-8025328,7932134,-93194
77364,2020-03-31,77,Value,3302250,-8025328,7932134,-93194
77364,2020-06-30,77,Value,3378890,-8025328,7932134,-93194
77364,2020-08-15,77,Capital Call,-249750,-8275078,7932134,-342944
77364,2020-08-15,77,Distribution,1298700,-8275078,9230834,955756
77364,2020-09-30,77,Value,2560770,-8275078,9230834,955756
77772,2020-01-15,12267,Capital Call,-893147,-1194641,0,-1194641
77772,2020-02-29,12267,Value,1075890,-1194641,0,-1194641
77772,2020-04-15,12267,Capital Call,-51226,-1245867,0,-1245867
77772,2020-05-31,12267,Value,633500,-1245867,0,-1245867
77772,2020-07-16,12267,Capital Call,-50313,-1296180,0,-1296180
77772,2020-08-31,12267,Value,669130,-1296180,0,-1296180
77772,2020-10-16,12267,Capital Call,-1011016,-2307196,0,-2307196
77772,2020-11-30,12267,Value,1548700,-2307196,0,-2307196
77772,2021-01-14,12267,Capital Call,-341800,-2648996,0,-2648996
77772,2021-02-28,12267,Value,1276480,-2648996,0,-2648996
77772,2021-04-15,12267,Capital Call,-208365,-2857361,0,-2857361
77772,2021-05-31,12267,Value,2060020,-2857361,0,-2857361
77772,2021-07-16,12267,Capital Call,-649416,-3506777,0,-3506777
77772,2021-08-31,12267,Value,2779390,-3506777,0,-3506777
77772,2021-10-16,12267,Capital Call,-690192,-4196969,0,-4196969
77772,2021-11-30,12267,Value,3778500,-4196969,0,-4196969
77845,2020-03-31,1357,Value,3118080,-3113495,0,-3113495
77845,2020-05-16,1357,Capital Call,-1000000,-4113495,0,-4113495
77845,2020-06-30,1357,Value,4148570,-4113495,0,-4113495
77845,2020-08-15,1357,Capital Call,-500000,-4613495,0,-4613495
77845,2020-09-30,1357,Value,4584770,-4613495,0,-4613495
78038,2020-03-31,59150,Value,5368770,-4629853,0,-4629853
78038,2020-05-16,59150,Capital Call,-753693,-5383546,0,-5383546
78038,2020-06-30,59150,Value,4757850,-5383546,0,-5383546
78038,2020-09-30,59150,Value,5235760,-5383546,0,-5383546
78038,2020-11-15,59150,Capital Call,-183169,-5566715,0,-5566715
78038,2020-11-15,59150,Distribution,56840,-5566715,56840,-5509875
78038,2020-12-31,59150,Value,5362090,-5566715,56840,-5509875
78038,2021-02-14,59150,Capital Call,-36383,-5603098,56840,-5546258
78038,2021-02-14,59150,Distribution,770274,-5603098,827114,-4775984
78038,2021-03-31,59150,Value,5737570,-5603098,827114,-4775984
78038,2021-06-30,59150,Value,6872330,-5603098,827114,-4775984
78039,2020-03-31,1632,Value,5125720,-5073742,0,-5073742
78039,2020-05-16,1632,Capital Call,-1014503,-6088245,0,-6088245
78039,2020-06-30,1632,Value,6038900,-6088245,0,-6088245
78039,2020-09-30,1632,Value,7195850,-6088245,0,-6088245
78039,2020-11-15,1632,Capital Call,-1881639,-7969884,0,-7969884
78039,2020-11-15,1632,Distribution,130595,-7969884,130595,-7839289
78039,2020-12-31,1632,Value,9698080,-7969884,130595,-7839289
78039,2021-03-31,1632,Value,11988550,-7969884,130595,-7839289
78095,2020-03-31,114,Value,4380580,-4306170,0,-4306170
78095,2020-05-16,114,Capital Call,-825662,-5131832,0,-5131832
78095,2020-06-30,114,Value,5112430,-5131832,0,-5131832
78095,2020-09-30,114,Value,4979670,-5131832,0,-5131832
78095,2020-12-31,114,Value,4975610,-5131832,0,-5131832
78095,2021-02-14,114,Capital Call,-1004348,-6136180,0,-6136180
78095,2021-03-31,114,Value,6387600,-6136180,0,-6136180
78095,2021-06-30,114,Value,7073160,-6136180,0,-6136180
78098,2020-03-31,22829,Capital Call,-1603054,-3587787,0,-3587787
78098,2020-06-30,22829,Value,3639420,-3587787,0,-3587787
78098,2020-08-15,22829,Capital Call,-534351,-4122138,0,-4122138
78098,2020-09-30,22829,Value,4846700,-4122138,0,-4122138
78098,2020-11-15,22829,Capital Call,-1603053,-5725191,0,-5725191
78098,2020-12-31,22829,Value,7844930,-5725191,0,-5725191
78098,2021-02-14,22829,Capital Call,-1068702,-6793893,0,-6793893
78098,2021-03-31,22829,Value,9220770,-6793893,0,-6793893
78100,2020-05-16,22829,Capital Call,-1565218,-4161942,0,-4161942
78100,2020-09-30,22829,Value,4683480,-4161942,0,-4161942
78100,2020-11-15,22829,Capital Call,-1055900,-5217842,0,-5217842
78100,2020-12-31,22829,Value,6385320,-5217842,0,-5217842
78100,2021-02-14,22829,Capital Call,-993789,-6211631,0,-6211631
78100,2021-03-31,22829,Value,8344940,-6211631,0,-6211631
78143,2020-02-15,9110,Capital Call,-669747,-10319747,1430132,-8889615
78143,2020-02-15,9110,Distribution,818366,-10319747,2248498,-8071249
78143,2020-03-31,9110,Value,10009930,-10319747,2248498,-8071249
78143,2020-05-16,9110,Capital Call,-170253,-10490000,2248498,-8241502
78143,2020-05-16,9110,Distribution,560,-10490000,2249058,-8240942
78143,2020-06-30,9110,Value,10555030,-10490000,2249058,-8240942
78143,2020-08-15,9110,Capital Call,-244000,-10734000,2249058,-8484942
78143,2020-08-15,9110,Distribution,95250,-10734000,2344308,-8389692
78143,2020-09-30,9110,Value,11624920,-10734000,2344308,-8389692
78143,2020-12-31,9110,Value,13277950,-10734000,2344308,-8389692
78143,2021-02-14,9110,Capital Call,-745000,-11479000,2344308,-9134692
78143,2021-02-14,9110,Distribution,570213,-11479000,2914521,-8564479
78143,2021-03-31,9110,Value,14523230,-11479000,2914521,-8564479
78143,2021-06-30,9110,Value,15688340,-11479000,2914521,-8564479
78143,2021-08-15,9110,Capital Call,-338000,-11817000,2914521,-8902479
78143,2021-08-15,9110,Distribution,807837,-11817000,3722358,-8094642
78143,2021-09-30,9110,Value,15178930,-11817000,3722358,-8094642
78243,2020-02-15,138612,Capital Call,-150718,-3824977,0,-3824977
78243,2020-03-31,138612,Value,4099210,-3824977,0,-3824977
78243,2020-09-30,138612,Value,4530430,-3824977,0,-3824977
78243,2020-11-15,138612,Capital Call,-149928,-3974905,0,-3974905
78243,2020-12-31,138612,Value,5566380,-3974905,0,-3974905
78243,2021-02-14,138612,Capital Call,-141031,-4115936,0,-4115936
78243,2021-03-31,138612,Value,5668000,-4115936,0,-4115936
78243,2021-06-30,138612,Value,7320420,-4115936,0,-4115936
78340,2020-03-31,6904,Value,4629410,-4949564,0,-4949564
78340,2020-06-30,6904,Value,3549640,-4949564,0,-4949564
78340,2020-09-30,6904,Value,3501660,-4949564,0,-4949564
78340,2020-12-31,6904,Value,3454420,-4949564,0,-4949564
78340,2021-02-14,6904,Capital Call,-1147132,-6096696,0,-6096696
78340,2021-03-31,6904,Value,4567560,-6096696,0,-6096696
78340,2021-06-30,6904,Value,4964860,-6096696,0,-6096696
78340,2021-08-15,6904,Capital Call,-997506,-7094202,0,-7094202
78340,2021-09-30,6904,Value,5962360,-7094202,0,-7094202
78359,2020-02-15,11548,Capital Call,-293847,-867106,0,-867106
78359,2020-03-31,11548,Value,655080,-867106,0,-867106
78359,2020-05-16,11548,Capital Call,-569625,-1436731,0,-1436731
78359,2020-06-30,11548,Value,1321000,-1436731,0,-1436731
78359,2020-08-15,11548,Capital Call,-320549,-1757280,0,-1757280
78359,2020-09-30,11548,Value,1683990,-1757280,0,-1757280
78359,2020-11-15,11548,Capital Call,-400112,-2157392,0,-2157392
78359,2020-12-31,11548,Value,2501330,-2157392,0,-2157392
78359,2021-02-14,11548,Capital Call,-601819,-2759211,0,-2759211
78359,2021-03-31,11548,Value,3131100,-2759211,0,-2759211
78359,2021-05-16,11548,Capital Call,-1023436,-3782647,0,-3782647
78359,2021-05-16,11548,Distribution,28509,-3782647,28509,-3754138
78359,2021-06-30,11548,Value,4518600,-3782647,28509,-3754138
78359,2021-08-15,11548,Capital Call,-693336,-4475983,28509,-4447474
78359,2021-09-30,11548,Value,5449640,-4475983,28509,-4447474
78469,2020-03-31,2225,Capital Call,-600000,-5650000,0,-5650000
78469,2020-03-31,2225,Distribution,252081,-5650000,252081,-5397919
78469,2020-06-30,2225,Value,5946330,-5650000,252081,-5397919
78469,2020-08-15,2225,Capital Call,-900000,-6550000,252081,-6297919
78469,2020-09-30,2225,Value,7294740,-6550000,252081,-6297919
78469,2020-11-15,2225,Capital Call,-400000,-6950000,252081,-6697919
78469,2020-12-31,2225,Value,7774910,-6950000,252081,-6697919
78469,2021-02-14,2225,Capital Call,-1100000,-8050000,252081,-7797919
78469,2021-03-31,2225,Value,9416110,-8050000,252081,-7797919
78471,2020-02-15,8396,Capital Call,-615000,-3181000,425956,-2755044
78471,2020-02-15,8396,Distribution,15249,-3181000,441205,-2739795
78471,2020-03-31,8396,Value,2304630,-3181000,441205,-2739795
78471,2020-05-16,8396,Capital Call,-1000,-3182000,441205,-2740795
78471,2020-05-16,8396,Distribution,-180,-3182000,441025,-2740975
78471,2020-06-30,8396,Value,2516640,-3182000,441025,-2740975
78471,2020-08-15,8396,Capital Call,-1709000,-4891000,441025,-4449975
78471,2020-08-15,8396,Distribution,515654,-4891000,956679,-3934321
78471,2020-09-30,8396,Value,4115770,-4891000,956679,-3934321
78471,2020-11-15,8396,Capital Call,-1060000,-5951000,956679,-4994321
78471,2020-11-15,8396,Distribution,241,-5951000,956920,-4994080
78471,2020-12-31,8396,Value,5688560,-5951000,956920,-4994080
78471,2021-03-31,8396,Value,5748660,-5951000,956920,-4994080
78471,2021-05-16,8396,Capital Call,-332000,-6283000,956920,-5326080
78471,2021-05-16,8396,Distribution,-20,-6283000,956900,-5326100
78471,2021-06-30,8396,Value,6641750,-6283000,956900,-5326100
78471,2021-08-15,8396,Capital Call,-994000,-7277000,956900,-6320100
78471,2021-08-15,8396,Distribution,344227,-7277000,1301127,-5975873
78471,2021-09-30,8396,Value,7766010,-7277000,1301127,-5975873
78484,2020-06-30,232891,Capital Call,-10000000,-10000000,0,-10000000
78484,2020-06-30,232891,Distribution,15060000,-10000000,15060000,5060000
78484,2020-06-30,232891,Value,16930000,-10000000,15060000,5060000
78564,2020-03-31,28,Capital Call,-1409000,-7014000,846355,-6167645
78564,2020-03-31,28,Distribution,815262,-7014000,1661617,-5352383
78564,2020-09-30,28,Value,5795660,-7014000,1661617,-5352383
78564,2021-02-14,28,Capital Call,14000,-7000000,1661617,-5338383
78564,2021-02-14,28,Distribution,18383,-7000000,1680000,-5320000
78564,2021-06-30,28,Value,7840000,-7000000,1680000,-5320000
78683,2020-06-30,26289,Value,3315240,-3500000,0,-3500000
78712,2020-06-30,664,Value,4687730,-3595126,0,-3595126
78712,2020-12-30,664,Capital Call,-2615424,-6210550,0,-6210550
78712,2020-12-30,664,Distribution,315966,-6210550,315966,-5894584
78712,2021-06-30,664,Value,12583220,-6210550,315966,-5894584
78744,2020-05-16,344,Capital Call,-3167382,-8855883,27237,-8828646
78744,2020-09-30,344,Value,9811110,-8855883,27237,-8828646
78744,2020-11-15,344,Capital Call,0,-8855883,27237,-8828646
78744,2020-12-31,344,Value,10308810,-8855883,27237,-8828646
78744,2021-03-31,344,Value,11069300,-8855883,27237,-8828646
79045,2020-02-15,906,Capital Call,-400000,-6950000,0,-6950000
79045,2020-03-31,906,Value,7907850,-6950000,0,-6950000
79045,2020-05-16,906,Capital Call,-600000,-7550000,0,-7550000
79045,2020-06-30,906,Value,8442890,-7550000,0,-7550000
79045,2020-08-15,906,Capital Call,-300000,-7850000,0,-7850000
79045,2020-09-30,906,Value,8932130,-7850000,0,-7850000
79045,2020-11-15,906,Capital Call,-600000,-8450000,0,-8450000
79045,2020-12-31,906,Value,10657400,-8450000,0,-8450000
79045,2021-02-14,906,Capital Call,-400000,-8850000,0,-8850000
79045,2021-03-31,906,Value,12560650,-8850000,0,-8850000
79046,2020-02-15,12055,Capital Call,-1232000,-2971000,0,-2971000
79046,2020-03-31,12055,Value,3361980,-2971000,0,-2971000
79046,2020-05-16,12055,Capital Call,-63000,-3034000,0,-3034000
79046,2020-06-30,12055,Value,3973020,-3034000,0,-3034000
79046,2020-08-15,12055,Capital Call,-227000,-3261000,0,-3261000
79046,2020-09-30,12055,Value,3803630,-3261000,0,-3261000
79046,2020-11-15,12055,Capital Call,-678000,-3939000,0,-3939000
79046,2020-12-31,12055,Value,4353770,-3939000,0,-3939000
79165,2020-02-15,1886,Capital Call,-350000,-4250000,200000,-4050000
79165,2020-03-31,1886,Value,4074330,-4250000,200000,-4050000
79165,2020-05-16,1886,Capital Call,-700000,-4950000,200000,-4750000
79165,2020-06-30,1886,Value,4994310,-4950000,200000,-4750000
79165,2020-08-15,1886,Capital Call,-650000,-5600000,200000,-5400000
79165,2020-09-30,1886,Value,5965110,-5600000,200000,-5400000
79165,2020-11-15,1886,Capital Call,-449995,-6049995,200000,-5849995
79165,2020-11-15,1886,Distribution,-1,-6049995,199999,-5849996
79165,2020-12-31,1886,Value,6896080,-6049995,199999,-5849996
79165,2021-02-14,1886,Capital Call,-700005,-6750000,199999,-6550001
79165,2021-02-14,1886,Distribution,1,-6750000,200000,-6550000
79165,2021-03-31,1886,Value,7952580,-6750000,200000,-6550000
79165,2021-05-16,1886,Capital Call,-349994,-7099994,200000,-6899994
79165,2021-05-16,1886,Distribution,0,-7099994,200000,-6899994
79165,2021-06-30,1886,Value,9064640,-7099994,200000,-6899994
79165,2021-08-15,1886,Capital Call,-6,-7100000,200000,-6900000
79165,2021-08-15,1886,Distribution,0,-7100000,200000,-6900000
79165,2021-09-30,1886,Value,9946930,-7100000,200000,-6900000
79219,2020-03-31,733,Value,2685680,-3035974,97081,-2938893
79219,2020-05-16,733,Capital Call,-79145,-3115119,97081,-3018038
79219,2020-06-30,733,Value,2891820,-3115119,97081,-3018038
79219,2020-08-15,733,Capital Call,-399003,-3514122,97081,-3417041
79219,2020-08-15,733,Distribution,69265,-3514122,166346,-3347776
79219,2020-09-30,733,Value,3405560,-3514122,166346,-3347776
79219,2020-11-15,733,Capital Call,-423940,-3938062,166346,-3771716
79219,2020-11-15,733,Distribution,141171,-3938062,307517,-3630545
79219,2020-12-31,733,Value,3683860,-3938062,307517,-3630545
79219,2021-02-14,733,Capital Call,-435455,-4373517,307517,-4066000
79219,2021-03-31,733,Value,4254390,-4373517,307517,-4066000
79219,2021-05-16,733,Capital Call,1457917,-2915600,307517,-2608083
79219,2021-05-16,733,Distribution,-102550,-2915600,204967,-2710633
79219,2021-06-30,733,Value,3399000,-2915600,204967,-2710633
79219,2021-08-15,733,Capital Call,-4583437,-7499037,204967,-7294070
79219,2021-08-15,733,Distribution,616380,-7499037,821347,-6677690
79219,2021-09-30,733,Value,8499040,-7499037,821347,-6677690
79256,2020-03-31,9225,Value,3995370,-5060000,0,-5060000
79256,2020-05-16,9225,Capital Call,-930000,-5990000,0,-5990000
79256,2020-06-30,9225,Value,7610890,-5990000,0,-5990000
79256,2020-09-30,9225,Value,7984070,-5990000,0,-5990000
79256,2020-11-15,9225,Capital Call,-840000,-6830000,0,-6830000
79256,2020-11-15,9225,Distribution,170067,-6830000,170067,-6659933
79256,2020-12-31,9225,Value,8874900,-6830000,170067,-6659933
79256,2021-03-31,9225,Value,15657090,-6830000,170067,-6659933
79256,2021-05-16,9225,Capital Call,-530000,-7360000,170067,-7189933
79256,2021-05-16,9225,Distribution,-51,-7360000,170016,-7189984
79256,2021-06-30,9225,Value,16058040,-7360000,170016,-7189984
79256,2021-09-30,9225,Value,16560000,-7360000,170016,-7189984
79300,2020-02-15,11324,Capital Call,-72512,-2524061,7239,-2516822
79300,2020-02-15,11324,Distribution,461,-2524061,7700,-2516361
79300,2020-03-31,11324,Value,2454860,-2524061,7700,-2516361
79300,2020-05-16,11324,Capital Call,-131,-2524192,7700,-2516492
79300,2020-05-16,11324,Distribution,14465,-2524192,22165,-2502027
79300,2020-06-30,11324,Value,2507290,-2524192,22165,-2502027
79300,2020-08-15,11324,Capital Call,-980250,-3504442,22165,-3482277
79300,2020-08-15,11324,Distribution,1147,-3504442,23312,-3481130
79300,2020-09-30,11324,Value,3486390,-3504442,23312,-3481130
79300,2020-11-15,11324,Capital Call,-1376294,-4880736,23312,-4857424
79300,2020-12-31,11324,Value,5043660,-4880736,23312,-4857424
79300,2021-02-14,11324,Capital Call,-1186310,-6067046,23312,-6043734
79300,2021-03-31,11324,Value,6229970,-6067046,23312,-6043734
79338,2020-02-15,355,Capital Call,-350000,-4904449,695775,-4208674
79338,2020-03-31,355,Value,4689470,-4904449,695775,-4208674
79338,2020-05-16,355,Capital Call,-600000,-5504449,695775,-4808674
79338,2020-06-30,355,Value,5865900,-5504449,695775,-4808674
79338,2020-09-30,355,Value,6764170,-5504449,695775,-4808674
79338,2020-11-15,355,Capital Call,-300000,-5804449,695775,-5108674
79338,2020-11-15,355,Distribution,300000,-5804449,995775,-4808674
79338,2020-12-31,355,Value,6739170,-5804449,995775,-4808674
79338,2021-02-14,355,Capital Call,-250000,-6054449,995775,-5058674
79338,2021-02-14,355,Distribution,523221,-6054449,1518996,-4535453
79338,2021-03-31,355,Value,8624340,-6054449,1518996,-4535453
79338,2021-05-16,355,Capital Call,-95551,-6150000,1518996,-4631004
79338,2021-05-16,355,Distribution,57648,-6150000,1576644,-4573356
79338,2021-06-30,355,Value,9925210,-6150000,1576644,-4573356
79349,2020-02-15,355,Capital Call,-1000000,-2500000,0,-2500000
79349,2020-03-31,355,Value,2368630,-2500000,0,-2500000
79349,2020-05-16,355,Capital Call,-1000000,-3500000,0,-3500000
79349,2020-06-30,355,Value,3182710,-3500000,0,-3500000
79349,2020-08-15,355,Capital Call,-1000000,-4500000,0,-4500000
79349,2020-09-30,355,Value,5076790,-4500000,0,-4500000
79349,2020-11-15,355,Capital Call,-1500000,-6000000,0,-6000000
79349,2020-12-31,355,Value,7979280,-6000000,0,-6000000
79349,2021-02-14,355,Capital Call,-1000000,-7000000,0,-7000000
79349,2021-03-31,355,Value,8979280,-7000000,0,-7000000
79369,2020-02-15,1632,Capital Call,-2474000,-5978000,0,-5978000
79369,2020-03-31,1632,Value,6388680,-5978000,0,-5978000
79369,2020-05-16,1632,Capital Call,-1096000,-7074000,0,-7074000
79369,2020-06-30,1632,Value,10794210,-7074000,0,-7074000
79369,2020-08-15,1632,Capital Call,24608,-7049392,0,-7049392
79369,2020-08-15,1632,Distribution,4670222,-7049392,4670222,-2379170
79369,2020-09-30,1632,Value,8395120,-7049392,4670222,-2379170
79369,2020-11-15,1632,Capital Call,-947608,-7997000,4670222,-3326778
79369,2020-11-15,1632,Distribution,479846,-7997000,5150068,-2846932
79369,2020-12-31,1632,Value,9570800,-7997000,5150068,-2846932
79369,2021-02-14,1632,Capital Call,-1768000,-9765000,5150068,-4614932
79369,2021-02-14,1632,Distribution,-7,-9765000,5150061,-4614939
79369,2021-03-31,1632,Value,11857630,-9765000,5150061,-4614939
79369,2021-06-30,1632,Value,12457210,-9765000,5150061,-4614939
79369,2021-08-15,1632,Capital Call,-1072000,-10837000,5150061,-5686939
79369,2021-08-15,1632,Distribution,-319,-10837000,5149742,-5687258
79369,2021-09-30,1632,Value,14303750,-10837000,5149742,-5687258
79370,2020-02-15,13569,Capital Call,814000,-2186000,0,-2186000
79370,2020-02-15,13569,Distribution,90500,-2186000,90500,-2095500
79370,2020-03-31,13569,Value,1788140,-2186000,90500,-2095500
79370,2020-05-16,13569,Capital Call,-664000,-2850000,90500,-2759500
79370,2020-05-16,13569,Distribution,22075,-2850000,112575,-2737425
79370,2020-06-30,13569,Value,2468670,-2850000,112575,-2737425
79370,2020-08-15,13569,Distribution,94050,-2850000,206625,-2643375
79370,2020-09-30,13569,Value,2460400,-2850000,206625,-2643375
79370,2020-11-15,13569,Distribution,110580,-2850000,317205,-2532795
79370,2020-12-31,13569,Value,2454130,-2850000,317205,-2532795
79370,2021-02-14,13569,Distribution,74955,-2850000,392160,-2457840
79370,2021-03-31,13569,Value,3105640,-2850000,392160,-2457840
79370,2021-05-16,13569,Capital Call,-2184000,-5034000,392160,-4641840
79370,2021-05-16,13569,Distribution,479729,-5034000,871889,-4162111
79370,2021-06-30,13569,Value,5098930,-5034000,871889,-4162111
79370,2021-08-15,13569,Distribution,96653,-5034000,968542,-4065458
79370,2021-09-30,13569,Value,5326970,-5034000,968542,-4065458
79370,2021-11-15,13569,Capital Call,-1109000,-6143000,968542,-5174458
79370,2021-11-15,13569,Distribution,827057,-6143000,1795599,-4347401
79370,2021-12-31,13569,Value,5870860,-6143000,1795599,-4347401
79486,2020-02-15,355,Capital Call,-930000,-3270000,0,-3270000
79486,2020-02-15,355,Distribution,39174,-3270000,39174,-3230826
79486,2020-03-31,355,Value,3217020,-3270000,39174,-3230826
79486,2020-05-16,355,Capital Call,-400356,-3670356,39174,-3631182
79486,2020-05-16,355,Distribution,-380,-3670356,38794,-3631562
79486,2020-06-30,355,Value,4228970,-3670356,38794,-3631562
79486,2020-09-30,355,Capital Call,-1749661,-5420017,38794,-5381223
79486,2020-09-30,355,Distribution,92179,-5420017,130973,-5289044
79486,2020-12-31,355,Value,6865990,-5420017,130973,-5289044
79486,2021-02-14,355,Distribution,84411,-5420017,215384,-5204633
79486,2021-03-31,355,Value,7428960,-5420017,215384,-5204633
79486,2021-05-16,355,Capital Call,-400000,-5820017,215384,-5604633
79486,2021-05-16,355,Distribution,295916,-5820017,511300,-5308717
79486,2021-06-30,355,Value,8564850,-5820017,511300,-5308717
79496,2020-02-15,939,Capital Call,-12544,-1255401,0,-1255401
79496,2020-02-15,939,Distribution,12544,-1255401,12544,-1242857
79496,2020-03-31,939,Value,1154000,-1255401,12544,-1242857
79496,2020-05-16,939,Capital Call,-1272125,-2527526,12544,-2514982
79496,2020-06-30,939,Value,2670380,-2527526,12544,-2514982
79496,2020-08-15,939,Capital Call,-4181,-2531707,12544,-2519163
79496,2020-08-15,939,Distribution,4181,-2531707,16725,-2514982
79496,2020-09-30,939,Value,3055050,-2531707,16725,-2514982
79496,2020-11-15,939,Capital Call,-1045,-2532752,16725,-2516027
79496,2020-11-15,939,Distribution,1045,-2532752,17770,-2514982
79496,2020-12-31,939,Value,4016020,-2532752,17770,-2514982
79496,2021-02-14,939,Capital Call,-265505,-2798257,17770,-2780487
79496,2021-02-14,939,Distribution,1455052,-2798257,1472822,-1325435
79496,2021-03-31,939,Value,3185360,-2798257,1472822,-1325435
79496,2021-06-30,939,Value,3838320,-2798257,1472822,-1325435
79505,2020-02-15,2317,Capital Call,-1860000,-3660000,16200,-3643800
79505,2020-02-15,2317,Distribution,-16200,-3660000,0,-3660000
79505,2020-03-31,2317,Value,2748660,-3660000,0,-3660000
79505,2020-05-16,2317,Capital Call,-130000,-3790000,0,-3790000
79505,2020-06-30,2317,Value,2986520,-3790000,0,-3790000
79505,2020-09-30,2317,Value,3558810,-3790000,0,-3790000
79505,2020-11-15,2317,Capital Call,-1150000,-4940000,0,-4940000
79505,2020-12-31,2317,Value,5458700,-4940000,0,-4940000
79505,2021-02-14,2317,Capital Call,-2130000,-7070000,0,-7070000
79505,2021-02-14,2317,Distribution,14140,-7070000,14140,-7055860
79505,2021-03-31,2317,Value,8830430,-7070000,14140,-7055860
79506,2020-02-15,2317,Capital Call,-100000,-990000,0,-990000
79506,2020-03-31,2317,Value,886050,-990000,0,-990000
79506,2020-06-30,2317,Value,770220,-990000,0,-990000
79506,2020-09-30,2317,Value,722700,-990000,0,-990000
79506,2020-11-15,2317,Capital Call,-960000,-1950000,0,-1950000
79506,2020-11-15,2317,Distribution,7800,-1950000,7800,-1942200
79506,2020-12-31,2317,Value,1622400,-1950000,7800,-1942200
79506,2021-02-14,2317,Capital Call,-1330000,-3280000,7800,-3272200
79506,2021-02-14,2317,Distribution,-1240,-3280000,6560,-3273440
79506,2021-03-31,2317,Value,3152080,-3280000,6560,-3273440
79516,2020-06-30,253,Capital Call,-3000000,-3000000,0,-3000000
79516,2020-06-30,253,Value,3439530,-3000000,0,-3000000
79516,2020-09-30,253,Value,3513260,-3000000,0,-3000000
79516,2020-12-31,253,Value,3513260,-3000000,0,-3000000
79516,2021-03-31,253,Value,5654390,-3000000,0,-3000000
79726,2020-02-15,7,Capital Call,-198916,-2604948,0,-2604948
79726,2020-02-15,7,Distribution,1199,-2604948,1199,-2603749
79726,2020-03-31,7,Value,2873950,-2604948,1199,-2603749
79726,2020-05-16,7,Capital Call,-196475,-2801423,1199,-2800224
79726,2020-05-16,7,Distribution,-12,-2801423,1187,-2800236
79726,2020-06-30,7,Value,3354360,-2801423,1187,-2800236
79726,2020-08-15,7,Capital Call,-850715,-3652138,1187,-3650951
79726,2020-08-15,7,Distribution,898813,-3652138,900000,-2752138
79726,2020-09-30,7,Value,3569670,-3652138,900000,-2752138
79748,2020-02-15,171709,Capital Call,-15311,-5848501,0,-5848501
79748,2020-03-31,171709,Value,5683710,-5848501,0,-5848501
79822,2020-06-30,664,Value,8829990,-6824999,0,-6824999
79822,2020-12-30,664,Capital Call,-1999998,-8824997,0,-8824997
79822,2021-06-30,664,Value,13238670,-8824997,0,-8824997
79900,2020-03-31,216500,Value,2580000,-3440000,0,-3440000
79900,2020-05-16,216500,Capital Call,-410000,-3850000,0,-3850000
79900,2020-06-30,216500,Value,3080000,-3850000,0,-3850000
79900,2020-08-15,216500,Capital Call,-2170000,-6020000,0,-6020000
79900,2020-09-30,216500,Value,5117000,-6020000,0,-6020000
79900,2020-12-31,216500,Value,5779200,-6020000,0,-6020000
79900,2021-03-31,216500,Value,6321000,-6020000,0,-6020000
79900,2021-06-30,216500,Value,6862800,-6020000,0,-6020000
79900,2021-09-30,216500,Value,8066800,-6020000,0,-6020000
79900,2021-11-15,216500,Capital Call,-2035000,-8055000,0,-8055000
79900,2021-12-31,216500,Value,11599200,-8055000,0,-8055000
79901,2020-03-31,65417,Value,4000000,-5000000,0,-5000000
79901,2020-06-30,65417,Value,4000000,-5000000,0,-5000000
79901,2020-09-30,65417,Capital Call,-2605615,-7605615,0,-7605615
79901,2020-12-31,65417,Value,6182280,-7605615,0,-7605615
80246,2020-02-15,16154,Capital Call,-191000,-900000,0,-900000
80246,2020-03-31,16154,Value,684000,-900000,0,-900000
80246,2020-06-30,16154,Value,540000,-900000,0,-900000
80246,2020-08-15,16154,Capital Call,-200000,-1100000,0,-1100000
80246,2020-09-30,16154,Value,671000,-1100000,0,-1100000
80246,2020-12-31,16154,Value,616000,-1100000,0,-1100000
80246,2021-02-14,16154,Capital Call,-1200000,-2300000,0,-2300000
80246,2021-03-31,16154,Value,1863000,-2300000,0,-2300000
80246,2021-05-16,16154,Capital Call,-800000,-3100000,0,-3100000
80246,2021-06-30,16154,Value,2573000,-3100000,0,-3100000
80246,2021-09-30,16154,Value,2573000,-3100000,0,-3100000
80246,2021-11-15,16154,Capital Call,-600000,-3700000,0,-3700000
80246,2021-12-31,16154,Value,3145000,-3700000,0,-3700000
80256,2020-02-15,558,Capital Call,-550000,-4360000,156444,-4203556
80256,2020-02-15,558,Distribution,2964667,-4360000,3121111,-1238889
80256,2020-03-31,558,Value,4986220,-4360000,3121111,-1238889
80256,2020-05-16,558,Capital Call,-850000,-5210000,3121111,-2088889
80256,2020-06-30,558,Value,7944660,-5210000,3121111,-2088889
80256,2020-08-15,558,Capital Call,-1200000,-6410000,3121111,-3288889
80256,2020-09-30,558,Value,7983330,-6410000,3121111,-3288889
80256,2020-11-15,558,Capital Call,-750000,-7160000,3121111,-4038889
80256,2020-12-31,558,Value,12460880,-7160000,3121111,-4038889
80256,2021-02-14,558,Capital Call,-700000,-7860000,3121111,-4738889
80256,2021-03-31,558,Value,12874220,-7860000,3121111,-4738889
80256,2021-06-30,558,Value,12758660,-7860000,3121111,-4738889
80259,2020-02-15,15805,Capital Call,-440000,-2590000,0,-2590000
80259,2020-03-31,15805,Value,2128980,-2590000,0,-2590000
80259,2020-05-16,15805,Capital Call,-737000,-3327000,0,-3327000
80259,2020-06-30,15805,Value,2281320,-3327000,0,-3327000
80259,2020-08-15,15805,Capital Call,-53000,-3380000,0,-3380000
80259,2020-09-30,15805,Value,2197000,-3380000,0,-3380000
80259,2020-11-15,15805,Capital Call,-49000,-3429000,0,-3429000
80259,2020-12-31,15805,Value,2484310,-3429000,0,-3429000
80259,2021-02-14,15805,Capital Call,-72000,-3501000,0,-3501000
80259,2021-03-31,15805,Value,2796940,-3501000,0,-3501000
80259,2021-05-16,15805,Capital Call,-1362000,-4863000,0,-4863000
80259,2021-06-30,15805,Value,4275060,-4863000,0,-4863000
80359,2020-02-28,81754,Capital Call,-750,-4834,0,-4834
80359,2020-09-07,81754,Capital Call,-1000,-5834,0,-5834
80359,2020-12-31,81754,Value,14850,-5834,0,-5834
80454,2020-03-31,88286,Value,4859000,-4300000,0,-4300000
80454,2020-05-16,88286,Capital Call,-700000,-5000000,0,-5000000
80454,2020-06-30,88286,Value,5550000,-5000000,0,-5000000
80454,2020-08-15,88286,Capital Call,-2200000,-7200000,0,-7200000
80454,2020-08-15,88286,Distribution,216000,-7200000,216000,-6984000
80454,2020-09-30,88286,Value,7488000,-7200000,216000,-6984000
80454,2020-11-15,88286,Capital Call,-1800000,-9000000,216000,-8784000
80454,2020-11-15,88286,Distribution,-36000,-9000000,180000,-8820000
80454,2020-12-31,88286,Value,10260000,-9000000,180000,-8820000
80454,2021-02-14,88286,Capital Call,43000,-8957000,180000,-8777000
80454,2021-02-14,88286,Distribution,38551,-8957000,218551,-8738449
80454,2021-03-31,88286,Value,11805320,-8957000,218551,-8738449
80454,2021-05-16,88286,Capital Call,668000,-8289000,218551,-8070449
80454,2021-05-16,88286,Distribution,-24588,-8289000,193963,-8095037
80454,2021-06-30,88286,Value,13285600,-8289000,193963,-8095037
80454,2021-08-15,88286,Capital Call,-436000,-8725000,193963,-8531037
80454,2021-08-15,88286,Distribution,4658882,-8725000,4852845,-3872155
80454,2021-09-30,88286,Value,9867970,-8725000,4852845,-3872155
80596,2020-06-30,11324,Capital Call,-3389000,-3389000,0,-3389000
80596,2020-06-30,11324,Value,3349680,-3389000,0,-3389000
80596,2020-08-15,11324,Capital Call,-9000,-3398000,0,-3398000
80596,2020-09-30,11324,Value,3354160,-3398000,0,-3398000
80596,2020-12-31,11324,Value,3386440,-3398000,0,-3398000
80596,2021-02-14,11324,Capital Call,-6000,-3404000,0,-3404000
80596,2021-03-31,11324,Value,3590870,-3404000,0,-3404000
80596,2021-06-30,11324,Value,3570110,-3404000,0,-3404000
80596,2021-08-15,11324,Capital Call,-4202000,-7606000,0,-7606000
80596,2021-09-30,11324,Value,7851670,-7606000,0,-7606000
80675,2020-03-31,93,Value,8111660,-7213000,0,-7213000
80675,2020-05-16,93,Capital Call,-525000,-7738000,0,-7738000
80675,2020-06-30,93,Value,8521220,-7738000,0,-7738000
80675,2020-08-15,93,Capital Call,-370000,-8108000,0,-8108000
80675,2020-09-30,93,Value,9017720,-8108000,0,-8108000
80675,2020-11-15,93,Capital Call,-100000,-8208000,0,-8208000
80675,2020-12-31,93,Value,11423810,-8208000,0,-8208000
80675,2021-02-14,93,Capital Call,-270000,-8478000,0,-8478000
80675,2021-03-31,93,Value,14507010,-8478000,0,-8478000
80675,2021-05-16,93,Capital Call,-215000,-8693000,0,-8693000
80675,2021-06-30,93,Value,17592970,-8693000,0,-8693000
80677,2020-03-31,93,Value,9318600,-7971000,0,-7971000
80677,2020-05-16,93,Capital Call,-110000,-8081000,0,-8081000
80677,2020-06-30,93,Value,9648170,-8081000,0,-8081000
80677,2020-08-15,93,Capital Call,-470000,-8551000,0,-8551000
80677,2020-09-30,93,Value,10391310,-8551000,0,-8551000
80677,2020-11-15,93,Capital Call,-100000,-8651000,0,-8651000
80677,2020-12-31,93,Value,14673310,-8651000,0,-8651000
80677,2021-02-14,93,Capital Call,-200000,-8851000,0,-8851000
80677,2021-03-31,93,Value,17726870,-8851000,0,-8851000
80677,2021-05-16,93,Capital Call,-200000,-9051000,0,-9051000
80677,2021-06-30,93,Value,22808020,-9051000,0,-9051000
80679,2020-01-15,171187,Capital Call,-700000,-5810000,0,-5810000
80679,2020-02-29,171187,Value,7259930,-5810000,0,-5810000
80679,2020-04-15,171187,Capital Call,-1130000,-6940000,0,-6940000
80679,2020-05-31,171187,Value,9033300,-6940000,0,-6940000
80679,2020-07-16,171187,Capital Call,-140000,-7080000,0,-7080000
80679,2020-08-31,171187,Value,8427200,-7080000,0,-7080000
80679,2020-10-16,171187,Capital Call,-430000,-7510000,0,-7510000
80679,2020-11-30,171187,Value,10693480,-7510000,0,-7510000
80679,2021-01-14,171187,Capital Call,-640000,-8150000,0,-8150000
80679,2021-02-28,171187,Value,13466920,-8150000,0,-8150000
80679,2021-04-15,171187,Capital Call,-1010000,-9160000,0,-9160000
80679,2021-05-31,171187,Value,18827210,-9160000,0,-9160000
80679,2021-08-31,171187,Value,25331870,-9160000,0,-9160000
80679,2021-11-30,171187,Value,30796850,-9160000,0,-9160000
80745,2020-02-15,29836,Capital Call,-883816,-3593708,0,-3593708
80745,2020-03-31,29836,Value,3298810,-3593708,0,-3593708
80745,2020-05-16,29836,Capital Call,-663194,-4256902,0,-4256902
80745,2020-06-30,29836,Value,4362800,-4256902,0,-4256902
80745,2020-09-30,29836,Value,4623520,-4256902,0,-4256902
80947,2020-02-15,219123,Capital Call,-214124,-3650805,551,-3650254
80947,2020-02-15,219123,Distribution,20925,-3650805,21476,-3629329
80947,2020-03-31,219123,Value,3613950,-3650805,21476,-3629329
80947,2020-05-16,219123,Capital Call,-384001,-4034806,21476,-4013330
80947,2020-06-30,219123,Value,3895890,-4034806,21476,-4013330
80947,2020-08-15,219123,Capital Call,-465108,-4499914,21476,-4478438
80947,2020-09-30,219123,Value,4713970,-4499914,21476,-4478438
80947,2020-11-15,219123,Capital Call,-1050962,-5550876,21476,-5529400
80947,2020-12-31,219123,Value,6507620,-5550876,21476,-5529400
80947,2021-02-14,219123,Capital Call,-649570,-6200446,21476,-6178970
80947,2021-03-31,219123,Value,7157190,-6200446,21476,-6178970
81057,2020-02-15,161262,Capital Call,-675609,-3109407,0,-3109407
81057,2020-03-31,161262,Value,2753440,-3109407,0,-3109407
81057,2020-05-16,161262,Capital Call,-195798,-3305205,0,-3305205
81057,2020-06-30,161262,Value,2836820,-3305205,0,-3305205
81057,2020-08-15,161262,Capital Call,-463190,-3768395,0,-3768395
81057,2020-09-30,161262,Value,3182330,-3768395,0,-3768395
81057,2020-12-31,161262,Value,3570830,-3768395,0,-3768395
81057,2021-02-14,161262,Capital Call,-173840,-3942235,0,-3942235
81057,2021-03-31,161262,Value,3869090,-3942235,0,-3942235
81057,2021-05-16,161262,Capital Call,-1433155,-5375390,0,-5375390
81057,2021-06-30,161262,Value,6949660,-5375390,0,-5375390
81059,2020-03-31,9067,Value,1776020,-2893199,0,-2893199
81059,2020-05-16,9067,Capital Call,-2227250,-5120449,0,-5120449
81059,2020-05-16,9067,Distribution,345235,-5120449,345235,-4775214
81059,2020-06-30,9067,Value,6334440,-5120449,345235,-4775214
81059,2020-08-15,9067,Distribution,345237,-5120449,690472,-4429977
81059,2020-09-30,9067,Value,7466410,-5120449,690472,-4429977
81059,2020-11-15,9067,Capital Call,-192944,-5313393,690472,-4622921
81059,2020-11-15,9067,Distribution,1188691,-5313393,1879163,-3434230
81059,2020-12-31,9067,Value,7137550,-5313393,1879163,-3434230
81059,2021-02-14,9067,Capital Call,-407063,-5720456,1879163,-3841293
81059,2021-02-14,9067,Distribution,1184763,-5720456,3063926,-2656530
81059,2021-03-31,9067,Value,8244970,-5720456,3063926,-2656530
81069,2020-06-30,264115,Value,1860250,-2635954,0,-2635954
81069,2020-11-14,264115,Capital Call,-1359922,-3995876,0,-3995876
81069,2021-03-31,264115,Value,4087730,-3995876,0,-3995876
81069,2021-05-16,264115,Capital Call,-156572,-4152448,0,-4152448
81069,2021-06-30,264115,Value,3889990,-4152448,0,-4152448
81166,2020-02-15,18,Capital Call,-500162,-2300162,0,-2300162
81166,2020-03-31,18,Value,2438110,-2300162,0,-2300162
81166,2020-05-16,18,Capital Call,-600042,-2900204,0,-2900204
81166,2020-06-30,18,Value,3221440,-2900204,0,-2900204
81166,2020-08-15,18,Capital Call,-600042,-3500246,0,-3500246
81166,2020-09-30,18,Value,4095830,-3500246,0,-3500246
81166,2020-11-15,18,Capital Call,-1300091,-4800337,0,-4800337
81166,2020-12-31,18,Value,6269650,-4800337,0,-4800337
81166,2021-02-14,18,Capital Call,-650046,-5450383,0,-5450383
81166,2021-03-31,18,Value,8195930,-5450383,0,-5450383
81166,2021-05-16,18,Capital Call,-600042,-6050425,0,-6050425
81166,2021-05-16,18,Distribution,220450,-6050425,220450,-5829975
81166,2021-06-30,18,Value,10804550,-6050425,220450,-5829975
81166,2021-08-15,18,Capital Call,-549574,-6599999,220450,-6379549
81166,2021-08-15,18,Distribution,-222,-6599999,220228,-6379771
81166,2021-09-30,18,Value,13636920,-6599999,220228,-6379771
81178,2020-02-15,174717,Capital Call,-400000,-8166871,0,-8166871
81178,2020-03-31,174717,Value,11024460,-8166871,0,-8166871
81178,2020-05-16,174717,Capital Call,-300000,-8466871,0,-8466871
81178,2020-06-30,174717,Value,11629700,-8466871,0,-8466871
81178,2020-08-15,174717,Capital Call,-498301,-8965172,0,-8965172
81178,2020-09-30,174717,Value,12676690,-8965172,0,-8965172
81178,2020-11-15,174717,Capital Call,-4060009,-13025181,0,-13025181
81178,2020-12-31,174717,Value,13025180,-13025181,0,-13025181
81206,2020-02-15,66301,Capital Call,-1661647,-4784353,217176,-4567177
81206,2020-02-15,66301,Distribution,130235,-4784353,347411,-4436942
81206,2020-03-31,66301,Value,5262580,-4784353,347411,-4436942
81206,2020-05-16,66301,Capital Call,-871647,-5656000,347411,-5308589
81206,2020-05-16,66301,Distribution,277412,-5656000,624823,-5031177
81206,2020-06-30,66301,Value,6362000,-5656000,624823,-5031177
81206,2020-08-15,66301,Capital Call,-4923059,-10579059,624823,-9954236
81206,2020-08-15,66301,Distribution,456941,-10579059,1081764,-9497295
81206,2020-09-30,66301,Value,13498820,-10579059,1081764,-9497295
81206,2020-11-15,66301,Capital Call,-170941,-10750000,1081764,-9668236
81206,2020-11-15,66301,Distribution,424588,-10750000,1506352,-9243648
81206,2020-12-31,66301,Value,15835410,-10750000,1506352,-9243648
81206,2021-02-14,66301,Capital Call,-111882,-10861882,1506352,-9355530
81206,2021-02-14,66301,Distribution,377294,-10861882,1883646,-8978236
81206,2021-03-31,66301,Value,15189880,-10861882,1883646,-8978236
81206,2021-05-16,66301,Capital Call,-55059,-10916941,1883646,-9033295
81206,2021-05-16,66301,Distribution,222235,-10916941,2105881,-8811060
81206,2021-06-30,66301,Value,14932700,-10916941,2105881,-8811060
81212,2020-02-15,16906,Capital Call,-819638,-2299638,0,-2299638
81212,2020-03-31,16906,Value,1724720,-2299638,0,-2299638
81212,2020-05-16,16906,Capital Call,-362,-2300000,0,-2300000
81212,2020-06-30,16906,Value,2507000,-2300000,0,-2300000
81212,2020-08-15,16906,Capital Call,-1070000,-3370000,0,-3370000
81212,2020-09-30,16906,Value,3033000,-3370000,0,-3370000
81212,2020-12-30,16906,Capital Call,-430000,-3800000,0,-3800000
81212,2021-03-31,16906,Value,3876000,-3800000,0,-3800000
81236,2020-03-31,436,Capital Call,-656235,-656235,0,-656235
81236,2020-03-31,436,Value,378720,-656235,0,-656235
81248,2020-03-31,17601,Value,4052200,-5002718,0,-5002718
81248,2020-06-30,17601,Value,4002170,-5002718,0,-5002718
81248,2020-09-30,17601,Capital Call,-1500815,-6503533,0,-6503533
81248,2020-12-31,17601,Value,5528000,-6503533,0,-6503533
81248,2021-02-14,17601,Capital Call,3533,-6500000,0,-6500000
81248,2021-03-31,17601,Value,5460000,-6500000,0,-6500000
81248,2021-06-30,17601,Value,5590000,-6500000,0,-6500000
81248,2021-08-15,17601,Capital Call,-1000000,-7500000,0,-7500000
81248,2021-09-30,17601,Value,6525000,-7500000,0,-7500000
81298,2020-02-15,741,Capital Call,-4296,-4140000,0,-4140000
81298,2020-03-31,741,Value,3320280,-4140000,0,-4140000
81298,2020-06-30,741,Value,4235220,-4140000,0,-4140000
81298,2020-09-30,741,Value,5448240,-4140000,0,-4140000
81298,2020-11-15,741,Capital Call,-1287223,-5427223,0,-5427223
81298,2020-12-31,741,Value,6629270,-5427223,0,-5427223
81298,2021-02-14,741,Capital Call,-1229777,-6657000,0,-6657000
81298,2021-02-14,741,Distribution,117829,-6657000,117829,-6539171
81298,2021-03-31,741,Value,8152820,-6657000,117829,-6539171
81298,2021-06-30,741,Value,9444280,-6657000,117829,-6539171
81298,2021-09-30,741,Value,9779130,-6657000,117829,-6539171
81353,2020-02-15,40167,Capital Call,-195000,-9561972,2522631,-7039341
81353,2020-03-31,40167,Value,8622270,-9561972,2522631,-7039341
81353,2020-05-16,40167,Capital Call,-30000,-9591972,2522631,-7069341
81353,2020-06-30,40167,Value,8139640,-9591972,2522631,-7069341
81353,2020-08-15,40167,Capital Call,-523274,-10115246,2522631,-7592615
81353,2020-08-15,40167,Distribution,2628001,-10115246,5150632,-4964614
81353,2020-09-30,40167,Value,6712390,-10115246,5150632,-4964614
81353,2020-11-15,40167,Capital Call,-112220,-10227466,5150632,-5076834
81353,2020-11-15,40167,Distribution,226847,-10227466,5377479,-4849987
81353,2020-12-31,40167,Value,8516620,-10227466,5377479,-4849987
81353,2021-02-14,40167,Capital Call,-351815,-10579281,5377479,-5201802
81353,2021-02-14,40167,Distribution,4,-10579281,5377483,-5201798
81353,2021-03-31,40167,Value,8868440,-10579281,5377483,-5201798
81429,2020-07-01,84936,Capital Call,-272000,-5830000,0,-5830000
81429,2020-07-01,84936,Distribution,354000,-5830000,354000,-5476000
81429,2020-12-31,84936,Value,3792000,-5830000,354000,-5476000
81521,2020-03-31,458,Distribution,189168,-708200,189168,-519032
81521,2020-06-30,458,Value,1135570,-708200,189168,-519032
81521,2020-08-15,458,Capital Call,-1008450,-1716650,189168,-1527482
81521,2020-08-15,458,Distribution,71389,-1716650,260557,-1456093
81521,2020-09-30,458,Value,1930920,-1716650,260557,-1456093
81521,2020-11-15,458,Capital Call,-798299,-2514949,260557,-2254392
81521,2020-11-15,458,Distribution,264589,-2514949,525146,-1989803
81521,2020-12-31,458,Value,2682560,-2514949,525146,-1989803
81521,2021-02-14,458,Capital Call,-978345,-3493294,525146,-2968148
81521,2021-02-14,458,Distribution,172131,-3493294,697277,-2796017
81521,2021-03-31,458,Value,3836770,-3493294,697277,-2796017
81521,2021-05-16,458,Capital Call,-244577,-3737871,697277,-3040594
81521,2021-05-16,458,Distribution,255291,-3737871,952568,-2785303
81521,2021-06-30,458,Value,4461370,-3737871,952568,-2785303
81521,2021-08-15,458,Capital Call,-1008403,-4746274,952568,-3793706
81521,2021-08-15,458,Distribution,120101,-4746274,1072669,-3673605
81521,2021-09-30,458,Value,6086330,-4746274,1072669,-3673605
81626,2020-09-30,56817,Value,9075000,-5500000,0,-5500000
81804,2020-02-15,461,Capital Call,-400000,-8000001,16133,-7983868
81804,2020-03-31,461,Value,8148660,-8000001,16133,-7983868
81804,2020-05-16,461,Capital Call,-200000,-8200001,16133,-8183868
81804,2020-06-30,461,Value,8511060,-8200001,16133,-8183868
81804,2020-08-15,461,Capital Call,-200000,-8400001,16133,-8383868
81804,2020-09-30,461,Value,9663060,-8400001,16133,-8383868
81804,2020-11-15,461,Capital Call,-700000,-9100001,16133,-9083868
81804,2020-12-31,461,Value,11456260,-9100001,16133,-9083868
81804,2021-03-31,461,Value,12624790,-9100001,16133,-9083868
81804,2021-05-16,461,Capital Call,-200000,-9300001,16133,-9283868
81804,2021-06-30,461,Value,15519330,-9300001,16133,-9283868
81805,2020-02-15,461,Capital Call,-1450000,-7150000,0,-7150000
81805,2020-03-31,461,Value,7369090,-7150000,0,-7150000
81805,2020-05-16,461,Capital Call,-250000,-7400000,0,-7400000
81805,2020-06-30,461,Value,7760000,-7400000,0,-7400000
81805,2020-08-15,461,Capital Call,-200000,-7600000,0,-7600000
81805,2020-09-30,461,Value,8423180,-7600000,0,-7600000
81805,2020-11-15,461,Capital Call,-400000,-8000000,0,-8000000
81805,2020-12-31,461,Value,9234090,-8000000,0,-8000000
81805,2021-02-14,461,Capital Call,-400000,-8400000,0,-8400000
81805,2021-03-31,461,Value,12182270,-8400000,0,-8400000
81805,2021-05-16,461,Capital Call,-500000,-8900000,0,-8900000
81805,2021-06-30,461,Value,14316810,-8900000,0,-8900000
82059,2020-06-30,361,Capital Call,-2206688,-2206688,0,-2206688
82059,2020-06-30,361,Value,2100670,-2206688,0,-2206688
82059,2020-08-15,361,Capital Call,-37312,-2244000,0,-2244000
82059,2020-09-30,361,Value,2453810,-2244000,0,-2244000
82059,2020-11-15,361,Capital Call,-2356000,-4600000,0,-4600000
82059,2020-12-31,361,Value,5056310,-4600000,0,-4600000
82059,2021-02-14,361,Capital Call,-2372600,-6972600,0,-6972600
82059,2021-02-14,361,Distribution,20918,-6972600,20918,-6951682
82059,2021-03-31,361,Value,7865090,-6972600,20918,-6951682
82059,2021-05-16,361,Capital Call,-23,-6972623,20918,-6951705
82059,2021-05-16,361,Distribution,0,-6972623,20918,-6951705
82059,2021-06-30,361,Value,8824550,-6972623,20918,-6951705
82059,2021-08-15,361,Capital Call,-1527377,-8500000,20918,-8479082
82059,2021-08-15,361,Distribution,-20918,-8500000,0,-8500000
82059,2021-09-30,361,Value,11050000,-8500000,0,-8500000
82060,2020-03-31,9036,Value,2169240,-1947082,0,-1947082
82060,2020-05-16,9036,Capital Call,-548338,-2495420,0,-2495420
82060,2020-06-30,9036,Value,2604000,-2495420,0,-2495420
82060,2020-09-30,9036,Value,2742350,-2495420,0,-2495420
82060,2020-11-15,9036,Capital Call,-156349,-2651769,0,-2651769
82060,2020-11-15,9036,Distribution,266862,-2651769,266862,-2384907
82060,2020-12-31,9036,Value,2920590,-2651769,266862,-2384907
82060,2021-02-14,9036,Capital Call,-1078699,-3730468,266862,-3463606
82060,2021-03-31,9036,Value,3999290,-3730468,266862,-3463606
82060,2021-05-16,9036,Capital Call,-1375469,-5105937,266862,-4839075
82060,2021-05-16,9036,Distribution,1852,-5105937,268714,-4837223
82060,2021-06-30,9036,Value,5656600,-5105937,268714,-4837223
82060,2021-09-30,9036,Value,5829090,-5105937,268714,-4837223
82065,2020-03-31,66152,Value,859740,-1246000,0,-1246000
82065,2020-06-30,66152,Value,872200,-1246000,0,-1246000
82065,2020-08-15,66152,Capital Call,26000,-1220000,0,-1220000
82065,2020-09-30,66152,Value,1000400,-1220000,0,-1220000
82065,2020-11-15,66152,Capital Call,-900000,-2120000,0,-2120000
82065,2020-12-31,66152,Value,1908000,-2120000,0,-2120000
82065,2021-02-14,66152,Capital Call,-890000,-3010000,0,-3010000
82065,2021-03-31,66152,Value,2829400,-3010000,0,-3010000
82065,2021-06-30,66152,Value,2829400,-3010000,0,-3010000
82065,2021-08-15,66152,Capital Call,-870000,-3880000,0,-3880000
82065,2021-09-30,66152,Value,3802400,-3880000,0,-3880000
82065,2021-11-15,66152,Distribution,34920,-3880000,34920,-3845080
82065,2021-12-31,66152,Value,4842240,-3880000,34920,-3845080
82138,2020-02-15,424,Capital Call,-49592,-1809990,22272,-1787718
82138,2020-03-31,424,Value,1575740,-1809990,22272,-1787718
82138,2020-05-16,424,Capital Call,-64610,-1874600,22272,-1852328
82138,2020-06-30,424,Value,1842230,-1874600,22272,-1852328
82138,2020-08-15,424,Capital Call,-1346230,-3220830,22272,-3198558
82138,2020-09-30,424,Value,3419540,-3220830,22272,-3198558
82138,2020-11-15,424,Capital Call,-566330,-3787160,22272,-3764888
82138,2020-12-31,424,Value,4794250,-3787160,22272,-3764888
82138,2021-02-14,424,Capital Call,-1841070,-5628230,22272,-5605958
82138,2021-03-31,424,Value,7189440,-5628230,22272,-5605958
82310,2020-02-15,79005,Capital Call,-805192,-2263388,0,-2263388
82310,2020-03-31,79005,Value,2236510,-2263388,0,-2263388
82310,2020-05-16,79005,Capital Call,-1007244,-3270632,0,-3270632
82310,2020-06-30,79005,Value,3212500,-3270632,0,-3270632
82310,2020-08-15,79005,Capital Call,-973283,-4243915,0,-4243915
82310,2020-09-30,79005,Value,4114700,-4243915,0,-4243915
82310,2020-11-15,79005,Capital Call,-486020,-4729935,0,-4729935
82310,2020-11-15,79005,Distribution,229810,-4729935,229810,-4500125
82310,2020-12-31,79005,Value,4751110,-4729935,229810,-4500125
82310,2021-03-31,79005,Value,4944630,-4729935,229810,-4500125
82310,2021-05-16,79005,Capital Call,-587862,-5317797,229810,-5087987
82310,2021-06-30,79005,Value,6512040,-5317797,229810,-5087987
82562,2020-02-15,65397,Capital Call,-1883908,-6518388,1014,-6517374
82562,2020-03-31,65397,Value,6644120,-6518388,1014,-6517374
82562,2020-06-30,65397,Value,6681840,-6518388,1014,-6517374
82562,2020-09-30,65397,Capital Call,-922054,-7440442,1014,-7439428
82562,2020-12-31,65397,Value,7984390,-7440442,1014,-7439428
82562,2021-03-31,65397,Value,8884810,-7440442,1014,-7439428
82562,2021-06-30,65397,Value,9994250,-7440442,1014,-7439428
82769,2020-02-15,391,Capital Call,6295,-9600002,2305510,-7294492
82769,2020-02-15,391,Distribution,-1511,-9600002,2303999,-7296003
82769,2020-03-31,391,Value,13344000,-9600002,2303999,-7296003
82769,2020-05-16,391,Capital Call,-100000,-9700002,2303999,-7396003
82769,2020-05-16,391,Distribution,24000,-9700002,2327999,-7372003
82769,2020-06-30,391,Value,13774000,-9700002,2327999,-7372003
82769,2020-09-30,391,Value,14550000,-9700002,2327999,-7372003
82769,2020-11-15,391,Distribution,6887000,-9700002,9214999,-485003
82769,2020-12-31,391,Value,7954000,-9700002,9214999,-485003
82769,2021-02-14,391,Distribution,2619000,-9700002,11833999,2133997
82769,2021-03-31,391,Value,5626000,-9700002,11833999,2133997
82769,2021-06-30,391,Value,5917000,-9700002,11833999,2133997
82769,2021-08-15,391,Distribution,1843000,-9700002,13676999,3976997
82769,2021-09-30,391,Value,4559000,-9700002,13676999,3976997
82769,2021-11-15,391,Distribution,-1455000,-9700002,12221999,2521997
82769,2021-12-31,391,Value,5529000,-9700002,12221999,2521997
82777,2020-06-30,60869,Value,2508040,-2486557,0,-2486557
82962,2020-03-31,12952,Value,548660,-767879,0,-767879
82962,2020-05-16,12952,Capital Call,-102990,-870869,0,-870869
82962,2020-06-30,12952,Value,579260,-870869,0,-870869
82962,2020-09-30,12952,Value,538940,-870869,0,-870869
82962,2020-11-15,12952,Capital Call,-10340,-881209,0,-881209
82962,2020-12-31,12952,Value,601190,-881209,0,-881209
82962,2021-03-31,12952,Value,565410,-881209,0,-881209
82962,2021-05-16,12952,Capital Call,-2011829,-2893038,0,-2893038
82962,2021-06-30,12952,Value,2525740,-2893038,0,-2893038
82971,2020-02-29,733,Capital Call,-568949,-568949,0,-568949
82971,2020-02-29,733,Value,354590,-568949,0,-568949
82971,2020-04-15,733,Capital Call,-412347,-981296,0,-981296
82971,2020-05-31,733,Value,677820,-981296,0,-981296
82971,2020-07-16,733,Capital Call,-339819,-1321115,0,-1321115
82971,2020-08-31,733,Value,1016510,-1321115,0,-1321115
82971,2020-11-30,733,Value,992660,-1321115,0,-1321115
82971,2021-01-14,733,Capital Call,-557786,-1878901,0,-1878901
82971,2021-01-14,733,Distribution,113237,-1878901,113237,-1765664
82971,2021-02-28,733,Value,1702830,-1878901,113237,-1765664
82971,2021-04-15,733,Capital Call,-589660,-2468561,113237,-2355324
82971,2021-04-15,733,Distribution,68931,-2468561,182168,-2286393
82971,2021-05-31,733,Value,2439920,-2468561,182168,-2286393
82971,2021-07-16,733,Capital Call,-1302728,-3771289,182168,-3589121
82971,2021-07-16,733,Distribution,167107,-3771289,349275,-3422014
82971,2021-08-31,733,Value,5459650,-3771289,349275,-3422014
82971,2021-10-16,733,Capital Call,-1008588,-4779877,349275,-4430602
82971,2021-10-16,733,Distribution,549819,-4779877,899094,-3880783
82971,2021-11-30,733,Value,5368450,-4779877,899094,-3880783
83080,2020-03-31,9407,Value,2257650,-2250000,0,-2250000
83080,2020-05-16,9407,Capital Call,-1000000,-3250000,0,-3250000
83080,2020-06-30,9407,Value,3342620,-3250000,0,-3250000
83080,2020-08-15,9407,Capital Call,-1000000,-4250000,0,-4250000
83080,2020-09-30,9407,Value,4778700,-4250000,0,-4250000
83080,2020-11-15,9407,Capital Call,-860000,-5110000,0,-5110000
83080,2020-12-31,9407,Value,6064030,-5110000,0,-5110000
83080,2021-03-31,9407,Value,7107490,-5110000,0,-5110000
83080,2021-05-16,9407,Capital Call,-850000,-5960000,0,-5960000
83080,2021-06-30,9407,Value,8448890,-5960000,0,-5960000
83080,2021-09-30,9407,Value,8469750,-5960000,0,-5960000
83172,2020-03-31,9004,Value,3733350,-3780000,0,-3780000
83172,2020-05-16,9004,Capital Call,-1100000,-4880000,0,-4880000
83172,2020-06-30,9004,Value,4776460,-4880000,0,-4880000
83172,2020-08-15,9004,Capital Call,-400000,-5280000,0,-5280000
83172,2020-09-30,9004,Value,5198770,-5280000,0,-5280000
83173,2020-02-15,9004,Capital Call,-750000,-4600000,0,-4600000
83173,2020-03-31,9004,Value,4529690,-4600000,0,-4600000
83173,2020-05-16,9004,Capital Call,-850000,-5450000,0,-5450000
83173,2020-06-30,9004,Value,5343550,-5450000,0,-5450000
83173,2020-09-30,9004,Value,5312870,-5450000,0,-5450000
83173,2020-11-15,9004,Capital Call,-1550000,-7000000,0,-7000000
83173,2020-12-31,9004,Value,6840390,-7000000,0,-7000000
83173,2021-03-31,9004,Value,6840390,-7000000,0,-7000000
83173,2021-05-16,9004,Capital Call,-280000,-7280000,0,-7280000
83173,2021-06-30,9004,Value,7879020,-7280000,0,-7280000
83273,2020-03-31,2165,Capital Call,-1312000,-2084000,0,-2084000
83273,2020-06-30,2165,Value,2875920,-2084000,0,-2084000
83273,2020-08-15,2165,Capital Call,-16000,-2100000,0,-2100000
83273,2020-09-30,2165,Value,3297000,-2100000,0,-2100000
83273,2020-12-31,2165,Value,3927000,-2100000,0,-2100000
83273,2021-04-01,2165,Capital Call,-1719000,-3819000,0,-3819000
83273,2021-06-30,2165,Value,8399500,-3819000,0,-3819000
83273,2021-08-15,2165,Capital Call,-382000,-4201000,0,-4201000
83273,2021-09-30,2165,Value,9347640,-4201000,0,-4201000
83273,2021-11-15,2165,Capital Call,-3168000,-7369000,0,-7369000
83273,2021-11-15,2165,Distribution,109798,-7369000,109798,-7259202
83273,2021-12-31,2165,Value,13043130,-7369000,109798,-7259202
83328,2020-02-15,802,Capital Call,-212500,-1931727,0,-1931727
83328,2020-03-31,802,Value,1676340,-1931727,0,-1931727
83328,2020-05-16,802,Capital Call,-52500,-1984227,0,-1984227
83328,2020-06-30,802,Value,1685500,-1984227,0,-1984227
83328,2020-08-15,802,Capital Call,-111064,-2095291,0,-2095291
83328,2020-09-30,802,Value,2241300,-2095291,0,-2095291
83328,2020-11-15,802,Capital Call,-2899000,-4994291,0,-4994291
83328,2020-12-31,802,Value,5224590,-4994291,0,-4994291
83328,2021-03-31,802,Value,5386300,-4994291,0,-4994291
83328,2021-05-16,802,Capital Call,-250000,-5244291,0,-5244291
83328,2021-05-16,802,Distribution,173798,-5244291,173798,-5070493
83328,2021-06-30,802,Value,5781220,-5244291,173798,-5070493
83460,2020-01-15,14497,Capital Call,-250000,-2700000,250,-2699750
83460,2020-02-29,14497,Value,2439930,-2700000,250,-2699750
83460,2020-04-15,14497,Capital Call,-250000,-2950000,250,-2949750
83460,2020-05-31,14497,Value,2668280,-2950000,250,-2949750
83460,2020-07-16,14497,Capital Call,-825000,-3775000,250,-3774750
83460,2020-08-31,14497,Value,3698310,-3775000,250,-3774750
83460,2020-10-16,14497,Capital Call,-100000,-3875000,250,-3874750
83460,2020-11-30,14497,Value,5001830,-3875000,250,-3874750
83460,2021-01-14,14497,Capital Call,-712500,-4587500,250,-4587250
83460,2021-02-28,14497,Value,6054810,-4587500,250,-4587250
83460,2021-04-15,14497,Capital Call,-500000,-5087500,250,-5087250
83460,2021-05-31,14497,Value,7510530,-5087500,250,-5087250
83460,2021-07-16,14497,Capital Call,-800000,-5887500,250,-5887250
83460,2021-08-31,14497,Value,10022880,-5887500,250,-5887250
83460,2021-10-16,14497,Capital Call,-1575000,-7462500,250,-7462250
83460,2021-11-30,14497,Value,12788920,-7462500,250,-7462250
83465,2020-02-15,70490,Capital Call,-500000,-1550000,0,-1550000
83465,2020-03-31,70490,Value,1147000,-1550000,0,-1550000
83465,2020-05-16,70490,Capital Call,-425000,-1975000,0,-1975000
83465,2020-06-30,70490,Value,1935500,-1975000,0,-1975000
83465,2020-08-15,70490,Capital Call,-175000,-2150000,0,-2150000
83465,2020-09-30,70490,Value,2064000,-2150000,0,-2150000
83465,2020-11-15,70490,Capital Call,-750000,-2900000,0,-2900000
83465,2020-12-31,70490,Value,3480000,-2900000,0,-2900000
83465,2021-02-14,70490,Capital Call,-500000,-3400000,0,-3400000
83465,2021-03-31,70490,Value,4012000,-3400000,0,-3400000
83465,2021-05-16,70490,Capital Call,-500000,-3900000,0,-3900000
83465,2021-06-30,70490,Value,4446000,-3900000,0,-3900000
83465,2021-08-15,70490,Capital Call,-500000,-4400000,0,-4400000
83465,2021-09-30,70490,Value,6952000,-4400000,0,-4400000
83470,2020-03-31,1360,Value,1355000,-1551250,0,-1551250
83470,2020-05-16,1360,Capital Call,-96250,-1647500,0,-1647500
83470,2020-06-30,1360,Value,1310000,-1647500,0,-1647500
83470,2020-09-30,1360,Value,1390000,-1647500,0,-1647500
83470,2020-12-31,1360,Value,1405000,-1647500,0,-1647500
83470,2021-03-31,1360,Value,1370000,-1647500,0,-1647500
83470,2021-05-16,1360,Capital Call,-1423750,-3071250,0,-3071250
83470,2021-06-30,1360,Value,2943750,-3071250,0,-3071250
83470,2021-09-30,1360,Value,3102580,-3071250,0,-3071250
83669,2020-06-30,184,Capital Call,-1017753,-1017753,0,-1017753
83669,2020-06-30,184,Value,1045810,-1017753,0,-1017753
83669,2020-12-31,184,Value,1381770,-1017753,0,-1017753
83669,2021-02-14,184,Capital Call,-123210,-1140963,0,-1140963
83669,2021-02-14,184,Distribution,276300,-1140963,276300,-864663
83669,2021-03-31,184,Value,1487850,-1140963,276300,-864663
83669,2021-05-16,184,Capital Call,-796138,-1937101,276300,-1660801
83669,2021-06-30,184,Value,2857290,-1937101,276300,-1660801
83799,2020-02-14,83265,Capital Call,-311964,-7356586,0,-7356586
83799,2020-06-30,83265,Value,8781100,-7356586,0,-7356586
83799,2020-08-15,83265,Capital Call,-1294140,-8650726,0,-8650726
83799,2020-09-30,83265,Value,11544240,-8650726,0,-8650726
83824,2020-02-15,673,Capital Call,-590000,-2987000,0,-2987000
83824,2020-03-31,673,Value,2719620,-2987000,0,-2987000
83824,2020-05-16,673,Capital Call,-535000,-3522000,0,-3522000
83824,2020-06-30,673,Value,3467890,-3522000,0,-3522000
83824,2020-08-15,673,Capital Call,-560000,-4082000,0,-4082000
83824,2020-09-30,673,Value,4375470,-4082000,0,-4082000
83824,2020-11-15,673,Capital Call,-880000,-4962000,0,-4962000
83824,2020-12-31,673,Value,6598910,-4962000,0,-4962000
83824,2021-02-14,673,Capital Call,-1274000,-6236000,0,-6236000
83824,2021-03-31,673,Value,8868970,-6236000,0,-6236000
83894,2020-02-15,10551,Capital Call,-182000,-2781000,31708,-2749292
83894,2020-02-15,10551,Distribution,-4,-2781000,31704,-2749296
83894,2020-03-31,10551,Value,2051540,-2781000,31704,-2749296
83894,2020-05-16,10551,Capital Call,-280000,-3061000,31704,-3029296
83894,2020-05-16,10551,Distribution,17273,-3061000,48977,-3012023
83894,2020-06-30,10551,Value,2265140,-3061000,48977,-3012023
83894,2020-08-15,10551,Capital Call,-327000,-3388000,48977,-3339023
83894,2020-08-15,10551,Distribution,-1544,-3388000,47433,-3340567
83894,2020-09-30,10551,Value,2547770,-3388000,47433,-3340567
83894,2020-11-15,10551,Capital Call,-697000,-4085000,47433,-4037567
83894,2020-11-15,10551,Distribution,9758,-4085000,57191,-4027809
83894,2020-12-31,10551,Value,3251660,-4085000,57191,-4027809
83894,2021-02-14,10551,Capital Call,-322000,-4407000,57191,-4349809
83894,2021-02-14,10551,Distribution,4508,-4407000,61699,-4345301
83894,2021-03-31,10551,Value,3521190,-4407000,61699,-4345301
83894,2021-05-16,10551,Capital Call,-266000,-4673000,61699,-4611301
83894,2021-05-16,10551,Distribution,17743,-4673000,79442,-4593558
83894,2021-06-30,10551,Value,3859890,-4673000,79442,-4593558
83894,2021-08-15,10551,Capital Call,-600000,-5273000,79442,-5193558
83894,2021-08-15,10551,Distribution,-346,-5273000,79096,-5193904
83894,2021-09-30,10551,Value,4408220,-5273000,79096,-5193904
83894,2021-11-15,10551,Capital Call,-697000,-5970000,79096,-5890904
83894,2021-11-15,10551,Distribution,-1485,-5970000,77611,-5892389
83894,2021-12-31,10551,Value,5205840,-5970000,77611,-5892389
84146,2020-03-31,15399,Capital Call,-955000,-2045000,0,-2045000
84146,2020-06-30,15399,Value,1626790,-2045000,0,-2045000
84157,2020-03-31,14411,Value,5761240,-5212043,13,-5212030
84157,2020-05-16,14411,Capital Call,-515428,-5727471,13,-5727458
84157,2020-05-16,14411,Distribution,59,-5727471,72,-5727399
84157,2020-06-30,14411,Value,7372940,-5727471,72,-5727399
84157,2020-09-30,14411,Capital Call,-537704,-6265175,72,-6265103
84157,2020-09-30,14411,Distribution,199157,-6265175,199229,-6065946
84157,2020-12-31,14411,Value,9339780,-6265175,199229,-6065946
84157,2021-02-14,14411,Capital Call,-1065351,-7330526,199229,-7131297
84157,2021-02-14,14411,Distribution,48182,-7330526,247411,-7083115
84157,2021-03-31,14411,Value,12254590,-7330526,247411,-7083115
84157,2021-05-16,14411,Capital Call,-1471438,-8801964,247411,-8554553
84157,2021-05-16,14411,Distribution,929372,-8801964,1176783,-7625181
84157,2021-06-30,14411,Value,13959740,-8801964,1176783,-7625181
84284,2020-12-31,9794,Capital Call,-3000000,-3000000,0,-3000000
84284,2020-12-31,9794,Value,3300000,-3000000,0,-3000000
84284,2021-06-30,9794,Value,3450000,-3000000,0,-3000000
84392,2020-03-31,14411,Capital Call,-701750,-701750,0,-701750
84392,2020-03-31,14411,Value,702500,-701750,0,-701750
84392,2020-05-16,14411,Capital Call,-500,-702250,0,-702250
84392,2020-06-30,14411,Value,585750,-702250,0,-702250
84392,2020-08-15,14411,Capital Call,-548500,-1250750,0,-1250750
84392,2020-09-30,14411,Value,1435000,-1250750,0,-1250750
84392,2020-11-15,14411,Capital Call,248750,-1002000,0,-1002000
84392,2020-12-31,14411,Value,1473000,-1002000,0,-1002000
84466,2020-02-15,14411,Capital Call,-1330615,-7482112,0,-7482112
84466,2020-03-31,14411,Value,10485050,-7482112,0,-7482112
84466,2020-06-30,14411,Value,12492770,-7482112,0,-7482112
84466,2020-09-30,14411,Capital Call,-1886323,-9368435,0,-9368435
84466,2020-09-30,14411,Distribution,2705950,-9368435,2705950,-6662485
84466,2020-12-31,14411,Value,19245380,-9368435,2705950,-6662485
84466,2021-02-14,14411,Capital Call,-30221,-9398656,2705950,-6692706
84466,2021-02-14,14411,Distribution,1012824,-9398656,3718774,-5679882
84466,2021-03-31,14411,Value,21460170,-9398656,3718774,-5679882
84473,2020-03-31,9954,Value,471050,-826316,0,-826316
84473,2020-06-30,9954,Value,405260,-826316,0,-826316
84473,2020-08-15,9954,Capital Call,-1107895,-1934211,0,-1934211
84473,2020-09-30,9954,Value,1815780,-1934211,0,-1934211
84473,2020-11-15,9954,Capital Call,-531579,-2465790,0,-2465790
84473,2020-11-15,9954,Distribution,47368,-2465790,47368,-2418422
84473,2020-12-31,9954,Value,2323680,-2465790,47368,-2418422
84473,2021-02-14,9954,Capital Call,-923684,-3389474,47368,-3342106
84473,2021-03-31,9954,Value,3147360,-3389474,47368,-3342106
84473,2021-06-30,9954,Value,4339470,-3389474,47368,-3342106
84473,2021-08-15,9954,Capital Call,-2186316,-5575790,47368,-5528422
84473,2021-08-15,9954,Distribution,263,-5575790,47631,-5528159
84473,2021-09-30,9954,Value,5677360,-5575790,47631,-5528159
84474,2020-05-16,49839,Capital Call,-2621367,-4000000,0,-4000000
84474,2020-09-30,49839,Value,4333330,-4000000,0,-4000000
84852,2020-02-15,725,Capital Call,-331111,-3629111,0,-3629111
84852,2020-03-31,725,Value,3380000,-3629111,0,-3629111
84852,2020-05-16,725,Capital Call,-164889,-3794000,0,-3794000
84852,2020-06-30,725,Value,4730220,-3794000,0,-3794000
84852,2020-08-15,725,Capital Call,-1815111,-5609111,0,-5609111
84852,2020-09-30,725,Value,7371110,-5609111,0,-5609111
84852,2020-11-15,725,Capital Call,-734000,-6343111,0,-6343111
84852,2020-12-31,725,Value,10570440,-6343111,0,-6343111
84852,2021-02-14,725,Capital Call,-280889,-6624000,0,-6624000
84852,2021-03-31,725,Value,12340000,-6624000,0,-6624000
84852,2021-05-16,725,Capital Call,-424444,-7048444,0,-7048444
84852,2021-06-30,725,Value,16900880,-7048444,0,-7048444
84875,2020-09-30,212,Capital Call,-346827,-346827,0,-346827
84875,2020-09-30,212,Value,378040,-346827,0,-346827
84875,2020-12-31,212,Value,423120,-346827,0,-346827
84875,2021-02-14,212,Capital Call,-421073,-767900,0,-767900
84875,2021-03-31,212,Value,806290,-767900,0,-767900
84875,2021-05-16,212,Capital Call,-118457,-886357,0,-886357
84875,2021-06-30,212,Value,1010440,-886357,0,-886357
84876,2020-03-31,162111,Value,4130420,-4175000,0,-4175000
84876,2020-06-30,162111,Value,4114200,-4175000,0,-4175000
84876,2020-08-15,162111,Capital Call,-1800000,-5975000,0,-5975000
84876,2020-09-30,162111,Value,5912580,-5975000,0,-5975000
84876,2020-12-30,162111,Capital Call,-3775000,-9750000,0,-9750000
84876,2021-03-31,162111,Value,11934370,-9750000,0,-9750000
85096,2020-03-31,2204,Capital Call,-2215581,-3268581,0,-3268581
85096,2020-06-30,2204,Value,3372310,-3268581,0,-3268581
85096,2020-08-15,2204,Capital Call,-444685,-3713266,0,-3713266
85096,2020-09-30,2204,Value,3877410,-3713266,0,-3713266
85096,2020-11-15,2204,Capital Call,-1695652,-5408918,0,-5408918
85096,2020-12-31,2204,Value,6092400,-5408918,0,-5408918
85096,2021-02-14,2204,Capital Call,-423913,-5832831,0,-5832831
85096,2021-03-31,2204,Value,7007910,-5832831,0,-5832831
85103,2020-07-01,178323,Capital Call,-2232000,-5112000,0,-5112000
85103,2020-12-31,178323,Value,6076000,-5112000,0,-5112000
85216,2020-02-15,11277,Capital Call,-602541,-5089362,630778,-4458584
85216,2020-02-15,11277,Distribution,285616,-5089362,916394,-4172968
85216,2020-03-31,11277,Value,5425220,-5089362,916394,-4172968
85216,2020-05-16,11277,Capital Call,-728146,-5817508,916394,-4901114
85216,2020-05-16,11277,Distribution,14364,-5817508,930758,-4886750
85216,2020-06-30,11277,Value,6610010,-5817508,930758,-4886750
85216,2020-08-15,11277,Capital Call,-12500,-5830008,930758,-4899250
85216,2020-08-15,11277,Distribution,97881,-5830008,1028639,-4801369
85216,2020-09-30,11277,Value,7548060,-5830008,1028639,-4801369
85216,2020-11-15,11277,Capital Call,-581568,-6411576,1028639,-5382937
85216,2020-11-15,11277,Distribution,693926,-6411576,1722565,-4689011
85216,2020-12-31,11277,Value,8987630,-6411576,1722565,-4689011
85216,2021-02-14,11277,Capital Call,-12500,-6424076,1722565,-4701511
85216,2021-03-31,11277,Value,12783040,-6424076,1722565,-4701511
85217,2020-03-31,93335,Capital Call,-1475000,-5000000,0,-5000000
85217,2020-06-30,93335,Value,6601350,-5000000,0,-5000000
85217,2020-08-15,93335,Capital Call,-725000,-5725000,0,-5725000
85217,2020-09-30,93335,Value,7313620,-5725000,0,-5725000
85217,2020-11-15,93335,Capital Call,-575000,-6300000,0,-6300000
85217,2020-12-31,93335,Value,7888620,-6300000,0,-6300000
85217,2021-02-14,93335,Capital Call,-425000,-6725000,0,-6725000
85217,2021-03-31,93335,Value,39061480,-6725000,0,-6725000
85477,2020-02-15,22769,Capital Call,-5680,-2809611,0,-2809611
85477,2020-03-31,22769,Value,2804190,-2809611,0,-2809611
85477,2020-05-16,22769,Capital Call,-10849,-2820460,0,-2820460
85477,2020-06-30,22769,Value,2527920,-2820460,0,-2820460
85477,2020-08-15,22769,Capital Call,-17031,-2837491,0,-2837491
85477,2020-09-30,22769,Value,2294960,-2837491,0,-2837491
85862,2020-02-15,7168,Distribution,137,-1523387,137,-1523250
85862,2020-03-31,7168,Value,1116090,-1523387,137,-1523250
85862,2020-05-16,7168,Capital Call,-93573,-1616960,137,-1616823
85862,2020-06-30,7168,Value,1145470,-1616960,137,-1616823
85862,2020-08-15,7168,Capital Call,-160152,-1777112,137,-1776975
85862,2020-09-30,7168,Value,1244870,-1777112,137,-1776975
85862,2020-12-31,7168,Value,1459080,-1777112,137,-1776975
85862,2021-02-14,7168,Capital Call,-1738888,-3516000,137,-3515863
85862,2021-02-14,7168,Distribution,-137,-3516000,0,-3516000
85862,2021-03-31,7168,Value,3095830,-3516000,0,-3516000
85895,2020-02-15,24,Capital Call,-250000,-2600000,25380,-2574620
85895,2020-02-15,24,Distribution,100,-2600000,25480,-2574520
85895,2020-03-31,24,Value,2663180,-2600000,25480,-2574520
85895,2020-06-30,24,Value,2857660,-2600000,25480,-2574520
85895,2020-08-15,24,Capital Call,-350000,-2950000,25480,-2924520
85895,2020-08-15,24,Distribution,40305,-2950000,65785,-2884215
85895,2020-09-30,24,Value,3259450,-2950000,65785,-2884215
85895,2020-11-15,24,Distribution,2360,-2950000,68145,-2881855
85895,2020-12-31,24,Value,3868040,-2950000,68145,-2881855
85895,2021-02-14,24,Capital Call,-750000,-3700000,68145,-3631855
85895,2021-02-14,24,Distribution,305,-3700000,68450,-3631550
85895,2021-03-31,24,Value,5631400,-3700000,68450,-3631550
85895,2021-05-16,24,Capital Call,-600000,-4300000,68450,-4231550
85895,2021-05-16,24,Distribution,-80,-4300000,68370,-4231630
85895,2021-06-30,24,Value,7065330,-4300000,68370,-4231630
85895,2021-08-15,24,Capital Call,-400071,-4700071,68370,-4631701
85895,2021-08-15,24,Distribution,32202,-4700071,100572,-4599499
85895,2021-09-30,24,Value,7750820,-4700071,100572,-4599499
85903,2020-03-31,465,Capital Call,-843024,-843024,0,-843024
85903,2020-03-31,465,Value,505000,-843024,0,-843024
85903,2020-05-16,465,Capital Call,-619733,-1462757,0,-1462757
85903,2020-06-30,465,Value,1508150,-1462757,0,-1462757
85903,2020-08-15,465,Capital Call,-718300,-2181057,0,-2181057
85903,2020-09-30,465,Value,2372780,-2181057,0,-2181057
85903,2020-11-15,465,Capital Call,-637182,-2818239,0,-2818239
85903,2020-12-31,465,Value,3009960,-2818239,0,-2818239
85903,2021-02-14,465,Capital Call,-97333,-2915572,0,-2915572
85903,2021-03-31,465,Value,3634880,-2915572,0,-2915572
85903,2021-05-16,465,Capital Call,-751094,-3666666,0,-3666666
85903,2021-06-30,465,Value,4856390,-3666666,0,-3666666
85903,2021-08-15,465,Capital Call,-168867,-3835533,0,-3835533
85903,2021-09-30,465,Value,5024930,-3835533,0,-3835533
86022,2020-02-15,350,Distribution,416202,-7395645,2643654,-4751991
86022,2020-03-31,350,Value,14383380,-7395645,2643654,-4751991
86022,2020-06-30,350,Value,14383380,-7395645,2643654,-4751991
86022,2020-08-15,350,Distribution,182746,-7395645,2826400,-4569245
86022,2020-09-30,350,Value,15072310,-7395645,2826400,-4569245
86022,2020-11-15,350,Distribution,426197,-7395645,3252597,-4143048
86022,2020-12-31,350,Value,14474930,-7395645,3252597,-4143048
86022,2021-02-14,350,Capital Call,-197,-7395842,3252597,-4143245
86022,2021-02-14,350,Distribution,305357,-7395842,3557954,-3837888
86022,2021-03-31,350,Value,15721180,-7395842,3557954,-3837888
86022,2021-05-16,350,Distribution,1291338,-7395842,4849292,-2546550
86022,2021-06-30,350,Value,20196590,-7395842,4849292,-2546550
86025,2020-02-15,350,Distribution,1334024,-9647585,8642831,-1004754
86025,2020-03-31,350,Value,19644560,-9647585,8642831,-1004754
86025,2020-05-16,350,Distribution,228809,-9647585,8871640,-775945
86025,2020-06-30,350,Value,19415750,-9647585,8871640,-775945
86025,2020-08-15,350,Distribution,656547,-9647585,9528187,-119398
86025,2020-09-30,350,Value,20612810,-9647585,9528187,-119398
86025,2020-12-31,350,Value,21060830,-9647585,9528187,-119398
86025,2021-03-31,350,Value,21713430,-9647585,9528187,-119398
86025,2021-05-16,350,Distribution,4707895,-9647585,14236082,4588497
86025,2021-06-30,350,Value,16491280,-9647585,14236082,4588497
86029,2020-02-15,350,Capital Call,-742273,-7484077,600871,-6883206
86029,2020-03-31,350,Value,10910860,-7484077,600871,-6883206
86029,2020-05-16,350,Capital Call,-564730,-8048807,600871,-7447936
86029,2020-06-30,350,Value,11475590,-8048807,600871,-7447936
86029,2020-09-30,350,Value,12512350,-8048807,600871,-7447936
86029,2020-11-15,350,Capital Call,-980303,-9029110,600871,-8428239
86029,2020-11-15,350,Distribution,750612,-9029110,1351483,-7677627
86029,2020-12-31,350,Value,12644250,-9029110,1351483,-7677627
86029,2021-03-31,350,Value,13806630,-9029110,1351483,-7677627
86029,2021-05-16,350,Distribution,879662,-9029110,2231145,-6797965
86029,2021-06-30,350,Value,15719060,-9029110,2231145,-6797965
86115,2020-02-12,2250,Capital Call,-275384,-2590622,0,-2590622
86115,2020-03-24,2250,Capital Call,-156435,-2747057,0,-2747057
86115,2020-05-01,2250,Capital Call,-295160,-3042217,0,-3042217
86115,2020-06-29,2250,Capital Call,-295160,-3337377,0,-3337377
86115,2020-06-30,2250,Value,6805800,-3337377,0,-3337377
86115,2020-08-25,2250,Distribution,223536,-3337377,223536,-3113841
86115,2020-09-30,2250,Capital Call,-2360622,-5697999,223536,-5474463
86115,2020-09-30,2250,Distribution,182162,-5697999,405698,-5292301
86115,2020-09-30,2250,Value,4314780,-5697999,405698,-5292301
86115,2020-11-15,2250,Capital Call,-502000,-6199999,405698,-5794301
86115,2020-11-15,2250,Distribution,2433902,-6199999,2839600,-3360399
86115,2020-12-31,2250,Value,7297400,-6199999,2839600,-3360399
86115,2021-03-31,2250,Value,7874000,-6199999,2839600,-3360399
86115,2021-05-16,2250,Distribution,892800,-6199999,3732400,-2467599
86115,2021-06-30,2250,Value,7471620,-6199999,3732400,-2467599
86115,2021-08-15,2250,Distribution,455700,-6199999,4188100,-2011899
86115,2021-09-30,2250,Value,7347620,-6199999,4188100,-2011899
86465,2020-02-15,18619,Capital Call,-18232,-2168049,50000,-2118049
86465,2020-02-15,18619,Distribution,25000,-2168049,75000,-2093049
86465,2020-03-31,18619,Value,2728490,-2168049,75000,-2093049
86465,2020-05-16,18619,Capital Call,-45000,-2213049,75000,-2138049
86465,2020-05-16,18619,Distribution,100000,-2213049,175000,-2038049
86465,2020-06-30,18619,Value,2891670,-2213049,175000,-2038049
86465,2020-08-15,18619,Capital Call,-45000,-2258049,175000,-2083049
86465,2020-08-15,18619,Distribution,100000,-2258049,275000,-1983049
86465,2020-09-30,18619,Value,2896910,-2258049,275000,-1983049
86465,2020-11-15,18619,Capital Call,-11669,-2269718,275000,-1994718
86465,2020-11-15,18619,Distribution,50000,-2269718,325000,-1944718
86465,2020-12-31,18619,Value,2654120,-2269718,325000,-1944718
86465,2021-02-14,18619,Capital Call,-771989,-3041707,325000,-2716707
86465,2021-02-14,18619,Distribution,25000,-3041707,350000,-2691707
86465,2021-03-31,18619,Value,3852440,-3041707,350000,-2691707
86465,2021-05-16,18619,Capital Call,-1614912,-4656619,350000,-4306619
86465,2021-05-16,18619,Distribution,1500000,-4656619,1850000,-2806619
86465,2021-06-30,18619,Value,4847180,-4656619,1850000,-2806619
86465,2021-08-15,18619,Capital Call,-856214,-5512833,1850000,-3662833
86465,2021-08-15,18619,Distribution,400000,-5512833,2250000,-3262833
86465,2021-09-30,18619,Value,6988740,-5512833,2250000,-3262833
86551,2020-02-15,1759,Capital Call,-500000,-3555000,152750,-3402250
86551,2020-02-15,1759,Distribution,1892,-3555000,154642,-3400358
86551,2020-03-31,1759,Value,3697200,-3555000,154642,-3400358
86551,2020-06-30,1759,Value,3874950,-3555000,154642,-3400358
86551,2020-09-30,1759,Value,4159350,-3555000,154642,-3400358
86551,2020-11-15,1759,Capital Call,-2500000,-6055000,154642,-5900358
86551,2020-11-15,1759,Distribution,-240,-6055000,154402,-5900598
86551,2020-12-31,1759,Value,7144900,-6055000,154402,-5900598
86551,2021-02-14,1759,Capital Call,-655000,-6710000,154402,-6555598
86551,2021-02-14,1759,Distribution,-73,-6710000,154329,-6555671
86551,2021-03-31,1759,Value,8253300,-6710000,154329,-6555671
86551,2021-05-16,1759,Capital Call,-595000,-7305000,154329,-7150671
86551,2021-05-16,1759,Distribution,536,-7305000,154865,-7150135
86551,2021-06-30,1759,Value,9642600,-7305000,154865,-7150135
86551,2021-08-15,1759,Capital Call,-495000,-7800000,154865,-7645135
86551,2021-08-15,1759,Distribution,1134,-7800000,155999,-7644001
86551,2021-09-30,1759,Value,10686000,-7800000,155999,-7644001
86834,2020-02-15,2474,Capital Call,-400000,-3000000,0,-3000000
86834,2020-03-31,2474,Value,3000000,-3000000,0,-3000000
86834,2020-05-16,2474,Capital Call,-1000000,-4000000,0,-4000000
86834,2020-06-30,2474,Value,3800000,-4000000,0,-4000000
86834,2020-09-30,2474,Capital Call,-599726,-4599726,0,-4599726
86834,2020-12-31,2474,Value,4765780,-4599726,0,-4599726
86852,2020-02-15,9110,Capital Call,-704556,-9271557,343538,-8928019
86852,2020-02-15,9110,Distribution,1592147,-9271557,1935685,-7335872
86852,2020-03-31,9110,Value,9629320,-9271557,1935685,-7335872
86852,2020-05-16,9110,Capital Call,-376444,-9648001,1935685,-7712316
86852,2020-05-16,9110,Distribution,12247,-9648001,1947932,-7700069
86852,2020-06-30,9110,Value,10555870,-9648001,1947932,-7700069
86852,2020-09-30,9110,Value,11349900,-9648001,1947932,-7700069
86852,2020-12-31,9110,Value,13114520,-9648001,1947932,-7700069
86852,2021-02-14,9110,Capital Call,-679000,-10327001,1947932,-8379069
86852,2021-02-14,9110,Distribution,478914,-10327001,2426846,-7900155
86852,2021-03-31,9110,Value,13954870,-10327001,2426846,-7900155
86852,2021-06-30,9110,Value,15091870,-10327001,2426846,-7900155
86852,2021-08-15,9110,Capital Call,-81000,-10408001,2426846,-7981155
86852,2021-08-15,9110,Distribution,930776,-10408001,3357622,-7050379
86852,2021-09-30,9110,Value,14054960,-10408001,3357622,-7050379
86856,2020-02-15,24,Capital Call,0,-1300000,0,-1300000
86856,2020-03-31,24,Value,1411140,-1300000,0,-1300000
86856,2020-05-16,24,Capital Call,-750000,-2050000,0,-2050000
86856,2020-06-30,24,Value,2226300,-2050000,0,-2050000
86856,2020-08-15,24,Capital Call,200000,-1850000,0,-1850000
86856,2020-09-30,24,Value,2153950,-1850000,0,-1850000
86856,2020-12-31,24,Value,2500640,-1850000,0,-1850000
86856,2021-02-14,24,Capital Call,-200000,-2050000,0,-2050000
86856,2021-03-31,24,Value,2984180,-2050000,0,-2050000
86856,2021-05-16,24,Capital Call,-608000,-2658000,0,-2658000
86856,2021-06-30,24,Value,3572880,-2658000,0,-2658000
86856,2021-08-15,24,Capital Call,-442000,-3100000,0,-3100000
86856,2021-09-30,24,Value,4190580,-3100000,0,-3100000
86859,2020-02-15,24,Capital Call,520000,-4787000,0,-4787000
86859,2020-03-31,24,Value,4525620,-4787000,0,-4787000
86859,2020-06-30,24,Value,4856890,-4787000,0,-4787000
86859,2020-09-30,24,Value,5300160,-4787000,0,-4787000
86859,2020-12-30,24,Capital Call,-1150000,-5937000,0,-5937000
86859,2021-03-31,24,Value,11881120,-5937000,0,-5937000
86859,2021-06-30,24,Value,11483930,-5937000,0,-5937000
86859,2021-08-15,24,Capital Call,-1250000,-7187000,0,-7187000
86859,2021-09-30,24,Value,11723430,-7187000,0,-7187000
86869,2020-02-15,9110,Capital Call,-962605,-4791605,90365,-4701240
86869,2020-02-15,9110,Distribution,64811,-4791605,155176,-4636429
86869,2020-03-31,9110,Value,4705930,-4791605,155176,-4636429
86869,2020-05-16,9110,Capital Call,-322395,-5114000,155176,-4958824
86869,2020-05-16,9110,Distribution,7450,-5114000,162626,-4951374
86869,2020-06-30,9110,Value,5428510,-5114000,162626,-4951374
86869,2020-08-15,9110,Capital Call,-653000,-5767000,162626,-5604374
86869,2020-08-15,9110,Distribution,79589,-5767000,242215,-5524785
86869,2020-09-30,9110,Value,6301600,-5767000,242215,-5524785
86869,2020-11-15,9110,Capital Call,-997000,-6764000,242215,-6521785
86869,2020-11-15,9110,Distribution,60813,-6764000,303028,-6460972
86869,2020-12-31,9110,Value,8515190,-6764000,303028,-6460972
86869,2021-02-14,9110,Capital Call,-1100000,-7864000,303028,-7560972
86869,2021-02-14,9110,Distribution,208133,-7864000,511161,-7352839
86869,2021-03-31,9110,Value,10562130,-7864000,511161,-7352839
86869,2021-06-30,9110,Value,10771320,-7864000,511161,-7352839
86869,2021-08-15,9110,Capital Call,-815000,-8679000,511161,-8167839
86869,2021-08-15,9110,Distribution,451341,-8679000,962502,-7716498
86869,2021-09-30,9110,Value,10912970,-8679000,962502,-7716498
86959,2020-02-15,733,Capital Call,-39123,-1698316,21652,-1676664
86959,2020-03-31,733,Value,1667360,-1698316,21652,-1676664
86959,2020-05-16,733,Capital Call,-1097772,-2796088,21652,-2774436
86959,2020-06-30,733,Value,3008420,-2796088,21652,-2774436
86959,2020-08-15,733,Capital Call,-1798038,-4594126,21652,-4572474
86959,2020-09-30,733,Value,5164700,-4594126,21652,-4572474
86959,2020-11-15,733,Capital Call,-80270,-4674396,21652,-4652744
86959,2020-12-31,733,Value,6987040,-4674396,21652,-4652744
86959,2021-02-14,733,Capital Call,-1872224,-6546620,21652,-6524968
86959,2021-02-14,733,Distribution,347988,-6546620,369640,-6176980
86959,2021-03-31,733,Value,9008660,-6546620,369640,-6176980
86959,2021-05-16,733,Capital Call,-1478342,-8024962,369640,-7655322
86959,2021-05-16,733,Distribution,744688,-8024962,1114328,-6910634
86959,2021-06-30,733,Value,10198230,-8024962,1114328,-6910634
86959,2021-08-15,733,Distribution,81939,-8024962,1196267,-6828695
86959,2021-09-30,733,Value,12007070,-8024962,1196267,-6828695
87056,2020-02-15,15275,Capital Call,-300000,-2500000,0,-2500000
87056,2020-03-31,15275,Value,2649540,-2500000,0,-2500000
87056,2020-06-30,15275,Value,2649540,-2500000,0,-2500000
87130,2020-03-31,283389,Value,1900530,-1835568,0,-1835568
87130,2020-05-16,283389,Capital Call,-1099379,-2934947,0,-2934947
87130,2020-06-30,283389,Value,3481870,-2934947,0,-2934947
87130,2020-09-30,283389,Value,4088830,-2934947,0,-2934947
87130,2020-11-15,283389,Capital Call,-1149004,-4083951,0,-4083951
87130,2020-12-31,283389,Value,6300610,-4083951,0,-4083951
87130,2021-02-14,283389,Distribution,4134543,-4083951,4134543,50592
87130,2021-03-31,283389,Value,2166070,-4083951,4134543,50592
87145,2020-02-15,58200,Capital Call,-725000,-2799000,0,-2799000
87145,2020-03-31,58200,Value,3078900,-2799000,0,-2799000
87145,2020-05-16,58200,Capital Call,-700000,-3499000,0,-3499000
87145,2020-06-30,58200,Value,4051840,-3499000,0,-3499000
87145,2020-09-30,58200,Value,3887030,-3499000,0,-3499000
87145,2020-12-31,58200,Value,7077070,-3499000,0,-3499000
87145,2021-02-14,58200,Capital Call,-1720000,-5219000,0,-5219000
87145,2021-03-31,58200,Value,9680720,-5219000,0,-5219000
87145,2021-06-30,58200,Value,9422900,-5219000,0,-5219000
87145,2021-08-15,58200,Capital Call,-720000,-5939000,0,-5939000
87145,2021-09-30,58200,Value,10675350,-5939000,0,-5939000
87238,2020-03-31,5571,Value,2717820,-2800000,0,-2800000
87240,2021-03-31,12504,Capital Call,-2468889,-2468889,0,-2468889
87240,2021-03-31,12504,Value,2468880,-2468889,0,-2468889
87240,2021-05-16,12504,Capital Call,-59467,-2528356,0,-2528356
87240,2021-06-30,12504,Value,2368650,-2528356,0,-2528356
87246,2020-03-01,176102,Capital Call,-2250000,-3750000,0,-3750000
87246,2020-08-31,176102,Value,3302720,-3750000,0,-3750000
87246,2020-10-16,176102,Capital Call,-500000,-4250000,0,-4250000
87246,2020-11-30,176102,Value,4018160,-4250000,0,-4250000
87246,2021-01-14,176102,Capital Call,-1000000,-5250000,0,-5250000
87246,2021-02-28,176102,Value,5018160,-5250000,0,-5250000
87246,2021-04-15,176102,Capital Call,-1500000,-6750000,0,-6750000
87246,2021-05-31,176102,Value,6985740,-6750000,0,-6750000
87246,2021-08-31,176102,Value,8493680,-6750000,0,-6750000
87246,2021-10-16,176102,Capital Call,-1000000,-7750000,0,-7750000
87246,2021-11-30,176102,Value,9536870,-7750000,0,-7750000
87354,2020-02-15,545,Capital Call,0,-8696071,249153,-8446918
87354,2020-02-15,545,Distribution,0,-8696071,249153,-8446918
87354,2020-03-31,545,Value,9911150,-8696071,249153,-8446918
87354,2020-05-16,545,Capital Call,-372738,-9068809,249153,-8819656
87354,2020-06-30,545,Value,10424650,-9068809,249153,-8819656
87354,2020-08-15,545,Capital Call,-203,-9069012,249153,-8819859
87354,2020-08-15,545,Distribution,6,-9069012,249159,-8819853
87354,2020-09-30,545,Value,10995950,-9069012,249159,-8819853
87354,2020-11-15,545,Capital Call,203,-9068809,249159,-8819650
87354,2020-11-15,545,Distribution,-6,-9068809,249153,-8819656
87354,2020-12-31,545,Value,12165890,-9068809,249153,-8819656
87354,2021-02-14,545,Capital Call,-84694,-9153503,249153,-8904350
87354,2021-02-14,545,Distribution,86238,-9153503,335391,-8818112
87354,2021-03-31,545,Value,13892750,-9153503,335391,-8818112
87354,2021-05-16,545,Distribution,5601399,-9153503,5936790,-3216713
87354,2021-06-30,545,Value,8637500,-9153503,5936790,-3216713
87354,2021-09-30,545,Value,9475020,-9153503,5936790,-3216713
87354,2021-12-31,545,Value,10171290,-9153503,5936790,-3216713
87360,2020-01-15,179668,Capital Call,-1250000,-4450000,0,-4450000
87360,2020-02-29,179668,Value,4155940,-4450000,0,-4450000
87360,2020-04-15,179668,Capital Call,-700000,-5150000,0,-5150000
87360,2020-05-31,179668,Value,4842400,-5150000,0,-5150000
87360,2020-07-16,179668,Capital Call,-975000,-6125000,0,-6125000
87360,2020-08-31,179668,Value,7074320,-6125000,0,-6125000
87360,2020-11-30,179668,Value,7131350,-6125000,0,-6125000
87360,2021-01-14,179668,Capital Call,-1975000,-8100000,0,-8100000
87360,2021-02-28,179668,Value,10071030,-8100000,0,-8100000
87360,2021-05-31,179668,Value,11393440,-8100000,0,-8100000
87360,2021-07-16,179668,Capital Call,-775000,-8875000,0,-8875000
87360,2021-08-31,179668,Value,14851380,-8875000,0,-8875000
87360,2021-10-16,179668,Capital Call,-450000,-9325000,0,-9325000
87360,2021-11-30,179668,Value,15256720,-9325000,0,-9325000
87373,2020-02-15,1357,Capital Call,-900000,-4089505,0,-4089505
87373,2020-03-31,1357,Value,4107310,-4089505,0,-4089505
87426,2020-02-15,65974,Capital Call,-600000,-3850000,0,-3850000
87426,2020-03-31,65974,Value,5280000,-3850000,0,-3850000
87426,2020-05-16,65974,Capital Call,-1500000,-5350000,0,-5350000
87426,2020-06-30,65974,Value,6822000,-5350000,0,-5350000
87426,2020-09-30,65974,Value,6910000,-5350000,0,-5350000
87426,2020-11-15,65974,Capital Call,-1000000,-6350000,0,-6350000
87426,2020-12-31,65974,Value,7960000,-6350000,0,-6350000
87439,2020-02-29,16819,Capital Call,-330414,-330414,0,-330414
87439,2020-02-29,16819,Value,125190,-330414,0,-330414
87439,2020-04-15,16819,Capital Call,-687618,-1018032,0,-1018032
87439,2020-05-31,16819,Value,751370,-1018032,0,-1018032
87439,2020-07-16,16819,Capital Call,-84133,-1102165,0,-1102165
87439,2020-08-31,16819,Value,817510,-1102165,0,-1102165
87439,2020-10-16,16819,Capital Call,-261896,-1364061,0,-1364061
87439,2020-10-16,16819,Distribution,15411,-1364061,15411,-1348650
87439,2020-11-30,16819,Value,1157330,-1364061,15411,-1348650
87439,2021-01-14,16819,Capital Call,-245273,-1609334,15411,-1593923
87439,2021-01-14,16819,Distribution,21331,-1609334,36742,-1572592
87439,2021-02-28,16819,Value,1394580,-1609334,36742,-1572592
87439,2021-04-15,16819,Capital Call,-1444673,-3054007,36742,-3017265
87439,2021-04-15,16819,Distribution,58392,-3054007,95134,-2958873
87439,2021-05-31,16819,Value,2804530,-3054007,95134,-2958873
87439,2021-07-16,16819,Capital Call,-2083868,-5137875,95134,-5042741
87439,2021-07-16,16819,Distribution,21389,-5137875,116523,-5021352
87439,2021-08-31,16819,Value,5197460,-5137875,116523,-5021352
87439,2021-10-16,16819,Distribution,184527,-5137875,301050,-4836825
87439,2021-11-30,16819,Value,5370120,-5137875,301050,-4836825
87605,2021-06-30,14045,Capital Call,-1759000,-1759000,0,-1759000
87605,2021-06-30,14045,Value,1799280,-1759000,0,-1759000
87658,2020-02-15,77,Capital Call,-1704181,-2373194,29,-2373165
87658,2020-03-31,77,Value,2558740,-2373194,29,-2373165
87658,2020-05-16,77,Capital Call,566179,-1807015,29,-1806986
87658,2020-05-16,77,Distribution,4207,-1807015,4236,-1802779
87658,2020-06-30,77,Value,1956620,-1807015,4236,-1802779
87658,2020-09-30,77,Value,2195530,-1807015,4236,-1802779
87658,2020-11-15,77,Capital Call,-255171,-2062186,4236,-2057950
87658,2020-11-15,77,Distribution,26042,-2062186,30278,-2031908
87658,2020-12-31,77,Value,2946920,-2062186,30278,-2031908
87658,2021-03-31,77,Value,3337710,-2062186,30278,-2031908
87658,2021-05-16,77,Distribution,231857,-2062186,262135,-1800051
87658,2021-06-30,77,Value,3617700,-2062186,262135,-1800051
87664,2020-07-01,902,Capital Call,-1000000,-3500000,0,-3500000
87664,2020-12-31,902,Value,4065710,-3500000,0,-3500000
87806,2020-12-31,181980,Capital Call,-33000,-33000,0,-33000
87806,2020-12-31,181980,Value,52500,-33000,0,-33000
87863,2020-02-15,443,Capital Call,-1049361,-5348687,46547,-5302140
87863,2020-03-31,443,Value,4961320,-5348687,46547,-5302140
87863,2020-06-30,443,Value,4948460,-5348687,46547,-5302140
87863,2020-08-15,443,Capital Call,-316136,-5664823,46547,-5618276
87863,2020-08-15,443,Distribution,2386,-5664823,48933,-5615890
87863,2020-09-30,443,Value,5224030,-5664823,48933,-5615890
87863,2020-12-31,443,Value,7145240,-5664823,48933,-5615890
87863,2021-02-14,443,Capital Call,-292178,-5957001,48933,-5908068
87863,2021-02-14,443,Distribution,2423818,-5957001,2472751,-3484250
87863,2021-03-31,443,Value,4066240,-5957001,2472751,-3484250
88006,2020-03-31,84797,Value,2941700,-3877702,802283,-3075419
88006,2020-07-01,84797,Capital Call,-1854924,-5732626,802283,-4930343
88006,2020-07-01,84797,Distribution,51481,-5732626,853764,-4878862
88006,2020-09-30,84797,Value,4619410,-5732626,853764,-4878862
88006,2020-11-15,84797,Capital Call,-1042499,-6775125,853764,-5921361
88006,2020-12-31,84797,Value,6672390,-6775125,853764,-5921361
88006,2021-02-14,84797,Capital Call,-1801187,-8576312,853764,-7722548
88006,2021-02-14,84797,Distribution,60171,-8576312,913935,-7662377
88006,2021-03-31,84797,Value,9161430,-8576312,913935,-7662377
88011,2020-02-15,502,Capital Call,-1035938,-6746876,0,-6746876
88011,2020-03-31,502,Value,7329180,-6746876,0,-6746876
88312,2020-03-31,1357,Value,3649210,-3600000,0,-3600000
88312,2020-05-16,1357,Capital Call,-500000,-4100000,0,-4100000
88312,2020-06-30,1357,Value,4399960,-4100000,0,-4100000
88312,2020-09-30,1357,Value,4683940,-4100000,0,-4100000
88312,2020-11-15,1357,Capital Call,-1000000,-5100000,0,-5100000
88312,2020-12-31,1357,Value,7291490,-5100000,0,-5100000
88312,2021-02-14,1357,Capital Call,-500000,-5600000,0,-5600000
88312,2021-02-14,1357,Distribution,210080,-5600000,210080,-5389920
88312,2021-03-31,1357,Value,8799600,-5600000,210080,-5389920
88314,2020-04-30,187,Capital Call,-779034,-779034,0,-779034
88314,2020-06-30,187,Value,635560,-779034,0,-779034
88314,2020-09-30,187,Value,582940,-779034,0,-779034
88314,2020-11-15,187,Capital Call,-543424,-1322458,0,-1322458
88314,2020-12-31,187,Value,1126360,-1322458,0,-1322458
88314,2021-01-16,187,Capital Call,-529186,-1851644,0,-1851644
88314,2021-03-31,187,Value,1545180,-1851644,0,-1851644
88314,2021-05-16,187,Capital Call,-245353,-2096997,0,-2096997
88314,2021-06-15,187,Capital Call,1,-2096996,0,-2096996
88314,2021-06-30,187,Value,1741110,-2096996,0,-2096996
88314,2021-08-15,187,Capital Call,-368597,-2465593,0,-2465593
88314,2021-09-30,187,Value,2053590,-2465593,0,-2465593
88317,2020-02-15,9407,Capital Call,-3459286,-4210000,0,-4210000
88317,2020-03-31,9407,Value,4075280,-4210000,0,-4210000
88317,2020-06-30,9407,Value,4181370,-4210000,0,-4210000
88317,2020-08-15,9407,Capital Call,-1800000,-6010000,0,-6010000
88317,2020-09-30,9407,Value,6082720,-6010000,0,-6010000
88317,2020-11-15,9407,Capital Call,-1901000,-7911000,0,-7911000
88317,2020-12-31,9407,Value,9269310,-7911000,0,-7911000
88317,2021-03-31,9407,Value,11135520,-7911000,0,-7911000
88317,2021-06-30,9407,Value,12176610,-7911000,0,-7911000
88317,2021-08-15,9407,Capital Call,-351000,-8262000,0,-8262000
88317,2021-09-30,9407,Value,12092260,-8262000,0,-8262000
88497,2020-02-15,2007,Capital Call,-980000,-3030000,0,-3030000
88497,2020-03-31,2007,Value,3051210,-3030000,0,-3030000
88497,2020-05-16,2007,Capital Call,-1750000,-4780000,0,-4780000
88497,2020-06-30,2007,Value,5109820,-4780000,0,-4780000
88497,2020-08-15,2007,Capital Call,-680000,-5460000,0,-5460000
88497,2020-09-30,2007,Value,6087900,-5460000,0,-5460000
88497,2020-12-31,2007,Value,7032480,-5460000,0,-5460000
88497,2021-02-14,2007,Capital Call,-2520000,-7980000,0,-7980000
88497,2021-02-14,2007,Distribution,343140,-7980000,343140,-7636860
88497,2021-03-31,2007,Value,10677240,-7980000,343140,-7636860
88497,2021-07-01,2007,Capital Call,-1510000,-9490000,343140,-9146860
88497,2021-07-01,2007,Distribution,1393530,-9490000,1736670,-7753330
88497,2021-09-30,2007,Value,13200590,-9490000,1736670,-7753330
88497,2021-12-31,2007,Value,13703560,-9490000,1736670,-7753330
88620,2020-02-15,756,Capital Call,-306134,-1473484,0,-1473484
88620,2020-03-31,756,Value,748370,-1473484,0,-1473484
88620,2020-05-16,756,Capital Call,-444248,-1917732,0,-1917732
88620,2020-06-30,756,Value,1462510,-1917732,0,-1917732
88620,2020-08-15,756,Capital Call,-1106851,-3024583,0,-3024583
88620,2020-09-30,756,Value,2649720,-3024583,0,-3024583
88620,2020-11-15,756,Capital Call,-267746,-3292329,0,-3292329
88620,2020-12-31,756,Value,3285270,-3292329,0,-3292329
88620,2021-02-14,756,Capital Call,-683750,-3976079,0,-3976079
88620,2021-02-14,756,Distribution,49923,-3976079,49923,-3926156
88620,2021-03-31,756,Value,4335240,-3976079,49923,-3926156
88620,2021-05-16,756,Capital Call,-796979,-4773058,49923,-4723135
88620,2021-06-30,756,Value,5527920,-4773058,49923,-4723135
88686,2020-01-15,9022,Capital Call,-1000000,-3700000,0,-3700000
88686,2020-02-29,9022,Value,3339470,-3700000,0,-3700000
88686,2020-04-15,9022,Capital Call,-500000,-4200000,0,-4200000
88686,2020-05-31,9022,Value,3741250,-4200000,0,-4200000
88686,2020-07-16,9022,Capital Call,-1000000,-5200000,0,-5200000
88686,2020-08-31,9022,Value,4751110,-5200000,0,-5200000
88686,2020-10-16,9022,Capital Call,-200000,-5400000,0,-5400000
88686,2020-11-30,9022,Value,5022340,-5400000,0,-5400000
88686,2021-01-14,9022,Capital Call,-700000,-6100000,0,-6100000
88686,2021-02-28,9022,Value,5722340,-6100000,0,-6100000
88686,2021-04-15,9022,Capital Call,-400000,-6500000,0,-6500000
88686,2021-05-31,9022,Value,7332430,-6500000,0,-6500000
88686,2021-07-16,9022,Capital Call,-1300000,-7800000,0,-7800000
88686,2021-08-31,9022,Value,9323910,-7800000,0,-7800000
88686,2021-11-30,9022,Value,9850660,-7800000,0,-7800000
88689,2020-01-15,9022,Capital Call,-1400000,-8400000,0,-8400000
88689,2020-02-29,9022,Value,9022180,-8400000,0,-8400000
88689,2020-04-15,9022,Capital Call,-300000,-8700000,0,-8700000
88689,2020-04-15,9022,Distribution,2194417,-8700000,2194417,-6505583
88689,2020-05-31,9022,Value,7986320,-8700000,2194417,-6505583
88689,2020-07-16,9022,Capital Call,-400000,-9100000,2194417,-6905583
88689,2020-08-31,9022,Value,9941770,-9100000,2194417,-6905583
88689,2020-10-16,9022,Capital Call,-300000,-9400000,2194417,-7205583
88689,2020-10-16,9022,Distribution,6377660,-9400000,8572077,-827923
88689,2020-11-30,9022,Value,5622480,-9400000,8572077,-827923
88689,2021-02-28,9022,Value,5622480,-9400000,8572077,-827923
88689,2021-05-31,9022,Value,6758050,-9400000,8572077,-827923
88689,2021-07-16,9022,Capital Call,-200000,-9600000,8572077,-1027923
88689,2021-08-31,9022,Value,7366910,-9600000,8572077,-1027923
88689,2021-11-30,9022,Value,6689210,-9600000,8572077,-1027923
88742,2020-03-31,795,Value,1775600,-1930000,0,-1930000
88742,2020-05-16,795,Capital Call,-380000,-2310000,0,-2310000
88742,2020-06-30,795,Value,2125200,-2310000,0,-2310000
88742,2020-08-15,795,Capital Call,-760000,-3070000,0,-3070000
88742,2020-09-30,795,Value,3039300,-3070000,0,-3070000
88742,2020-11-15,795,Capital Call,-1490000,-4560000,0,-4560000
88742,2020-12-31,795,Value,4742400,-4560000,0,-4560000
88742,2021-02-14,795,Capital Call,-420000,-4980000,0,-4980000
88742,2021-02-14,795,Distribution,99600,-4980000,99600,-4880400
88742,2021-03-31,795,Value,5577600,-4980000,99600,-4880400
88742,2021-05-16,795,Capital Call,-1860000,-6840000,99600,-6740400
88742,2021-05-16,795,Distribution,-31200,-6840000,68400,-6771600
88742,2021-06-30,795,Value,8139600,-6840000,68400,-6771600
88742,2021-08-15,795,Capital Call,-660000,-7500000,68400,-7431600
88742,2021-08-15,795,Distribution,6600,-7500000,75000,-7425000
88742,2021-09-30,795,Value,9300000,-7500000,75000,-7425000
88742,2021-11-15,795,Capital Call,-1080000,-8580000,75000,-8505000
88742,2021-11-15,795,Distribution,10800,-8580000,85800,-8494200
88742,2021-12-31,795,Value,11239800,-8580000,85800,-8494200
88744,2020-02-15,333,Capital Call,-37500,-1165818,0,-1165818
88744,2020-03-31,333,Value,929350,-1165818,0,-1165818
88744,2020-05-16,333,Capital Call,-907220,-2073038,0,-2073038
88744,2020-06-30,333,Value,2149350,-2073038,0,-2073038
88744,2020-08-15,333,Capital Call,-37500,-2110538,0,-2110538
88744,2020-09-30,333,Value,2161800,-2110538,0,-2110538
88744,2020-11-15,333,Capital Call,-37500,-2148038,0,-2148038
88744,2020-12-31,333,Value,2156560,-2148038,0,-2148038
88744,2021-02-14,333,Capital Call,-16844,-2164882,0,-2164882
88744,2021-03-31,333,Value,2173400,-2164882,0,-2164882
88744,2021-05-16,333,Capital Call,-1417464,-3582346,0,-3582346
88744,2021-06-30,333,Value,3521420,-3582346,0,-3582346
88744,2021-08-15,333,Capital Call,-98101,-3680447,0,-3680447
88744,2021-09-30,333,Value,3568680,-3680447,0,-3680447
88745,2020-09-21,81754,Capital Call,-995,-8508,0,-8508
88745,2020-12-31,81754,Value,13040,-8508,0,-8508
88914,2020-02-15,664,Capital Call,-302326,-7302327,46512,-7255815
88914,2020-03-31,664,Value,7395340,-7302327,46512,-7255815
88914,2020-05-16,664,Capital Call,-1697674,-9000001,46512,-8953489
88914,2020-05-16,664,Distribution,139535,-9000001,186047,-8813954
88914,2020-06-30,664,Value,9767440,-9000001,186047,-8813954
88914,2020-08-15,664,Capital Call,-651163,-9651164,186047,-9465117
88914,2020-09-30,664,Value,10674410,-9651164,186047,-9465117
88914,2020-11-15,664,Capital Call,-372093,-10023257,186047,-9837210
88914,2020-12-31,664,Value,15837200,-10023257,186047,-9837210
88914,2021-02-14,664,Capital Call,-69767,-10093024,186047,-9906977
88914,2021-02-14,664,Distribution,93023,-10093024,279070,-9813954
88914,2021-03-31,664,Value,14813950,-10093024,279070,-9813954
88914,2021-05-16,664,Capital Call,-922977,-11016001,279070,-10736931
88914,2021-05-16,664,Distribution,1037342,-11016001,1316412,-9699589
88914,2021-06-30,664,Value,15888370,-11016001,1316412,-9699589
88914,2021-08-15,664,Capital Call,-378000,-11394001,1316412,-10077589
88914,2021-08-15,664,Distribution,589804,-11394001,1906216,-9487785
88914,2021-09-30,664,Value,14405430,-11394001,1906216,-9487785
88917,2020-06-30,664,Value,7276610,-5900000,0,-5900000
88924,2020-06-30,664,Value,10982290,-8957673,654908,-8302765
88925,2020-06-30,664,Value,5642820,-5100000,0,-5100000
89199,2020-02-15,18,Capital Call,-850255,-2440618,0,-2440618
89199,2020-03-31,18,Value,2467660,-2440618,0,-2440618
89199,2020-05-16,18,Capital Call,-549456,-2990074,0,-2990074
89199,2020-06-30,18,Value,3349570,-2990074,0,-2990074
89199,2020-09-30,18,Value,3687400,-2990074,0,-2990074
89199,2020-11-15,18,Capital Call,-655016,-3645090,0,-3645090
89199,2020-11-15,18,Distribution,208005,-3645090,208005,-3437085
89199,2020-12-31,18,Value,4975530,-3645090,208005,-3437085
89199,2021-02-14,18,Capital Call,-550014,-4195104,208005,-3987099
89199,2021-03-31,18,Value,6439040,-4195104,208005,-3987099
89199,2021-05-16,18,Capital Call,-429966,-4625070,208005,-4417065
89199,2021-05-16,18,Distribution,-2,-4625070,208003,-4417067
89199,2021-06-30,18,Value,7846120,-4625070,208003,-4417067
89199,2021-09-30,18,Value,8825410,-4625070,208003,-4417067
89355,2020-03-31,741,Value,1663530,-2020615,0,-2020615
89355,2020-05-16,741,Capital Call,-477077,-2497692,0,-2497692
89355,2020-06-30,741,Value,2133840,-2497692,0,-2497692
89355,2020-08-15,741,Capital Call,-892923,-3390615,0,-3390615
89355,2020-09-30,741,Value,3251690,-3390615,0,-3390615
89355,2020-12-31,741,Value,3635070,-3390615,0,-3390615
89355,2021-02-14,741,Capital Call,-1277385,-4668000,0,-4668000
89355,2021-03-31,741,Value,5233690,-4668000,0,-4668000
89355,2021-05-16,741,Capital Call,-276154,-4944154,0,-4944154
89355,2021-06-30,741,Value,6309380,-4944154,0,-4944154
89434,2020-03-31,8723,Value,321840,-675000,0,-675000
89434,2020-05-16,8723,Capital Call,-213000,-888000,0,-888000
89434,2020-06-30,8723,Value,544960,-888000,0,-888000
89434,2020-09-30,8723,Value,630300,-888000,0,-888000
89434,2020-11-15,8723,Capital Call,-184000,-1072000,0,-1072000
89434,2020-12-31,8723,Value,728740,-1072000,0,-1072000
89434,2021-02-14,8723,Capital Call,-1903807,-2975807,0,-2975807
89434,2021-03-31,8723,Value,2703310,-2975807,0,-2975807
89434,2021-05-16,8723,Capital Call,-193,-2976000,0,-2976000
89434,2021-06-30,8723,Value,2813800,-2976000,0,-2976000
89446,2020-02-29,733,Capital Call,-291047,-291047,0,-291047
89446,2020-02-29,733,Value,59130,-291047,0,-291047
89446,2020-04-15,733,Capital Call,-933221,-1224268,0,-1224268
89446,2020-05-31,733,Value,914970,-1224268,0,-1224268
89446,2020-07-16,733,Capital Call,-550389,-1774657,0,-1774657
89446,2020-08-31,733,Value,1450040,-1774657,0,-1774657
89446,2020-11-30,733,Value,1545100,-1774657,0,-1774657
89446,2021-01-14,733,Capital Call,-1043938,-2818595,0,-2818595
89446,2021-01-14,733,Distribution,453223,-2818595,453223,-2365372
89446,2021-02-28,733,Value,2863140,-2818595,453223,-2365372
89446,2021-04-15,733,Distribution,122505,-2818595,575728,-2242867
89446,2021-05-31,733,Value,3150520,-2818595,575728,-2242867
89446,2021-07-16,733,Capital Call,-748921,-3567516,575728,-2991788
89446,2021-07-16,733,Distribution,282994,-3567516,858722,-2708794
89446,2021-08-31,733,Value,8225560,-3567516,858722,-2708794
89446,2021-10-16,733,Capital Call,-537973,-4105489,858722,-3246767
89446,2021-11-30,733,Value,6094070,-4105489,858722,-3246767
89496,2020-02-15,44656,Capital Call,-5206000,-7908000,0,-7908000
89496,2020-03-31,44656,Value,8332000,-7908000,0,-7908000
89496,2020-06-30,44656,Value,8896000,-7908000,0,-7908000
89496,2020-08-15,44656,Capital Call,550000,-7358000,0,-7358000
89496,2020-08-15,44656,Distribution,90000,-7358000,90000,-7268000
89496,2020-09-30,44656,Value,9802000,-7358000,90000,-7268000
89496,2020-11-15,44656,Capital Call,-1908000,-9266000,90000,-9176000
89496,2020-12-31,44656,Value,12874000,-9266000,90000,-9176000
89502,2020-03-31,112079,Capital Call,-750000,-5750000,0,-5750000
89502,2020-09-30,112079,Value,6440000,-5750000,0,-5750000
89963,2020-02-15,116062,Capital Call,-337003,-6620200,1870019,-4750181
89963,2020-02-15,116062,Distribution,342349,-6620200,2212368,-4407832
89963,2020-03-31,116062,Value,7632610,-6620200,2212368,-4407832
89963,2020-05-16,116062,Distribution,1543957,-6620200,3756325,-2863875
89963,2020-06-30,116062,Value,7214690,-6620200,3756325,-2863875
89963,2020-08-15,116062,Capital Call,-98801,-6719001,3756325,-2962676
89963,2020-08-15,116062,Distribution,320763,-6719001,4077088,-2641913
89963,2020-09-30,116062,Value,9850050,-6719001,4077088,-2641913
89963,2020-11-15,116062,Capital Call,-547000,-7266001,4077088,-3188913
89963,2020-11-15,116062,Distribution,424198,-7266001,4501286,-2764715
89963,2020-12-31,116062,Value,12472810,-7266001,4501286,-2764715
89963,2021-02-14,116062,Capital Call,-874000,-8140001,4501286,-3638715
89963,2021-02-14,116062,Distribution,301313,-8140001,4802599,-3337402
89963,2021-03-31,116062,Value,14082200,-8140001,4802599,-3337402
89963,2021-05-16,116062,Capital Call,-820000,-8960001,4802599,-4157402
89963,2021-05-16,116062,Distribution,304600,-8960001,5107199,-3852802
89963,2021-06-30,116062,Value,16934390,-8960001,5107199,-3852802
89963,2021-08-15,116062,Capital Call,-120000,-9080001,5107199,-3972802
89963,2021-08-15,116062,Distribution,1339600,-9080001,6446799,-2633202
89963,2021-09-30,116062,Value,13892390,-9080001,6446799,-2633202
90046,2020-12-31,18,Capital Call,-820000,-820000,0,-820000
90046,2020-12-31,18,Value,1010890,-820000,0,-820000
90046,2021-02-14,18,Capital Call,-435000,-1255000,0,-1255000
90046,2021-03-31,18,Value,1432450,-1255000,0,-1255000
90046,2021-05-16,18,Capital Call,755000,-500000,0,-500000
90046,2021-06-30,18,Value,664740,-500000,0,-500000
90134,2020-02-15,11706,Capital Call,-300000,-2700000,0,-2700000
90134,2020-03-31,11706,Value,4023000,-2700000,0,-2700000
90134,2020-05-16,11706,Capital Call,-400000,-3100000,0,-3100000
90134,2020-06-30,11706,Value,4247000,-3100000,0,-3100000
90134,2020-08-15,11706,Capital Call,-800000,-3900000,0,-3900000
90134,2020-08-15,11706,Distribution,2340000,-3900000,2340000,-1560000
90134,2020-09-30,11706,Value,6006000,-3900000,2340000,-1560000
90134,2020-11-15,11706,Capital Call,-500000,-4400000,2340000,-2060000
90134,2020-11-15,11706,Distribution,-8000,-4400000,2332000,-2068000
90134,2020-12-31,11706,Value,6512000,-4400000,2332000,-2068000
90134,2021-03-31,11706,Value,6512000,-4400000,2332000,-2068000
90134,2021-05-16,11706,Capital Call,-1400000,-5800000,2332000,-3468000
90134,2021-05-16,11706,Distribution,-12000,-5800000,2320000,-3480000
90134,2021-06-30,11706,Value,7656000,-5800000,2320000,-3480000
90134,2021-09-30,11706,Value,7424000,-5800000,2320000,-3480000
90135,2021-02-14,111,Capital Call,-1077130,-1077130,0,-1077130
90135,2021-03-31,111,Value,1000890,-1077130,0,-1077130
90135,2021-05-16,111,Capital Call,-172045,-1249175,0,-1249175
90135,2021-06-30,111,Value,1274070,-1249175,0,-1249175
90135,2021-08-15,111,Capital Call,-1949956,-3199131,0,-3199131
90135,2021-08-15,111,Distribution,109803,-3199131,109803,-3089328
90135,2021-09-30,111,Value,3390560,-3199131,109803,-3089328
90289,2020-03-31,1759,Value,751800,-1100000,0,-1100000
90289,2020-05-16,1759,Capital Call,-1000000,-2100000,0,-2100000
90289,2020-06-30,1759,Value,1747400,-2100000,0,-2100000
90289,2020-09-30,1759,Value,1972800,-2100000,0,-2100000
90289,2020-11-15,1759,Capital Call,-1000000,-3100000,0,-3100000
90289,2020-12-31,1759,Value,3235800,-3100000,0,-3100000
90289,2021-03-31,1759,Value,3456200,-3100000,0,-3100000
90368,2020-02-15,40167,Capital Call,-732357,-5384902,949898,-4435004
90368,2020-03-31,40167,Value,4622130,-5384902,949898,-4435004
90368,2020-05-16,40167,Capital Call,-1026851,-6411753,949898,-5461855
90368,2020-06-30,40167,Value,5777230,-6411753,949898,-5461855
90368,2020-08-15,40167,Capital Call,-451179,-6862932,949898,-5913034
90368,2020-09-30,40167,Value,6403170,-6862932,949898,-5913034
90368,2020-11-15,40167,Capital Call,-720406,-7583338,949898,-6633440
90368,2020-11-15,40167,Distribution,42870,-7583338,992768,-6590570
90368,2020-12-31,40167,Value,7414480,-7583338,992768,-6590570
90368,2021-02-14,40167,Capital Call,-740175,-8323513,992768,-7330745
90368,2021-02-14,40167,Distribution,432662,-8323513,1425430,-6898083
90368,2021-03-31,40167,Value,7857280,-8323513,1425430,-6898083
90666,2020-03-31,9052,Value,7109060,-6384841,4173,-6380668
90666,2020-05-16,9052,Capital Call,-1208155,-7592996,4173,-7588823
90666,2020-06-30,9052,Value,8941640,-7592996,4173,-7588823
90666,2020-08-15,9052,Capital Call,-939660,-8532656,4173,-8528483
90666,2020-08-15,9052,Distribution,125000,-8532656,129173,-8403483
90666,2020-09-30,9052,Value,11333970,-8532656,129173,-8403483
90894,2020-03-31,192302,Value,2321600,-2576470,0,-2576470
90894,2020-05-16,192302,Capital Call,-576470,-3152940,0,-3152940
90894,2020-06-30,192302,Value,2994440,-3152940,0,-3152940
90894,2020-08-15,192302,Capital Call,-922353,-4075293,0,-4075293
90894,2020-09-30,192302,Value,3847400,-4075293,0,-4075293
91008,2020-02-15,1759,Capital Call,-400000,-5135000,0,-5135000
91008,2020-03-31,1759,Value,5695140,-5135000,0,-5135000
91008,2020-05-16,1759,Capital Call,-250000,-5385000,0,-5385000
91008,2020-06-30,1759,Value,5945140,-5385000,0,-5385000
91008,2020-08-15,1759,Capital Call,-550000,-5935000,0,-5935000
91008,2020-09-30,1759,Value,7659980,-5935000,0,-5935000
91008,2020-11-15,1759,Capital Call,-500000,-6435000,0,-6435000
91008,2020-11-15,1759,Distribution,937815,-6435000,937815,-5497185
91008,2020-12-31,1759,Value,8067790,-6435000,937815,-5497185
91008,2021-02-14,1759,Capital Call,-412776,-6847776,937815,-5909961
91008,2021-02-14,1759,Distribution,212364,-6847776,1150179,-5697597
91008,2021-03-31,1759,Value,9063800,-6847776,1150179,-5697597
91023,2020-03-31,17601,Value,1094790,-1499723,0,-1499723
91023,2020-06-30,17601,Value,1049800,-1499723,0,-1499723
91023,2020-09-30,17601,Capital Call,-1900277,-3400000,0,-3400000
91023,2020-12-31,17601,Value,2924000,-3400000,0,-3400000
91023,2021-03-31,17601,Value,3196000,-3400000,0,-3400000
91023,2021-06-30,17601,Value,3094000,-3400000,0,-3400000
91023,2021-08-15,17601,Capital Call,-1000000,-4400000,0,-4400000
91023,2021-09-30,17601,Value,3960000,-4400000,0,-4400000
91242,2020-12-31,212,Capital Call,-676364,-676364,0,-676364
91242,2020-12-31,212,Value,570900,-676364,0,-676364
91242,2021-03-31,212,Value,509090,-676364,0,-676364
91242,2021-06-30,212,Value,421810,-676364,0,-676364
91242,2021-08-15,212,Capital Call,-1455,-677819,0,-677819
91242,2021-09-30,212,Value,420720,-677819,0,-677819
91245,2020-03-31,18,Value,4129160,-4290000,0,-4290000
91245,2020-06-30,18,Value,4826430,-4290000,0,-4290000
91245,2020-08-15,18,Capital Call,-950000,-5240000,0,-5240000
91245,2020-09-30,18,Value,6556410,-5240000,0,-5240000
91245,2020-11-15,18,Capital Call,-1030000,-6270000,0,-6270000
91245,2020-12-31,18,Value,9127010,-6270000,0,-6270000
91245,2021-03-31,18,Value,10027810,-6270000,0,-6270000
91245,2021-05-16,18,Capital Call,-400000,-6670000,0,-6670000
91245,2021-06-30,18,Value,11582150,-6670000,0,-6670000
91328,2020-02-15,70,Capital Call,-834480,-1696470,133627,-1562843
91328,2020-02-15,70,Distribution,71250,-1696470,204877,-1491593
91328,2020-03-31,70,Value,1651400,-1696470,204877,-1491593
91328,2020-06-30,70,Value,2028890,-1696470,204877,-1491593
91328,2020-08-15,70,Capital Call,-750356,-2446826,204877,-2241949
91328,2020-08-15,70,Distribution,34866,-2446826,239743,-2207083
91328,2020-09-30,70,Value,3029610,-2446826,239743,-2207083
91328,2020-12-31,70,Value,3357810,-2446826,239743,-2207083
91328,2021-03-31,70,Value,3941520,-2446826,239743,-2207083
91328,2021-05-16,70,Capital Call,-1999059,-4445885,239743,-4206142
91328,2021-05-16,70,Distribution,284556,-4445885,524299,-3921586
91328,2021-06-30,70,Value,6697220,-4445885,524299,-3921586
91331,2020-02-15,47993,Capital Call,-794583,-1902472,0,-1902472
91331,2020-03-31,47993,Value,1563170,-1902472,0,-1902472
91331,2020-05-16,47993,Capital Call,-383203,-2285675,0,-2285675
91331,2020-06-30,47993,Value,2023830,-2285675,0,-2285675
91331,2020-08-15,47993,Capital Call,-32470,-2318145,0,-2318145
91331,2020-09-30,47993,Value,2063090,-2318145,0,-2318145
91331,2020-11-15,47993,Capital Call,-3673529,-5991674,0,-5991674
91331,2020-12-31,47993,Value,5940180,-5991674,0,-5991674
91331,2021-03-31,47993,Value,6298860,-5991674,0,-5991674
91331,2021-05-16,47993,Capital Call,7383,-5984291,0,-5984291
91331,2021-06-30,47993,Value,7542970,-5984291,0,-5984291
91331,2021-08-15,47993,Capital Call,-25709,-6010000,0,-6010000
91331,2021-08-15,47993,Distribution,16227,-6010000,16227,-5993773
91331,2021-09-30,47993,Value,8487920,-6010000,16227,-5993773
91621,2020-02-15,20998,Capital Call,-662459,-1662000,0,-1662000
91621,2020-03-31,20998,Value,1567930,-1662000,0,-1662000
91621,2020-06-30,20998,Value,2207130,-1662000,0,-1662000
91621,2020-08-15,20998,Capital Call,-284134,-1946134,0,-1946134
91621,2020-09-30,20998,Value,2569500,-1946134,0,-1946134
91621,2020-11-15,20998,Capital Call,-1477994,-3424128,0,-3424128
91621,2020-11-15,20998,Distribution,413673,-3424128,413673,-3010455
91621,2020-12-31,20998,Value,4416120,-3424128,413673,-3010455
91621,2021-03-31,20998,Value,5035230,-3424128,413673,-3010455
91892,2021-06-30,519,Capital Call,-1500000,-1500000,0,-1500000
91892,2021-06-30,519,Distribution,420000,-1500000,420000,-1080000
91892,2021-06-30,519,Value,1950000,-1500000,420000,-1080000
92026,2020-02-15,423991,Capital Call,-901460,-3470803,36496,-3434307
92026,2020-03-31,423991,Value,3755470,-3470803,36496,-3434307
92026,2020-05-16,423991,Capital Call,18248,-3452555,36496,-3416059
92026,2020-06-30,423991,Value,3846710,-3452555,36496,-3416059
92026,2020-08-15,423991,Capital Call,-850365,-4302920,36496,-4266424
92026,2020-09-30,423991,Value,4835760,-4302920,36496,-4266424
92026,2020-11-15,423991,Distribution,251825,-4302920,288321,-4014599
92026,2020-12-31,423991,Value,5905100,-4302920,288321,-4014599
92026,2021-02-14,423991,Capital Call,-817518,-5120438,288321,-4832117
92026,2021-02-14,423991,Distribution,883212,-5120438,1171533,-3948905
92026,2021-03-31,423991,Value,6324810,-5120438,1171533,-3948905
92026,2021-05-16,423991,Capital Call,-200730,-5321168,1171533,-4149635
92026,2021-06-30,423991,Value,6445250,-5321168,1171533,-4149635
92026,2021-08-15,423991,Capital Call,-709124,-6030292,1171533,-4858759
92026,2021-08-15,423991,Distribution,188321,-6030292,1359854,-4670438
92026,2021-09-30,423991,Value,7200360,-6030292,1359854,-4670438
92411,2020-03-31,20998,Capital Call,-1998163,-1998163,0,-1998163
92411,2020-03-31,20998,Distribution,82589,-1998163,82589,-1915574
92411,2020-03-31,20998,Value,1936270,-1998163,82589,-1915574
92411,2020-05-16,20998,Capital Call,0,-1998163,82589,-1915574
92411,2020-06-30,20998,Value,1995050,-1998163,82589,-1915574
92411,2020-09-30,20998,Value,2168920,-1998163,82589,-1915574
92411,2020-11-15,20998,Capital Call,-205831,-2203994,82589,-2121405
92411,2020-12-31,20998,Value,2580520,-2203994,82589,-2121405
92411,2021-03-31,20998,Value,2736740,-2203994,82589,-2121405
92411,2021-06-30,20998,Value,3199560,-2203994,82589,-2121405
92411,2021-08-15,20998,Capital Call,-1064622,-3268616,82589,-3186027
92411,2021-08-15,20998,Distribution,935053,-3268616,1017642,-2250974
92411,2021-09-30,20998,Value,5349810,-3268616,1017642,-2250974
92419,2020-02-15,59783,Capital Call,-505996,-3530267,0,-3530267
92419,2020-03-31,59783,Value,3235880,-3530267,0,-3530267
92419,2020-05-16,59783,Capital Call,-559403,-4089670,0,-4089670
92419,2020-06-30,59783,Value,3973210,-4089670,0,-4089670
92419,2020-09-30,59783,Value,4214880,-4089670,0,-4089670
92419,2020-11-15,59783,Capital Call,-560767,-4650437,0,-4650437
92419,2020-12-31,59783,Value,5372090,-4650437,0,-4650437
92419,2021-02-14,59783,Capital Call,-377733,-5028170,0,-5028170
92419,2021-03-31,59783,Value,7530530,-5028170,0,-5028170
92419,2021-05-16,59783,Capital Call,-490756,-5518926,0,-5518926
92419,2021-06-30,59783,Value,9022370,-5518926,0,-5518926
92548,2020-01-15,2238,Capital Call,-1100000,-3400000,0,-3400000
92548,2020-02-29,2238,Value,3289170,-3400000,0,-3400000
92548,2020-04-15,2238,Capital Call,-650000,-4050000,0,-4050000
92548,2020-05-31,2238,Value,3909430,-4050000,0,-4050000
92548,2020-07-16,2238,Capital Call,-700000,-4750000,0,-4750000
92548,2020-08-31,2238,Value,4735190,-4750000,0,-4750000
92548,2020-10-16,2238,Capital Call,-1500000,-6250000,0,-6250000
92548,2020-11-30,2238,Value,6460720,-6250000,0,-6250000
92548,2021-01-14,2238,Capital Call,-1500000,-7750000,0,-7750000
92548,2021-02-28,2238,Value,7960720,-7750000,0,-7750000
92548,2021-04-15,2238,Capital Call,-900000,-8650000,0,-8650000
92548,2021-05-31,2238,Value,11534570,-8650000,0,-8650000
92548,2021-07-16,2238,Capital Call,-300000,-8950000,0,-8950000
92548,2021-08-31,2238,Value,12503660,-8950000,0,-8950000
92548,2021-10-16,2238,Capital Call,-250000,-9200000,0,-9200000
92548,2021-11-30,2238,Value,13705940,-9200000,0,-9200000
92623,2020-02-15,62096,Capital Call,-200000,-504857,0,-504857
92623,2020-03-31,62096,Value,280850,-504857,0,-504857
92623,2020-06-30,62096,Value,273420,-504857,0,-504857
92623,2020-09-30,62096,Value,317710,-504857,0,-504857
92623,2020-12-31,62096,Value,304570,-504857,0,-504857
92623,2021-03-31,62096,Value,275420,-504857,0,-504857
92623,2021-05-16,62096,Capital Call,-504571,-1009428,0,-1009428
92623,2021-06-30,62096,Value,829710,-1009428,0,-1009428
93149,2020-02-15,94243,Capital Call,-2000000,-10000000,0,-10000000
93149,2020-03-31,94243,Value,12800000,-10000000,0,-10000000
93149,2020-09-30,94243,Value,12200000,-10000000,0,-10000000
93149,2021-03-31,94243,Value,14700000,-10000000,0,-10000000
93149,2021-09-30,94243,Value,16900000,-10000000,0,-10000000
93313,2020-03-31,25,Capital Call,-61025,-1116382,0,-1116382
93313,2020-06-30,25,Value,1046650,-1116382,0,-1116382
93313,2020-08-15,25,Capital Call,-518636,-1635018,0,-1635018
93313,2020-09-30,25,Value,1512770,-1635018,0,-1635018
93313,2020-11-15,25,Capital Call,-38194,-1673212,0,-1673212
93313,2020-12-31,25,Value,1667950,-1673212,0,-1673212
93314,2020-02-15,21861,Capital Call,-330000,-5290000,0,-5290000
93314,2020-03-31,21861,Value,4374830,-5290000,0,-5290000
93314,2020-06-30,21861,Value,4332510,-5290000,0,-5290000
93314,2020-08-15,21861,Capital Call,-570000,-5860000,0,-5860000
93314,2020-09-30,21861,Value,5725220,-5860000,0,-5860000
93314,2020-11-15,21861,Capital Call,-408000,-6268000,0,-6268000
93314,2020-12-31,21861,Value,7191900,-6268000,0,-6268000
93314,2021-03-31,21861,Value,7658240,-6268000,0,-6268000
93314,2021-05-16,21861,Capital Call,-665000,-6933000,0,-6933000
93314,2021-06-30,21861,Value,9357470,-6933000,0,-6933000
93314,2021-08-15,21861,Capital Call,-1967000,-8900000,0,-8900000
93314,2021-08-15,21861,Distribution,666610,-8900000,666610,-8233390
93314,2021-09-30,21861,Value,11713290,-8900000,666610,-8233390
93314,2021-12-31,21861,Value,13803900,-8900000,666610,-8233390
93377,2020-03-31,8258,Value,875670,-1373133,0,-1373133
93377,2020-05-16,8258,Capital Call,-1223277,-2596410,0,-2596410
93377,2020-06-30,8258,Value,2263350,-2596410,0,-2596410
93377,2020-08-15,8258,Capital Call,-314411,-2910821,0,-2910821
93377,2020-09-30,8258,Value,2917220,-2910821,0,-2910821
93590,2020-03-31,28684,Value,844880,-1181518,0,-1181518
93590,2020-05-16,28684,Capital Call,-402640,-1584158,0,-1584158
93590,2020-05-16,28684,Distribution,72607,-1584158,72607,-1511551
93590,2020-06-30,28684,Value,1432340,-1584158,72607,-1511551
93590,2020-09-30,28684,Value,1716170,-1584158,72607,-1511551
93590,2020-11-15,28684,Capital Call,-99010,-1683168,72607,-1610561
93590,2020-12-31,28684,Value,1867980,-1683168,72607,-1610561
93590,2021-03-31,28684,Value,2000000,-1683168,72607,-1610561
93590,2021-06-30,28684,Value,2112210,-1683168,72607,-1610561
93590,2021-08-15,28684,Capital Call,-1458746,-3141914,72607,-3069307
93590,2021-09-30,28684,Value,3452140,-3141914,72607,-3069307
93599,2020-02-15,783,Capital Call,-592500,-2086667,0,-2086667
93599,2020-03-31,783,Value,1766070,-2086667,0,-2086667
93599,2020-05-16,783,Capital Call,-724183,-2810850,0,-2810850
93599,2020-06-30,783,Value,2668920,-2810850,0,-2810850
93599,2020-09-30,783,Capital Call,-1646200,-4457050,0,-4457050
93599,2020-12-31,783,Value,5008580,-4457050,0,-4457050
93599,2021-02-14,783,Capital Call,-285833,-4742883,0,-4742883
93599,2021-03-31,783,Value,6276450,-4742883,0,-4742883
93599,2021-05-16,783,Capital Call,-1792125,-6535008,0,-6535008
93599,2021-06-30,783,Value,9318820,-6535008,0,-6535008
94192,2020-02-15,674,Capital Call,-863311,-7912334,3770,-7908564
94192,2020-03-31,674,Value,7406860,-7912334,3770,-7908564
94192,2020-06-30,674,Value,7763980,-7912334,3770,-7908564
94192,2020-08-15,674,Capital Call,-453152,-8365486,3770,-8361716
94192,2020-09-30,674,Value,8414550,-8365486,3770,-8361716
94192,2020-12-31,674,Value,8939380,-8365486,3770,-8361716
94192,2021-02-14,674,Capital Call,-750228,-9115714,3770,-9111944
94192,2021-02-14,674,Distribution,2034366,-9115714,2038136,-7077578
94192,2021-03-31,674,Value,10782730,-9115714,2038136,-7077578
94192,2021-06-30,674,Value,10161510,-9115714,2038136,-7077578
94312,2020-03-31,16727,Value,1756740,-2010000,0,-2010000
94312,2020-05-16,16727,Capital Call,-1080000,-3090000,0,-3090000
94312,2020-06-30,16727,Value,2784090,-3090000,0,-3090000
94312,2020-08-15,16727,Capital Call,-20000,-3110000,0,-3110000
94312,2020-09-30,16727,Value,2746130,-3110000,0,-3110000
94312,2020-11-15,16727,Capital Call,-50000,-3160000,0,-3160000
94312,2020-11-15,16727,Distribution,287560,-3160000,287560,-2872440
94312,2020-12-31,16727,Value,3561320,-3160000,287560,-2872440
94312,2021-02-14,16727,Capital Call,-80000,-3240000,287560,-2952440
94312,2021-02-14,16727,Distribution,800,-3240000,288360,-2951640
94312,2021-03-31,16727,Value,3589920,-3240000,288360,-2951640
94318,2020-03-31,255471,Capital Call,-4119850,-4119850,0,-4119850
94318,2020-03-31,255471,Value,4065750,-4119850,0,-4119850
94318,2020-05-16,255471,Capital Call,-2095464,-6215314,0,-6215314
94318,2020-05-16,255471,Distribution,44664,-6215314,44664,-6170650
94318,2020-06-30,255471,Value,5362330,-6215314,44664,-6170650
94318,2020-09-30,255471,Value,5312390,-6215314,44664,-6170650
94318,2020-11-15,255471,Capital Call,-1381432,-7596746,44664,-7552082
94318,2020-11-15,255471,Distribution,55205,-7596746,99869,-7496877
94318,2020-12-31,255471,Value,8744330,-7596746,99869,-7496877
94319,2020-03-31,367179,Value,8277950,-6700000,0,-6700000
94319,2020-05-16,367179,Capital Call,-1188476,-7888476,0,-7888476
94319,2020-06-30,367179,Value,9763710,-7888476,0,-7888476
94319,2020-08-15,367179,Capital Call,-611524,-8500000,0,-8500000
94319,2020-09-30,367179,Value,13217460,-8500000,0,-8500000
94377,2020-01-15,2238,Capital Call,-750000,-3150000,0,-3150000
94377,2020-02-29,2238,Value,3109580,-3150000,0,-3150000
94377,2020-04-15,2238,Capital Call,-700000,-3850000,0,-3850000
94377,2020-05-31,2238,Value,3979720,-3850000,0,-3850000
94377,2020-07-16,2238,Capital Call,-850000,-4700000,0,-4700000
94377,2020-08-31,2238,Value,5010430,-4700000,0,-4700000
94377,2020-10-16,2238,Capital Call,-1000000,-5700000,0,-5700000
94377,2020-11-30,2238,Value,6186750,-5700000,0,-5700000
94377,2021-01-14,2238,Capital Call,-1450000,-7150000,0,-7150000
94377,2021-02-28,2238,Value,7636750,-7150000,0,-7150000
94377,2021-04-15,2238,Capital Call,-300000,-7450000,0,-7450000
94377,2021-05-31,2238,Value,10108320,-7450000,0,-7450000
94377,2021-07-16,2238,Capital Call,-900000,-8350000,0,-8350000
94377,2021-08-31,2238,Value,12831350,-8350000,0,-8350000
94377,2021-10-16,2238,Capital Call,-500000,-8850000,0,-8850000
94377,2021-11-30,2238,Value,14945150,-8850000,0,-8850000
94379,2020-01-15,2238,Capital Call,-900000,-3250000,0,-3250000
94379,2020-02-29,2238,Value,3253760,-3250000,0,-3250000
94379,2020-04-15,2238,Capital Call,-550000,-3800000,0,-3800000
94379,2020-05-31,2238,Value,3804570,-3800000,0,-3800000
94379,2020-07-16,2238,Capital Call,-1600000,-5400000,0,-5400000
94379,2020-08-31,2238,Value,5649610,-5400000,0,-5400000
94379,2020-10-16,2238,Capital Call,-700000,-6100000,0,-6100000
94379,2020-11-30,2238,Value,6996660,-6100000,0,-6100000
94379,2021-01-14,2238,Capital Call,-900000,-7000000,0,-7000000
94379,2021-02-28,2238,Value,7896660,-7000000,0,-7000000
94379,2021-04-15,2238,Capital Call,-2650000,-9650000,0,-9650000
94379,2021-05-31,2238,Value,12090480,-9650000,0,-9650000
94379,2021-08-31,2238,Value,11925220,-9650000,0,-9650000
94379,2021-10-16,2238,Capital Call,-100000,-9750000,0,-9750000
94379,2021-11-30,2238,Value,12930850,-9750000,0,-9750000
94432,2020-03-31,10301,Value,9077630,-2500000,0,-2500000
94484,2020-03-31,527,Value,1080660,-1243000,0,-1243000
94484,2020-05-16,527,Capital Call,-127000,-1370000,0,-1370000
94484,2020-06-30,527,Value,1133400,-1370000,0,-1370000
94484,2020-08-15,527,Capital Call,-937000,-2307000,0,-2307000
94484,2020-09-30,527,Value,2453030,-2307000,0,-2307000
94484,2020-12-31,527,Value,3127590,-2307000,0,-2307000
94484,2021-03-31,527,Value,5269880,-2307000,0,-2307000
94484,2021-05-16,527,Capital Call,29948,-2277052,0,-2277052
94484,2021-06-30,527,Value,6397710,-2277052,0,-2277052
94484,2021-09-30,527,Value,6238680,-2277052,0,-2277052
94486,2020-02-15,289,Capital Call,96191,-3504966,817,-3504149
94486,2020-03-31,289,Value,3661170,-3504966,817,-3504149
94486,2020-05-16,289,Capital Call,-113956,-3618922,817,-3618105
94486,2020-06-30,289,Value,3814780,-3618922,817,-3618105
94486,2020-08-15,289,Capital Call,-112041,-3730963,817,-3730146
94486,2020-09-30,289,Value,4038160,-3730963,817,-3730146
94486,2020-11-15,289,Capital Call,-3856524,-7587487,817,-7586670
94486,2020-12-31,289,Value,7916630,-7587487,817,-7586670
94486,2021-02-14,289,Capital Call,566531,-7020956,817,-7020139
94486,2021-03-31,289,Value,7344050,-7020956,817,-7020139
94486,2021-05-16,289,Capital Call,-19245,-7040201,817,-7039384
94486,2021-06-30,289,Value,7448390,-7040201,817,-7039384
94486,2021-08-15,289,Capital Call,-46840,-7087041,817,-7086224
94486,2021-09-30,289,Value,8017640,-7087041,817,-7086224
94642,2020-03-31,357,Capital Call,-1707113,-2378384,0,-2378384
94642,2020-06-30,357,Value,2180470,-2378384,0,-2378384
94642,2020-09-30,357,Value,2150510,-2378384,0,-2378384
94642,2020-11-15,357,Capital Call,-214478,-2592862,0,-2592862
94642,2020-12-31,357,Value,2150940,-2592862,0,-2592862
94642,2021-02-14,357,Capital Call,-682530,-3275392,0,-3275392
94642,2021-03-31,357,Value,2769840,-3275392,0,-3275392
94811,2020-03-31,2212,Capital Call,-62000,-136000,0,-136000
94811,2020-06-30,2212,Value,33480,-136000,0,-136000
94811,2020-08-15,2212,Capital Call,-28000,-164000,0,-164000
94811,2020-09-30,2212,Value,126230,-164000,0,-164000
94811,2020-11-15,2212,Capital Call,-198000,-362000,0,-362000
94811,2020-12-31,2212,Value,831980,-362000,0,-362000
94811,2021-02-14,2212,Capital Call,-422000,-784000,0,-784000
94811,2021-03-31,2212,Value,1251420,-784000,0,-784000
94811,2021-05-16,2212,Capital Call,-381000,-1165000,0,-1165000
94811,2021-06-30,2212,Value,2636740,-1165000,0,-1165000
94811,2021-08-15,2212,Capital Call,-1462000,-2627000,0,-2627000
94811,2021-08-15,2212,Distribution,125308,-2627000,125308,-2501692
94811,2021-09-30,2212,Value,3942070,-2627000,125308,-2501692
94989,2020-02-15,143499,Capital Call,-2585937,-10000000,0,-10000000
94989,2020-03-31,143499,Value,9217030,-10000000,0,-10000000
94989,2020-06-30,143499,Value,9478520,-10000000,0,-10000000
94989,2020-09-30,143499,Value,14167980,-10000000,0,-10000000
95075,2020-03-31,112079,Capital Call,-1500000,-2500000,0,-2500000
95075,2020-09-30,112079,Value,2575000,-2500000,0,-2500000
95175,2020-02-15,7,Capital Call,-109,-811000,0,-811000
95175,2020-03-31,7,Value,717240,-811000,0,-811000
95175,2020-05-16,7,Capital Call,122,-810878,0,-810878
95175,2020-06-30,7,Value,890570,-810878,0,-810878
95175,2020-08-15,7,Capital Call,-1260323,-2071201,0,-2071201
95175,2020-09-30,7,Value,2310840,-2071201,0,-2071201
95203,2020-06-30,174,Capital Call,-1030120,-1030120,0,-1030120
95203,2020-06-30,174,Value,967230,-1030120,0,-1030120
95203,2020-09-30,174,Value,991800,-1030120,0,-1030120
95203,2020-12-31,174,Value,1158850,-1030120,0,-1030120
95203,2021-03-31,174,Value,1046980,-1030120,0,-1030120
95263,2020-03-31,6479,Value,1728690,-2050000,0,-2050000
95263,2020-05-16,6479,Capital Call,-800000,-2850000,0,-2850000
95263,2020-06-30,6479,Value,2556850,-2850000,0,-2850000
95263,2020-08-15,6479,Capital Call,-1300000,-4150000,0,-4150000
95263,2020-09-30,6479,Value,4050640,-4150000,0,-4150000
95264,2020-02-15,6479,Capital Call,-900000,-2650000,0,-2650000
95264,2020-03-31,6479,Value,3186640,-2650000,0,-2650000
95326,2020-02-15,16570,Capital Call,-1244000,-3746999,0,-3746999
95326,2020-03-31,16570,Value,3534990,-3746999,0,-3746999
95326,2020-06-30,16570,Value,3470140,-3746999,0,-3746999
95326,2020-08-15,16570,Capital Call,-764000,-4510999,0,-4510999
95326,2020-09-30,16570,Value,4335490,-4510999,0,-4510999
95326,2020-11-15,16570,Capital Call,-1166000,-5676999,0,-5676999
95326,2020-12-31,16570,Value,7271930,-5676999,0,-5676999
95326,2021-03-31,16570,Value,7347290,-5676999,0,-5676999
95326,2021-05-16,16570,Capital Call,-538000,-6214999,0,-6214999
95326,2021-06-30,16570,Value,8887860,-6214999,0,-6214999
95326,2021-08-15,16570,Capital Call,-281000,-6495999,0,-6495999
95326,2021-09-30,16570,Value,12662250,-6495999,0,-6495999
95441,2020-02-15,136948,Capital Call,-3000000,-6090000,120000,-5970000
95441,2020-03-31,136948,Value,6260000,-6090000,120000,-5970000
95441,2020-05-16,136948,Capital Call,-1800000,-7890000,120000,-7770000
95441,2020-05-16,136948,Distribution,20000,-7890000,140000,-7750000
95441,2020-06-30,136948,Value,9860000,-7890000,140000,-7750000
95441,2020-09-30,136948,Value,14119990,-7890000,140000,-7750000
95441,2020-11-15,136948,Capital Call,-2730000,-10620000,140000,-10480000
95441,2020-11-15,136948,Distribution,1270000,-10620000,1410000,-9210000
95441,2020-12-31,136948,Value,19250000,-10620000,1410000,-9210000
95441,2021-02-14,136948,Distribution,1840000,-10620000,3250000,-7370000
95441,2021-03-31,136948,Value,20449990,-10620000,3250000,-7370000
95441,2021-05-16,136948,Capital Call,-2320000,-12940000,3250000,-9690000
95441,2021-05-16,136948,Distribution,5230000,-12940000,8480000,-4460000
95441,2021-06-30,136948,Value,21439990,-12940000,8480000,-4460000
95441,2021-08-15,136948,Capital Call,-491000,-13431000,8480000,-4951000
95441,2021-08-15,136948,Distribution,3077000,-13431000,11557000,-1874000
95441,2021-09-30,136948,Value,19856990,-13431000,11557000,-1874000
95457,2020-03-31,1998,Value,742350,-950000,0,-950000
95457,2020-05-16,1998,Capital Call,-463575,-1413575,0,-1413575
95457,2020-06-30,1998,Value,1169450,-1413575,0,-1413575
95457,2020-08-15,1998,Capital Call,-971400,-2384975,0,-2384975
95457,2020-09-30,1998,Value,2589740,-2384975,0,-2384975
95457,2020-12-31,1998,Value,3129840,-2384975,0,-2384975
95457,2021-02-14,1998,Capital Call,-700000,-3084975,0,-3084975
95457,2021-03-31,1998,Value,4264920,-3084975,0,-3084975
95481,2020-12-31,454,Capital Call,-1316198,-1316198,0,-1316198
95481,2020-12-31,454,Value,1303490,-1316198,0,-1316198
95481,2021-02-14,454,Capital Call,-32868,-1349066,0,-1349066
95481,2021-03-31,454,Value,1271580,-1349066,0,-1349066
95481,2021-05-16,454,Capital Call,-2754174,-4103240,0,-4103240
95481,2021-06-30,454,Value,3979250,-4103240,0,-4103240
95481,2021-09-30,454,Value,4241050,-4103240,0,-4103240
95712,2020-03-31,350,Value,5403850,-5377051,82708,-5294343
95712,2020-05-16,350,Capital Call,-1024517,-6401568,82708,-6318860
95712,2020-06-30,350,Value,7183010,-6401568,82708,-6318860
95712,2020-08-15,350,Capital Call,-112125,-6513693,82708,-6430985
95712,2020-08-15,350,Distribution,254562,-6513693,337270,-6176423
95712,2020-09-30,350,Value,7641750,-6513693,337270,-6176423
95712,2020-12-31,350,Value,7641750,-6513693,337270,-6176423
95712,2021-02-14,350,Capital Call,-1903432,-8417125,337270,-8079855
95712,2021-02-14,350,Distribution,337440,-8417125,674710,-7742415
95712,2021-03-31,350,Value,11824250,-8417125,674710,-7742415
95712,2021-05-16,350,Capital Call,-396516,-8813641,674710,-8138931
95712,2021-05-16,350,Distribution,931393,-8813641,1606103,-7207538
95712,2021-06-30,350,Value,13181260,-8813641,1606103,-7207538
95712,2021-08-15,350,Capital Call,-292695,-9106336,1606103,-7500233
95712,2021-08-15,350,Distribution,922136,-9106336,2528239,-6578097
95712,2021-09-30,350,Value,13776830,-9106336,2528239,-6578097
95805,2020-09-30,28,Value,2339330,-2062000,82274,-1979726
95805,2021-02-14,28,Capital Call,-138000,-2200000,82274,-2117726
95805,2021-02-14,28,Distribution,533726,-2200000,616000,-1584000
95805,2021-06-30,28,Value,2860000,-2200000,616000,-1584000
95863,2020-03-31,147,Value,1813200,-1807472,7354,-1800118
95863,2020-05-16,147,Capital Call,-1080222,-2887694,7354,-2880340
95863,2020-06-30,147,Value,3555850,-2887694,7354,-2880340
95863,2020-08-15,147,Capital Call,-579666,-3467360,7354,-3460006
95863,2020-09-30,147,Value,4564930,-3467360,7354,-3460006
95863,2020-11-15,147,Capital Call,-714372,-4181732,7354,-4174378
95863,2020-12-31,147,Value,6682250,-4181732,7354,-4174378
95866,2020-03-31,68882,Capital Call,-1200000,-1200000,0,-1200000
95866,2020-03-31,68882,Value,1362700,-1200000,0,-1200000
95866,2020-05-16,68882,Capital Call,-698924,-1898924,0,-1898924
95866,2020-06-30,68882,Value,2019300,-1898924,0,-1898924
95866,2020-08-15,68882,Capital Call,-588261,-2487185,0,-2487185
95866,2020-09-30,68882,Value,2845960,-2487185,0,-2487185
95866,2020-11-15,68882,Capital Call,-2338798,-4825983,0,-4825983
95866,2021-02-14,68882,Capital Call,-1690000,-6515983,0,-6515983
95866,2021-02-14,68882,Distribution,845000,-6515983,845000,-5670983
95866,2021-03-31,68882,Value,7350790,-6515983,845000,-5670983
95891,2020-02-15,668,Capital Call,-1163211,-1425271,0,-1425271
95891,2020-03-31,668,Value,1138450,-1425271,0,-1425271
95891,2020-08-16,668,Capital Call,-633858,-2059129,0,-2059129
95891,2020-12-31,668,Value,1401690,-2059129,0,-2059129
95891,2021-01-16,668,Capital Call,-1092900,-3152029,0,-3152029
95891,2021-01-16,668,Distribution,3352,-3152029,3352,-3148677
95891,2021-03-31,668,Value,2541140,-3152029,3352,-3148677
95914,2020-01-15,52,Capital Call,-550000,-2550000,0,-2550000
95914,2020-02-29,52,Value,2445980,-2550000,0,-2550000
95914,2020-04-15,52,Capital Call,-750000,-3300000,0,-3300000
95914,2020-05-31,52,Value,3278970,-3300000,0,-3300000
95914,2020-07-16,52,Capital Call,-1250000,-4550000,0,-4550000
95914,2020-08-31,52,Value,5740950,-4550000,0,-4550000
95914,2020-10-16,52,Capital Call,-1450000,-6000000,0,-6000000
95914,2020-11-30,52,Value,8105700,-6000000,0,-6000000
95914,2021-01-14,52,Capital Call,-550000,-6550000,0,-6550000
95914,2021-02-28,52,Value,9062640,-6550000,0,-6550000
95914,2021-04-15,52,Capital Call,-800000,-7350000,0,-7350000
95914,2021-05-31,52,Value,13415270,-7350000,0,-7350000
95914,2021-07-16,52,Capital Call,-350000,-7700000,0,-7700000
95914,2021-08-31,52,Value,16520260,-7700000,0,-7700000
95914,2021-10-16,52,Capital Call,-350000,-8050000,0,-8050000
95914,2021-11-30,52,Value,19131490,-8050000,0,-8050000
95960,2020-02-15,219123,Capital Call,-354275,-2344180,3845,-2340335
95960,2020-02-15,219123,Distribution,1559,-2344180,5404,-2338776
95960,2020-03-31,219123,Value,2314660,-2344180,5404,-2338776
95960,2020-05-16,219123,Distribution,2303,-2344180,7707,-2336473
95960,2020-06-30,219123,Value,2299940,-2344180,7707,-2336473
95960,2020-08-15,219123,Capital Call,-888385,-3232565,7707,-3224858
95960,2020-08-15,219123,Distribution,2892,-3232565,10599,-3221966
95960,2020-09-30,219123,Value,3243220,-3232565,10599,-3221966
95960,2020-11-15,219123,Capital Call,-975807,-4208372,10599,-4197773
95960,2020-11-15,219123,Distribution,2030,-4208372,12629,-4195743
95960,2020-12-31,219123,Value,4657370,-4208372,12629,-4195743
95960,2021-02-14,219123,Capital Call,-1424303,-5632675,12629,-5620046
95960,2021-02-14,219123,Distribution,2030,-5632675,14659,-5618016
95960,2021-03-31,219123,Value,6081670,-5632675,14659,-5618016
96061,2020-02-15,1314,Capital Call,-296000,-2725000,0,-2725000
96061,2020-03-31,1314,Value,2805660,-2725000,0,-2725000
96061,2020-05-16,1314,Capital Call,-486000,-3211000,0,-3211000
96061,2020-06-30,1314,Value,3464020,-3211000,0,-3211000
96061,2020-08-15,1314,Capital Call,-474000,-3685000,0,-3685000
96061,2020-09-30,1314,Value,4238480,-3685000,0,-3685000
96061,2020-11-15,1314,Capital Call,-366000,-4051000,0,-4051000
96061,2020-12-31,1314,Value,5384990,-4051000,0,-4051000
96061,2021-02-14,1314,Capital Call,-334000,-4385000,0,-4385000
96061,2021-03-31,1314,Value,6392010,-4385000,0,-4385000
96061,2021-05-16,1314,Capital Call,-14000,-4399000,0,-4399000
96061,2021-06-30,1314,Value,7279900,-4399000,0,-4399000
96061,2021-08-15,1314,Capital Call,-907000,-5306000,0,-5306000
96061,2021-08-15,1314,Distribution,157588,-5306000,157588,-5148412
96061,2021-09-30,1314,Value,8742690,-5306000,157588,-5148412
96072,2020-02-15,304,Capital Call,-1281897,-2321078,2601,-2318477
96072,2020-03-31,304,Value,2070250,-2321078,2601,-2318477
96072,2020-07-01,304,Capital Call,-793226,-3114304,2601,-3111703
96072,2020-09-30,304,Value,2628180,-3114304,2601,-3111703
96072,2020-12-31,304,Value,2676610,-3114304,2601,-3111703
96072,2021-02-14,304,Capital Call,-1080313,-4194617,2601,-4192016
96072,2021-03-31,304,Value,3657200,-4194617,2601,-4192016
96072,2021-06-30,304,Value,4225110,-4194617,2601,-4192016
96072,2021-08-15,304,Capital Call,-956992,-5151609,2601,-5149008
96072,2021-09-30,304,Value,5601330,-5151609,2601,-5149008
96111,2020-02-15,158016,Capital Call,-288644,-3734118,0,-3734118
96111,2020-03-31,158016,Value,2836060,-3734118,0,-3734118
96111,2020-06-30,158016,Value,2847180,-3734118,0,-3734118
96111,2020-08-15,158016,Capital Call,-784027,-4518145,0,-4518145
96111,2020-08-15,158016,Distribution,1282,-4518145,1282,-4516863
96111,2020-09-30,158016,Value,3797610,-4518145,1282,-4516863
96111,2020-11-15,158016,Capital Call,-986979,-5505124,1282,-5503842
96111,2020-12-31,158016,Value,5118570,-5505124,1282,-5503842
96111,2021-02-14,158016,Capital Call,-344973,-5850097,1282,-5848815
96111,2021-03-31,158016,Value,6000290,-5850097,1282,-5848815
96111,2021-05-16,158016,Capital Call,-631903,-6482000,1282,-6480718
96111,2021-05-16,158016,Distribution,15,-6482000,1297,-6480703
96111,2021-06-30,158016,Value,7022590,-6482000,1297,-6480703
96121,2020-02-15,167467,Capital Call,-2274667,-8285667,46000,-8239667
96121,2020-02-15,167467,Distribution,15000,-8285667,61000,-8224667
96121,2020-03-31,167467,Value,6678330,-8285667,61000,-8224667
96121,2020-06-30,167467,Value,7648000,-8285667,61000,-8224667
96121,2020-08-15,167467,Capital Call,-194333,-8480000,61000,-8419000
96121,2020-08-15,167467,Distribution,20667,-8480000,81667,-8398333
96121,2020-09-30,167467,Value,9133000,-8480000,81667,-8398333
96121,2020-12-31,167467,Value,12096330,-8480000,81667,-8398333
96121,2021-03-31,167467,Value,12810000,-8480000,81667,-8398333
96121,2021-05-16,167467,Capital Call,-737000,-9217000,81667,-9135333
96121,2021-05-16,167467,Distribution,84333,-9217000,166000,-9051000
96121,2021-06-30,167467,Value,14606000,-9217000,166000,-9051000
96184,2020-02-15,317,Capital Call,-421,-2318000,0,-2318000
96184,2020-03-31,317,Value,2239880,-2318000,0,-2318000
96184,2020-05-16,317,Capital Call,52907,-2265093,0,-2265093
96184,2020-06-30,317,Value,2503840,-2265093,0,-2265093
96184,2020-08-15,317,Capital Call,-1352907,-3618000,0,-3618000
96184,2020-09-30,317,Value,4419380,-3618000,0,-3618000
96238,2020-02-15,11,Capital Call,-914038,-3153399,0,-3153399
96238,2020-03-31,11,Value,2044250,-3153399,0,-3153399
96238,2020-05-16,11,Capital Call,-900283,-4053682,0,-4053682
96238,2020-06-30,11,Value,3346510,-4053682,0,-4053682
96238,2020-08-15,11,Capital Call,-1061042,-5114724,0,-5114724
96238,2020-09-30,11,Value,4808080,-5114724,0,-5114724
96238,2020-11-15,11,Capital Call,-53671,-5168395,0,-5168395
96238,2020-12-31,11,Value,5121380,-5168395,0,-5168395
96274,2020-02-15,74855,Capital Call,-1354291,-5475789,987102,-4488687
96274,2020-02-15,74855,Distribution,106212,-5475789,1093314,-4382475
96274,2020-03-31,74855,Value,6108330,-5475789,1093314,-4382475
96274,2020-05-16,74855,Capital Call,-473675,-5949464,1093314,-4856150
96274,2020-06-30,74855,Value,7250130,-5949464,1093314,-4856150
96274,2020-08-15,74855,Distribution,28537,-5949464,1121851,-4827613
96274,2020-09-30,74855,Value,9172580,-5949464,1121851,-4827613
96274,2020-11-15,74855,Capital Call,-2288871,-8238335,1121851,-7116484
96274,2020-11-15,74855,Distribution,1413555,-8238335,2535406,-5702929
96274,2020-12-31,74855,Value,10963700,-8238335,2535406,-5702929
96274,2021-02-14,74855,Capital Call,-1511782,-9750117,2535406,-7214711
96274,2021-02-14,74855,Distribution,14193,-9750117,2549599,-7200518
96274,2021-03-31,74855,Value,13192850,-9750117,2549599,-7200518
96274,2021-05-16,74855,Capital Call,-18564,-9768681,2549599,-7219082
96274,2021-05-16,74855,Distribution,3070784,-9768681,5620383,-4148298
96274,2021-06-30,74855,Value,10903130,-9768681,5620383,-4148298
96274,2021-08-15,74855,Distribution,29637,-9768681,5650020,-4118661
96274,2021-09-30,74855,Value,11510200,-9768681,5650020,-4118661
96303,2020-02-15,733,Capital Call,-811189,-5324905,0,-5324905
96303,2020-03-31,733,Value,5022380,-5324905,0,-5324905
96303,2020-05-16,733,Capital Call,-7888,-5332793,0,-5332793
96303,2020-06-30,733,Value,5388650,-5332793,0,-5332793
96303,2020-09-30,733,Capital Call,-2340528,-7673321,0,-7673321
96303,2020-09-30,733,Distribution,402612,-7673321,402612,-7270709
96303,2020-12-31,733,Value,7203790,-7673321,402612,-7270709
96303,2021-02-14,733,Capital Call,-2807020,-10480341,402612,-10077729
96303,2021-03-31,733,Value,10559870,-10480341,402612,-10077729
96303,2021-05-16,733,Capital Call,-133067,-10613408,402612,-10210796
96303,2021-06-30,733,Value,13705600,-10613408,402612,-10210796
96323,2020-02-15,270,Capital Call,-24000,-7320000,136434,-7183566
96323,2020-02-15,270,Distribution,2645,-7320000,139079,-7180921
96323,2020-03-31,270,Value,8220360,-7320000,139079,-7180921
96361,2020-03-31,16101,Capital Call,680703,2522879,0,2522879
96361,2020-03-31,16101,Value,2581440,2522879,0,2522879
96361,2020-06-30,16101,Capital Call,376515,2899394,0,2899394
96361,2020-06-30,16101,Value,2883980,2899394,0,2899394
96361,2020-09-30,16101,Capital Call,1199749,4099143,0,4099143
96361,2020-09-30,16101,Value,4701440,4099143,0,4099143
96361,2020-12-31,16101,Capital Call,699854,4798997,0,4798997
96361,2020-12-31,16101,Value,5558900,4798997,0,4798997
96361,2021-03-31,16101,Distribution,481172,4798997,481172,5280169
96361,2021-03-31,16101,Value,5077730,4798997,481172,5280169
96361,2021-06-30,16101,Distribution,191960,4798997,673132,5472129
96361,2021-07-01,16101,Value,5642870,4798997,673132,5472129
96390,2020-02-15,18,Capital Call,-1000000,-2500000,0,-2500000
96390,2020-03-31,18,Value,2466740,-2500000,0,-2500000
96390,2020-05-16,18,Capital Call,-500000,-3000000,0,-3000000
96390,2020-06-30,18,Value,3306600,-3000000,0,-3000000
96390,2020-09-30,18,Value,3679190,-3000000,0,-3000000
96390,2020-11-15,18,Capital Call,-800000,-3800000,0,-3800000
96390,2020-11-15,18,Distribution,250040,-3800000,250040,-3549960
96390,2020-12-31,18,Value,5105290,-3800000,250040,-3549960
96390,2021-02-14,18,Capital Call,-650000,-4450000,250040,-4199960
96390,2021-02-14,18,Distribution,8950,-4450000,258990,-4191010
96390,2021-03-31,18,Value,6679000,-4450000,258990,-4191010
96390,2021-05-16,18,Capital Call,-500000,-4950000,258990,-4691010
96390,2021-05-16,18,Distribution,-105,-4950000,258885,-4691115
96390,2021-06-30,18,Value,8167990,-4950000,258885,-4691115
96390,2021-09-30,18,Value,9216890,-4950000,258885,-4691115
96391,2020-02-15,162111,Capital Call,-1000000,-4950000,0,-4950000
96391,2020-03-31,162111,Value,5548670,-4950000,0,-4950000
96391,2020-05-16,162111,Capital Call,-400000,-5350000,0,-5350000
96391,2020-06-30,162111,Value,6128930,-5350000,0,-5350000
96391,2020-08-15,162111,Capital Call,-1175000,-6525000,0,-6525000
96391,2020-09-30,162111,Value,7496750,-6525000,0,-6525000
96391,2020-12-30,162111,Capital Call,-2425000,-8950000,0,-8950000
96391,2021-03-31,162111,Value,11488110,-8950000,0,-8950000
96392,2020-02-15,18,Capital Call,-570000,-2270000,0,-2270000
96392,2020-03-31,18,Value,2335370,-2270000,0,-2270000
96392,2020-05-16,18,Capital Call,-500000,-2770000,0,-2770000
96392,2020-06-30,18,Value,3013750,-2770000,0,-2770000
96392,2020-09-30,18,Value,3379120,-2770000,0,-2770000
96392,2020-11-15,18,Capital Call,-400000,-3170000,0,-3170000
96392,2020-11-15,18,Distribution,200027,-3170000,200027,-2969973
96392,2020-12-31,18,Value,4406290,-3170000,200027,-2969973
96392,2021-02-14,18,Capital Call,-250000,-3420000,200027,-3219973
96392,2021-02-14,18,Distribution,43,-3420000,200070,-3219930
96392,2021-03-31,18,Value,5072880,-3420000,200070,-3219930
96392,2021-05-16,18,Capital Call,-300000,-3720000,200070,-3519930
96392,2021-05-16,18,Distribution,66,-3720000,200136,-3519864
96392,2021-06-30,18,Value,5965390,-3720000,200136,-3519864
96392,2021-09-30,18,Value,6467590,-3720000,200136,-3519864
96393,2020-02-15,18,Capital Call,-1000000,-2620000,0,-2620000
96393,2020-03-31,18,Value,2919980,-2620000,0,-2620000
96393,2020-05-16,18,Capital Call,-1000000,-3620000,0,-3620000
96393,2020-06-30,18,Value,5239580,-3620000,0,-3620000
96393,2020-09-30,18,Value,5603750,-3620000,0,-3620000
96393,2020-11-15,18,Capital Call,-750000,-4370000,0,-4370000
96393,2020-12-31,18,Value,7774220,-4370000,0,-4370000
96393,2021-02-14,18,Capital Call,-1000000,-5370000,0,-5370000
96393,2021-03-31,18,Value,12259170,-5370000,0,-5370000
96393,2021-07-01,18,Capital Call,-500000,-5870000,0,-5870000
96393,2021-09-30,18,Value,19162610,-5870000,0,-5870000
96449,2020-02-15,1557,Distribution,11242,-194010,28384,-165626
96449,2020-03-31,1557,Value,153930,-194010,28384,-165626
96449,2020-05-16,1557,Capital Call,-202797,-396807,28384,-368423
96449,2020-05-16,1557,Distribution,33094,-396807,61478,-335329
96449,2020-06-30,1557,Value,321800,-396807,61478,-335329
96535,2020-03-31,247761,Value,2237180,-2600000,0,-2600000
96535,2020-05-16,247761,Capital Call,-1100000,-3700000,0,-3700000
96535,2020-06-30,247761,Value,3692790,-3700000,0,-3700000
96535,2020-09-30,247761,Capital Call,-2800000,-6500000,0,-6500000
96535,2020-12-31,247761,Value,9177390,-6500000,0,-6500000
96535,2021-02-14,247761,Capital Call,-1900000,-8400000,0,-8400000
96535,2021-03-31,247761,Value,12547110,-8400000,0,-8400000
96535,2021-06-30,247761,Value,19764030,-8400000,0,-8400000
96563,2020-03-31,795,Value,297020,-350000,0,-350000
96563,2020-06-30,795,Value,306720,-350000,0,-350000
96563,2020-08-15,795,Capital Call,-920000,-1270000,0,-1270000
96563,2020-09-30,795,Value,1216770,-1270000,0,-1270000
96563,2020-11-15,795,Capital Call,-470000,-1740000,0,-1740000
96563,2020-11-15,795,Distribution,192000,-1740000,192000,-1548000
96563,2020-12-31,795,Value,1596410,-1740000,192000,-1548000
96563,2021-03-31,795,Value,1711550,-1740000,192000,-1548000
96563,2021-06-30,795,Value,2306120,-1740000,192000,-1548000
96572,2020-02-15,16505,Capital Call,-1180930,-11644728,686920,-10957808
96572,2020-02-15,16505,Distribution,2539437,-11644728,3226357,-8418371
96572,2020-03-31,16505,Value,9564960,-11644728,3226357,-8418371
96572,2020-05-16,16505,Capital Call,-33647,-11678375,3226357,-8452018
96572,2020-05-16,16505,Distribution,569343,-11678375,3795700,-7882675
96572,2020-06-30,16505,Value,8687260,-11678375,3795700,-7882675
96572,2020-09-30,16505,Value,10549190,-11678375,3795700,-7882675
96572,2020-12-31,16505,Value,11415970,-11678375,3795700,-7882675
96572,2021-03-31,16505,Value,13393570,-11678375,3795700,-7882675
96572,2021-06-30,16505,Value,14635590,-11678375,3795700,-7882675
96589,2020-02-15,178752,Capital Call,-1281479,-6267531,369699,-5897832
96589,2020-02-15,178752,Distribution,454741,-6267531,824440,-5443091
96589,2020-03-31,178752,Value,5832350,-6267531,824440,-5443091
96589,2020-05-16,178752,Capital Call,-745363,-7012894,824440,-6188454
96589,2020-05-16,178752,Distribution,270142,-7012894,1094582,-5918312
96589,2020-06-30,178752,Value,6508100,-7012894,1094582,-5918312
96589,2020-08-15,178752,Capital Call,-521981,-7534875,1094582,-6440293
96589,2020-08-15,178752,Distribution,877396,-7534875,1971978,-5562897
96589,2020-09-30,178752,Value,6656570,-7534875,1971978,-5562897
96589,2020-11-15,178752,Capital Call,-248958,-7783833,1971978,-5811855
96589,2020-11-15,178752,Distribution,198143,-7783833,2170121,-5613712
96589,2020-12-31,178752,Value,6642370,-7783833,2170121,-5613712
96589,2021-02-14,178752,Capital Call,0,-7783833,2170121,-5613712
96589,2021-02-14,178752,Distribution,1341617,-7783833,3511738,-4272095
96589,2021-03-31,178752,Value,5694980,-7783833,3511738,-4272095
96589,2021-05-16,178752,Capital Call,-1391396,-9175229,3511738,-5663491
96589,2021-05-16,178752,Distribution,1063408,-9175229,4575146,-4600083
96589,2021-06-30,178752,Value,7019040,-9175229,4575146,-4600083
96589,2021-08-15,178752,Capital Call,-422700,-9597929,4575146,-5022783
96589,2021-08-15,178752,Distribution,783792,-9597929,5358938,-4238991
96589,2021-09-30,178752,Value,6889500,-9597929,5358938,-4238991
96643,2020-02-15,7951,Capital Call,-1000000,-3200000,0,-3200000
96643,2020-03-31,7951,Value,3300160,-3200000,0,-3200000
96643,2020-05-16,7951,Capital Call,-1000000,-4200000,0,-4200000
96643,2020-06-30,7951,Value,4386060,-4200000,0,-4200000
96643,2020-09-30,7951,Value,4432680,-4200000,0,-4200000
96643,2020-12-31,7951,Value,4855200,-4200000,0,-4200000
96643,2021-03-31,7951,Value,5561640,-4200000,0,-4200000
96643,2021-05-16,7951,Capital Call,-1800000,-6000000,0,-6000000
96643,2021-05-16,7951,Distribution,660000,-6000000,660000,-5340000
96643,2021-06-30,7951,Value,7320000,-6000000,660000,-5340000
96643,2021-08-15,7951,Distribution,120000,-6000000,780000,-5220000
96643,2021-09-30,7951,Value,7800000,-6000000,780000,-5220000
96672,2020-02-15,2437,Capital Call,-1300250,-7166000,0,-7166000
96672,2020-02-15,2437,Distribution,3395000,-7166000,3395000,-3771000
96672,2020-03-31,2437,Value,4446000,-7166000,3395000,-3771000
96672,2020-05-16,2437,Capital Call,-530000,-7696000,3395000,-4301000
96672,2020-06-30,2437,Value,5053750,-7696000,3395000,-4301000
96672,2020-08-15,2437,Capital Call,-1106500,-8802500,3395000,-5407500
96672,2020-09-30,2437,Value,7081500,-8802500,3395000,-5407500
96672,2020-11-15,2437,Capital Call,-970250,-9772750,3395000,-6377750
96672,2020-12-31,2437,Value,8049000,-9772750,3395000,-6377750
96672,2021-02-14,2437,Capital Call,-345000,-10117750,3395000,-6722750
96672,2021-03-31,2437,Value,14073000,-10117750,3395000,-6722750
96672,2021-05-16,2437,Capital Call,-170500,-10288250,3395000,-6893250
96672,2021-05-16,2437,Distribution,1133250,-10288250,4528250,-5760000
96672,2021-06-30,2437,Value,11159750,-10288250,4528250,-5760000
96708,2020-12-31,1220,Capital Call,-3500000,-3500000,0,-3500000
96708,2020-12-31,1220,Value,3230500,-3500000,0,-3500000
96708,2021-04-01,1220,Capital Call,-1249000,-4749000,0,-4749000
96708,2021-06-30,1220,Value,4490170,-4749000,0,-4749000
96708,2021-08-15,1220,Capital Call,-84000,-4833000,0,-4833000
96708,2021-09-30,1220,Value,6160140,-4833000,0,-4833000
96813,2020-02-15,97295,Capital Call,-2886667,-4646667,0,-4646667
96813,2020-03-31,97295,Value,4386660,-4646667,0,-4646667
96813,2020-06-30,97295,Value,4333330,-4646667,0,-4646667
96813,2020-08-15,97295,Capital Call,-360000,-5006667,0,-5006667
96813,2020-09-30,97295,Value,4953330,-5006667,0,-5006667
96813,2020-11-15,97295,Capital Call,-880000,-5886667,0,-5886667
96813,2020-12-31,97295,Value,6406660,-5886667,0,-5886667
96813,2021-02-14,97295,Capital Call,-2806667,-8693334,0,-8693334
96813,2021-03-31,97295,Value,11193330,-8693334,0,-8693334
96813,2021-06-30,97295,Value,11153330,-8693334,0,-8693334
96813,2021-08-15,97295,Capital Call,-833333,-9526667,0,-9526667
96813,2021-08-15,97295,Distribution,6667,-9526667,6667,-9520000
96813,2021-09-30,97295,Value,11746660,-9526667,6667,-9520000
96827,2020-03-31,170017,Value,3214960,-3422293,1994,-3420299
96827,2020-06-30,170017,Value,3351850,-3422293,1994,-3420299
96827,2020-08-15,170017,Capital Call,-818897,-4241190,1994,-4239196
96827,2020-08-15,170017,Distribution,58865,-4241190,60859,-4180331
96827,2020-09-30,170017,Value,4180330,-4241190,60859,-4180331
96827,2020-11-15,170017,Capital Call,64396,-4176794,60859,-4115935
96827,2020-11-15,170017,Distribution,37123,-4176794,97982,-4078812
96827,2020-12-31,170017,Value,4580020,-4176794,97982,-4078812
96827,2021-03-31,170017,Value,4872400,-4176794,97982,-4078812
96827,2021-05-16,170017,Capital Call,-1154671,-5331465,97982,-5233483
96827,2021-06-30,170017,Value,6619660,-5331465,97982,-5233483
96846,2020-03-31,350,Value,128230,-200000,0,-200000
96846,2020-05-16,350,Capital Call,-1300000,-1500000,0,-1500000
96846,2020-06-30,350,Value,1614890,-1500000,0,-1500000
96846,2020-09-30,350,Value,1791690,-1500000,0,-1500000
96846,2020-12-31,350,Value,1791690,-1500000,0,-1500000
96846,2021-02-14,350,Capital Call,-250000,-1750000,0,-1750000
96846,2021-03-31,350,Value,2608120,-1750000,0,-1750000
96846,2021-05-16,350,Capital Call,-1438831,-3188831,0,-3188831
96846,2021-05-16,350,Distribution,37945,-3188831,37945,-3150886
96846,2021-06-30,350,Value,3978390,-3188831,37945,-3150886
96846,2021-08-15,350,Capital Call,-1420332,-4609163,37945,-4571218
96846,2021-08-15,350,Distribution,356306,-4609163,394251,-4214912
96846,2021-09-30,350,Value,5702440,-4609163,394251,-4214912
96966,2020-03-31,6733,Value,9903830,-9886673,0,-9886673
96966,2020-08-16,6733,Distribution,374792,-9886673,374792,-9511881
96966,2020-12-31,6733,Value,10410350,-9886673,374792,-9511881
96966,2021-02-14,6733,Distribution,187396,-9886673,562188,-9324485
96966,2021-03-31,6733,Value,10686590,-9886673,562188,-9324485
96966,2021-06-30,6733,Value,10930470,-9886673,562188,-9324485
96966,2021-09-30,6733,Value,11742570,-9886673,562188,-9324485
96983,2020-03-31,108496,Capital Call,-551880,-1783574,0,-1783574
96983,2020-06-30,108496,Value,1779420,-1783574,0,-1783574
96983,2020-09-30,108496,Value,1806740,-1783574,0,-1783574
96983,2020-11-15,108496,Capital Call,-1048226,-2831800,0,-2831800
96983,2020-12-31,108496,Value,3521580,-2831800,0,-2831800
96983,2021-03-31,108496,Value,3734320,-2831800,0,-2831800
96985,2020-03-31,18367,Value,11641400,-10100000,0,-10100000
96985,2020-06-30,18367,Value,11640950,-10100000,0,-10100000
96985,2020-09-30,18367,Value,13925530,-10100000,0,-10100000
96985,2020-12-31,18367,Value,13924930,-10100000,0,-10100000
96985,2021-03-31,18367,Value,20778720,-10100000,0,-10100000
97042,2020-03-31,6178,Value,2428570,-2571429,0,-2571429
97042,2020-05-16,6178,Capital Call,-571429,-3142858,0,-3142858
97042,2020-06-30,6178,Value,3000000,-3142858,0,-3142858
97042,2020-09-30,6178,Capital Call,-857143,-4000001,0,-4000001
97042,2020-12-31,6178,Value,4000000,-4000001,0,-4000001
97042,2021-03-31,6178,Value,4285710,-4000001,0,-4000001
97042,2021-05-16,6178,Capital Call,-2142857,-6142858,0,-6142858
97042,2021-06-30,6178,Value,7142850,-6142858,0,-6142858
97042,2021-08-15,6178,Capital Call,-1428571,-7571429,0,-7571429
97042,2021-09-30,6178,Value,8857140,-7571429,0,-7571429
97043,2020-03-31,105936,Capital Call,-63490,-63490,0,-63490
97043,2020-05-16,105936,Capital Call,-50000,-113490,0,-113490
97043,2020-08-15,105936,Capital Call,-50000,-163490,0,-163490
97043,2020-11-15,105936,Capital Call,-2379210,-2542700,0,-2542700
97043,2020-12-31,105936,Value,2324110,-2542700,0,-2542700
97043,2021-02-14,105936,Capital Call,-3237512,-5780212,0,-5780212
97043,2021-03-31,105936,Value,6242710,-5780212,0,-5780212
97043,2021-05-16,105936,Capital Call,-953076,-6733288,0,-6733288
97043,2021-06-30,105936,Value,8421140,-6733288,0,-6733288
97081,2020-03-31,708,Value,788860,-2,0,-2
97081,2020-06-24,708,Capital Call,0,-2,0,-2
97081,2020-06-30,708,Value,920780,-2,0,-2
97081,2020-09-30,708,Value,861410,-2,0,-2
97081,2020-10-22,708,Capital Call,-1,-3,0,-3
97081,2020-12-03,708,Capital Call,-1,-4,0,-4
97081,2020-12-17,708,Capital Call,-3415033,-3415037,0,-3415037
97081,2020-12-31,708,Value,3323350,-3415037,0,-3415037
97081,2021-02-14,708,Capital Call,-593919,-4008956,0,-4008956
97081,2021-03-31,708,Value,3853400,-4008956,0,-4008956
97081,2021-07-01,708,Capital Call,-1385812,-5394768,0,-5394768
97081,2021-09-30,708,Value,6443550,-5394768,0,-5394768
97088,2020-03-31,461,Value,2849000,-2700000,0,-2700000
97088,2020-06-30,461,Value,2834000,-2700000,0,-2700000
97088,2020-09-30,461,Value,3149000,-2700000,0,-2700000
97088,2020-11-15,461,Capital Call,-400000,-3100000,0,-3100000
97088,2020-11-15,461,Distribution,12000,-3100000,12000,-3088000
97088,2020-12-31,461,Value,3872000,-3100000,12000,-3088000
97088,2021-02-14,461,Capital Call,-400000,-3500000,12000,-3488000
97088,2021-03-31,461,Value,5025000,-3500000,12000,-3488000
97088,2021-05-16,461,Capital Call,-2100000,-5600000,12000,-5588000
97088,2021-06-30,461,Value,8337000,-5600000,12000,-5588000
97109,2020-02-15,356,Capital Call,-610023,-1583311,300,-1583011
97109,2020-03-31,356,Value,1533230,-1583311,300,-1583011
97109,2020-05-16,356,Capital Call,-2400767,-3984078,300,-3983778
97109,2020-06-30,356,Value,3924440,-3984078,300,-3983778
97109,2020-08-15,356,Capital Call,-45682,-4029760,300,-4029460
97109,2020-09-30,356,Value,4400030,-4029760,300,-4029460
97109,2020-11-15,356,Capital Call,-1516041,-5545801,300,-5545501
97109,2020-12-31,356,Value,6524490,-5545801,300,-5545501
97137,2020-02-15,18,Capital Call,0,-284995,0,-284995
97137,2020-03-31,18,Value,321730,-284995,0,-284995
97137,2020-05-16,18,Capital Call,-525011,-810006,0,-810006
97137,2020-06-30,18,Value,913430,-810006,0,-810006
97137,2020-09-30,18,Value,1206210,-810006,0,-810006
97137,2020-12-31,18,Value,1827440,-810006,0,-810006
97137,2021-02-14,18,Capital Call,-720006,-1530012,0,-1530012
97137,2021-03-31,18,Value,3145360,-1530012,0,-1530012
97137,2021-05-16,18,Capital Call,-642988,-2173000,0,-2173000
97137,2021-06-30,18,Value,4623940,-2173000,0,-2173000
97137,2021-08-15,18,Capital Call,-639000,-2812000,0,-2812000
97137,2021-08-15,18,Distribution,313538,-2812000,313538,-2498462
97137,2021-09-30,18,Value,5643680,-2812000,313538,-2498462
97156,2020-02-15,18,Capital Call,4,-599996,0,-599996
97156,2020-03-31,18,Value,467040,-599996,0,-599996
97156,2020-05-16,18,Capital Call,-749995,-1349991,0,-1349991
97156,2020-06-30,18,Value,1711810,-1349991,0,-1349991
97156,2020-09-30,18,Value,1956360,-1349991,0,-1349991
97156,2020-12-31,18,Value,2788330,-1349991,0,-1349991
97156,2021-02-14,18,Capital Call,-1199992,-2549983,0,-2549983
97156,2021-03-31,18,Value,6782970,-2549983,0,-2549983
97191,2020-03-31,475912,Value,2476830,-2669000,0,-2669000
97191,2020-05-16,475912,Capital Call,-1031000,-3700000,0,-3700000
97191,2020-06-30,475912,Value,3842080,-3700000,0,-3700000
97191,2020-09-30,475912,Value,4255740,-3700000,0,-3700000
97191,2020-11-15,475912,Capital Call,-600000,-4300000,0,-4300000
97191,2020-11-15,475912,Distribution,129000,-4300000,129000,-4171000
97191,2020-12-31,475912,Value,5633000,-4300000,129000,-4171000
97191,2021-02-14,475912,Capital Call,-800000,-5100000,129000,-4971000
97191,2021-02-14,475912,Distribution,330000,-5100000,459000,-4641000
97191,2021-03-31,475912,Value,6885000,-5100000,459000,-4641000
97195,2020-02-15,18,Capital Call,-30,-250030,0,-250030
97195,2020-03-31,18,Value,283820,-250030,0,-250030
97195,2020-05-16,18,Capital Call,-500060,-750090,0,-750090
97195,2020-06-30,18,Value,824940,-750090,0,-750090
97195,2020-09-30,18,Value,1190530,-750090,0,-750090
97195,2020-12-31,18,Value,1981870,-750090,0,-750090
97195,2021-02-14,18,Capital Call,-753910,-1504000,0,-1504000
97195,2021-03-31,18,Value,3103950,-1504000,0,-1504000
97195,2021-05-16,18,Capital Call,-596241,-2100241,0,-2100241
97195,2021-06-30,18,Value,4417870,-2100241,0,-2100241
97195,2021-08-15,18,Capital Call,-600069,-2700310,0,-2700310
97195,2021-08-15,18,Distribution,500057,-2700310,500057,-2200253
97195,2021-09-30,18,Value,5269970,-2700310,500057,-2200253
97199,2020-02-15,18,Capital Call,-8,-250008,0,-250008
97199,2020-03-31,18,Value,335300,-250008,0,-250008
97199,2020-05-16,18,Capital Call,-500015,-750023,0,-750023
97199,2020-06-30,18,Value,854720,-750023,0,-750023
97199,2020-09-30,18,Value,1166850,-750023,0,-750023
97199,2020-12-31,18,Value,1803660,-750023,0,-750023
97199,2021-02-14,18,Capital Call,-600018,-1350041,0,-1350041
97199,2021-03-31,18,Value,2868010,-1350041,0,-1350041
97199,2021-05-16,18,Capital Call,-650009,-2000050,0,-2000050
97199,2021-06-30,18,Value,4347940,-2000050,0,-2000050
97199,2021-08-15,18,Capital Call,-600015,-2600065,0,-2600065
97199,2021-08-15,18,Distribution,300007,-2600065,300007,-2300058
97199,2021-09-30,18,Value,5142100,-2600065,300007,-2300058
97244,2020-02-15,8787,Capital Call,-55000,-593000,0,-593000
97244,2020-03-31,8787,Value,343940,-593000,0,-593000
97244,2020-05-16,8787,Capital Call,-55000,-648000,0,-648000
97244,2020-06-30,8787,Value,341490,-648000,0,-648000
97244,2020-08-15,8787,Capital Call,-459000,-1107000,0,-1107000
97244,2020-09-30,8787,Value,730730,-1107000,0,-1107000
97244,2020-11-15,8787,Capital Call,-52000,-1159000,0,-1159000
97244,2020-12-31,8787,Value,833660,-1159000,0,-1159000
97244,2021-02-14,8787,Capital Call,-83000,-1242000,0,-1242000
97244,2021-03-31,8787,Value,875730,-1242000,0,-1242000
97244,2021-05-16,8787,Capital Call,-1925000,-3167000,0,-3167000
97244,2021-06-30,8787,Value,2831930,-3167000,0,-3167000
97244,2021-08-15,8787,Capital Call,-627000,-3794000,0,-3794000
97244,2021-09-30,8787,Value,3306090,-3794000,0,-3794000
97275,2020-06-30,123275,Capital Call,-1900934,-1900934,0,-1900934
97275,2020-06-30,123275,Value,2381580,-1900934,0,-1900934
97275,2020-08-15,123275,Capital Call,-1206897,-3107831,0,-3107831
97275,2020-09-30,123275,Value,4128370,-3107831,0,-3107831
97286,2020-02-15,6715,Capital Call,-1010638,-3244680,0,-3244680
97286,2020-03-31,6715,Value,3085100,-3244680,0,-3244680
97286,2020-05-16,6715,Capital Call,-212766,-3457446,0,-3457446
97286,2020-06-30,6715,Value,3297870,-3457446,0,-3457446
97286,2020-08-15,6715,Capital Call,-851064,-4308510,0,-4308510
97286,2020-09-30,6715,Value,4680850,-4308510,0,-4308510
97286,2020-12-31,6715,Value,6382970,-4308510,0,-4308510
97286,2021-02-14,6715,Capital Call,-372340,-4680850,0,-4680850
97286,2021-03-31,6715,Value,6702120,-4680850,0,-4680850
97286,2021-05-16,6715,Capital Call,-212766,-4893616,0,-4893616
97286,2021-06-30,6715,Value,7765950,-4893616,0,-4893616
97286,2021-08-15,6715,Capital Call,-638298,-5531914,0,-5531914
97286,2021-09-30,6715,Value,7234040,-5531914,0,-5531914
97302,2020-02-15,291,Capital Call,-400000,-2200000,0,-2200000
97302,2020-03-31,291,Value,2117060,-2200000,0,-2200000
97302,2020-07-01,291,Capital Call,-250000,-2450000,0,-2450000
97302,2020-09-30,291,Value,2340070,-2450000,0,-2450000
97323,2020-02-15,6715,Capital Call,-1333333,-2666666,0,-2666666
97323,2020-03-31,6715,Value,2266660,-2666666,0,-2666666
97323,2020-05-16,6715,Capital Call,-600000,-3266666,0,-3266666
97323,2020-06-30,6715,Value,3000000,-3266666,0,-3266666
97323,2020-08-15,6715,Capital Call,-666667,-3933333,0,-3933333
97323,2020-09-30,6715,Value,4333330,-3933333,0,-3933333
97323,2020-11-15,6715,Capital Call,-733333,-4666666,0,-4666666
97323,2020-12-31,6715,Value,7133330,-4666666,0,-4666666
97323,2021-02-14,6715,Capital Call,-600000,-5266666,0,-5266666
97323,2021-03-31,6715,Value,17400000,-5266666,0,-5266666
97323,2021-05-16,6715,Capital Call,-466667,-5733333,0,-5733333
97323,2021-06-30,6715,Value,15933330,-5733333,0,-5733333
97323,2021-09-30,6715,Value,23866660,-5733333,0,-5733333
97344,2020-02-15,18,Capital Call,-720000,-1220000,0,-1220000
97344,2020-03-31,18,Value,1225240,-1220000,0,-1220000
97344,2020-05-16,18,Capital Call,-750000,-1970000,0,-1970000
97344,2020-06-30,18,Value,3071230,-1970000,0,-1970000
97344,2020-09-30,18,Value,3242020,-1970000,0,-1970000
97344,2020-12-31,18,Value,3750880,-1970000,0,-1970000
97344,2021-02-14,18,Capital Call,-500000,-2470000,0,-2470000
97344,2021-03-31,18,Value,4745610,-2470000,0,-2470000
97344,2021-05-16,18,Distribution,252187,-2470000,252187,-2217813
97344,2021-06-30,18,Value,5458940,-2470000,252187,-2217813
97344,2021-08-15,18,Capital Call,-1340000,-3810000,252187,-3557813
97344,2021-08-15,18,Distribution,35,-3810000,252222,-3557778
97344,2021-09-30,18,Value,8065770,-3810000,252222,-3557778
97403,2020-02-15,5782,Capital Call,-378638,-1324517,0,-1324517
97403,2020-03-31,5782,Value,1313770,-1324517,0,-1324517
97403,2020-06-30,5782,Value,1334470,-1324517,0,-1324517
97403,2020-08-15,5782,Capital Call,-149024,-1473541,0,-1473541
97403,2020-09-30,5782,Value,1476660,-1473541,0,-1473541
97403,2020-11-15,5782,Capital Call,-1058824,-2532365,0,-2532365
97403,2020-12-31,5782,Value,2621010,-2532365,0,-2532365
97403,2021-04-01,5782,Capital Call,-1303475,-3835840,0,-3835840
97403,2021-06-30,5782,Value,4080910,-3835840,0,-3835840
97403,2021-08-15,5782,Capital Call,-1071117,-4906957,0,-4906957
97403,2021-09-30,5782,Value,5676570,-4906957,0,-4906957
97413,2020-03-31,152873,Value,1234220,-1469202,713,-1468489
97413,2020-06-30,152873,Value,1333480,-1469202,713,-1468489
97413,2020-08-15,152873,Capital Call,-526200,-1995402,713,-1994689
97413,2020-09-30,152873,Value,1737770,-1995402,713,-1994689
97450,2020-03-31,533,Capital Call,-1194600,-1194600,0,-1194600
97450,2020-03-31,533,Value,1111200,-1194600,0,-1194600
97450,2020-06-30,533,Value,1132800,-1194600,0,-1194600
97450,2020-08-15,533,Capital Call,-864000,-2058600,0,-2058600
97450,2020-09-30,533,Value,2351800,-2058600,0,-2058600
97450,2020-11-15,533,Capital Call,-817400,-2876000,0,-2876000
97450,2020-12-31,533,Value,3562600,-2876000,0,-2876000
97450,2021-03-31,533,Value,3665600,-2876000,0,-2876000
97450,2021-05-16,533,Capital Call,-1165600,-4041600,0,-4041600
97450,2021-05-16,533,Distribution,1660200,-4041600,1660200,-2381400
97450,2021-06-30,533,Value,3759400,-4041600,1660200,-2381400
97464,2020-04-17,2250,Capital Call,-4904,-10099241,0,-10099241
97464,2020-09-30,2250,Value,13066520,-10099241,0,-10099241
97515,2020-03-31,12679,Capital Call,-349565,-349565,0,-349565
97515,2020-03-31,12679,Value,47880,-349565,0,-349565
97515,2020-06-30,12679,Value,5190,-349565,0,-349565
97515,2020-09-30,12679,Capital Call,-1290376,-1639941,0,-1639941
97515,2020-12-31,12679,Value,1264060,-1639941,0,-1639941
97515,2021-03-31,12679,Value,1211410,-1639941,0,-1639941
97602,2020-02-29,182780,Value,167520,-311850,0,-311850
97602,2020-04-15,182780,Capital Call,-784102,-1095952,0,-1095952
97602,2020-05-31,182780,Value,972550,-1095952,0,-1095952
97602,2020-07-16,182780,Capital Call,-145003,-1240955,0,-1240955
97602,2020-08-31,182780,Value,1030210,-1240955,0,-1240955
97602,2020-10-16,182780,Capital Call,-436356,-1677311,0,-1677311
97602,2020-11-30,182780,Value,1395630,-1677311,0,-1677311
97602,2021-01-14,182780,Capital Call,-865551,-2542862,0,-2542862
97602,2021-02-28,182780,Value,3054180,-2542862,0,-2542862
97602,2021-04-15,182780,Capital Call,-366838,-2909700,0,-2909700
97602,2021-05-31,182780,Value,4271840,-2909700,0,-2909700
97602,2021-07-16,182780,Capital Call,-385498,-3295198,0,-3295198
97602,2021-08-31,182780,Value,4470500,-3295198,0,-3295198
97602,2021-10-16,182780,Capital Call,-319418,-3614616,0,-3614616
97602,2021-11-30,182780,Value,4334830,-3614616,0,-3614616
97653,2020-02-15,1886,Capital Call,-450000,-3300000,300000,-3000000
97653,2020-03-31,1886,Value,3078810,-3300000,300000,-3000000
97653,2020-05-16,1886,Capital Call,-500000,-3800000,300000,-3500000
97653,2020-06-30,1886,Value,3705220,-3800000,300000,-3500000
97653,2020-09-30,1886,Value,3790270,-3800000,300000,-3500000
97653,2020-11-15,1886,Capital Call,-1000000,-4800000,300000,-4500000
97653,2020-11-15,1886,Distribution,100000,-4800000,400000,-4400000
97653,2020-12-31,1886,Value,4890480,-4800000,400000,-4400000
97653,2021-02-14,1886,Capital Call,-900000,-5700000,400000,-5300000
97653,2021-02-14,1886,Distribution,0,-5700000,400000,-5300000
97653,2021-03-31,1886,Value,6513420,-5700000,400000,-5300000
97653,2021-05-16,1886,Capital Call,0,-5700000,400000,-5300000
97653,2021-05-16,1886,Distribution,0,-5700000,400000,-5300000
97653,2021-06-30,1886,Value,7088220,-5700000,400000,-5300000
97653,2021-08-15,1886,Capital Call,-500000,-6200000,400000,-5800000
97653,2021-08-15,1886,Distribution,300000,-6200000,700000,-5500000
97653,2021-09-30,1886,Value,8307720,-6200000,700000,-5500000
97661,2020-12-31,49,Capital Call,-120000,-120000,0,-120000
97661,2020-12-31,49,Value,170270,-120000,0,-120000
97717,2020-03-31,345712,Capital Call,-1800000,-1800000,0,-1800000
97717,2020-03-31,345712,Value,1634330,-1800000,0,-1800000
97717,2020-05-16,345712,Capital Call,-700000,-2500000,0,-2500000
97717,2020-06-30,345712,Value,2268330,-2500000,0,-2500000
97717,2020-08-15,345712,Capital Call,-925000,-3425000,0,-3425000
97717,2020-09-30,345712,Value,3113660,-3425000,0,-3425000
97717,2020-11-15,345712,Capital Call,-2340667,-5765667,0,-5765667
97717,2020-12-31,345712,Value,5148660,-5765667,0,-5765667
97717,2021-02-14,345712,Capital Call,-916667,-6682334,0,-6682334
97717,2021-03-31,345712,Value,6443660,-6682334,0,-6682334
97726,2020-05-16,13359,Capital Call,-1113953,-5398297,0,-5398297
97726,2020-05-16,13359,Distribution,178298,-5398297,178298,-5219999
97726,2020-06-30,13359,Value,6899440,-5398297,178298,-5219999
97967,2020-03-31,107362,Capital Call,-322351,-2568812,0,-2568812
97967,2020-06-30,107362,Value,2239320,-2568812,0,-2568812
97967,2020-08-15,107362,Capital Call,-29889,-2598701,0,-2598701
97967,2020-09-30,107362,Value,2414000,-2598701,0,-2598701
97967,2020-11-15,107362,Capital Call,-1333406,-3932107,0,-3932107
97967,2020-12-31,107362,Value,4097810,-3932107,0,-3932107
97967,2021-02-14,107362,Capital Call,-19831,-3951938,0,-3951938
97967,2021-03-31,107362,Value,4315880,-3951938,0,-3951938
98171,2020-03-31,24,Value,1049000,-1000000,0,-1000000
98171,2020-05-16,24,Capital Call,-500000,-1500000,0,-1500000
98171,2020-06-30,24,Value,1528050,-1500000,0,-1500000
98171,2020-09-30,24,Value,1510350,-1500000,0,-1500000
98171,2020-12-31,24,Value,1962900,-1500000,0,-1500000
98171,2021-02-14,24,Capital Call,-500000,-2000000,0,-2000000
98171,2021-03-31,24,Value,2684000,-2000000,0,-2000000
98171,2021-05-16,24,Capital Call,-613000,-2613000,0,-2613000
98171,2021-06-30,24,Value,3476330,-2613000,0,-2613000
98171,2021-08-15,24,Capital Call,-1137000,-3750000,0,-3750000
98171,2021-08-15,24,Distribution,127875,-3750000,127875,-3622125
98171,2021-09-30,24,Value,4845750,-3750000,127875,-3622125
98339,2020-02-15,9048,Capital Call,-580000,-770000,0,-770000
98339,2020-03-31,9048,Value,642280,-770000,0,-770000
98339,2020-05-16,9048,Capital Call,-100000,-870000,0,-870000
98339,2020-06-30,9048,Value,646450,-870000,0,-870000
98339,2020-09-30,9048,Value,598070,-870000,0,-870000
98339,2020-11-15,9048,Capital Call,-1480000,-2350000,0,-2350000
98339,2020-12-31,9048,Value,2324290,-2350000,0,-2350000
98339,2021-02-14,9048,Capital Call,-500000,-2850000,0,-2850000
98339,2021-03-31,9048,Value,3267740,-2850000,0,-2850000
98365,2020-02-15,350,Capital Call,-1302313,-5208534,4084,-5204450
98365,2020-03-31,350,Value,5534490,-5208534,4084,-5204450
98365,2020-05-16,350,Capital Call,-709312,-5917846,4084,-5913762
98365,2020-06-30,350,Value,6243800,-5917846,4084,-5913762
98365,2020-09-30,350,Value,6504540,-5917846,4084,-5913762
98365,2020-11-15,350,Capital Call,-1402965,-7320811,4084,-7316727
98365,2020-12-31,350,Value,8221170,-7320811,4084,-7316727
98365,2021-02-14,350,Capital Call,-212501,-7533312,4084,-7529228
98365,2021-03-31,350,Value,8959640,-7533312,4084,-7529228
98365,2021-05-16,350,Capital Call,-632973,-8166285,4084,-8162201
98365,2021-06-30,350,Value,10826520,-8166285,4084,-8162201
98414,2020-09-30,280,Capital Call,-2150000,-2150000,0,-2150000
98414,2020-09-30,280,Value,2021430,-2150000,0,-2150000
98460,2020-02-27,81754,Capital Call,-391,-802,0,-802
98460,2020-03-31,81754,Capital Call,-112,-914,0,-914
98460,2020-04-30,81754,Capital Call,-58,-972,0,-972
98460,2020-05-31,81754,Capital Call,-11,-983,0,-983
98460,2020-06-30,81754,Capital Call,-137,-1120,0,-1120
98460,2020-07-19,81754,Capital Call,0,-1120,0,-1120
98460,2020-09-30,81754,Capital Call,-18,-1138,0,-1138
98460,2020-11-06,81754,Capital Call,-13,-1151,0,-1151
98460,2020-12-08,81754,Capital Call,0,-1151,0,-1151
98460,2020-12-31,81754,Value,1070,-1151,0,-1151
98461,2020-06-30,214065,Value,4560000,-4000000,0,-4000000
98461,2020-09-30,214065,Capital Call,-500000,-4500000,0,-4500000
98461,2020-12-31,214065,Value,4995000,-4500000,0,-4500000
98461,2021-03-31,214065,Value,6840000,-4500000,0,-4500000
98461,2021-06-30,214065,Value,6930000,-4500000,0,-4500000
98461,2021-08-15,214065,Capital Call,-1200000,-5700000,0,-5700000
98461,2021-09-30,214065,Value,11172000,-5700000,0,-5700000
98507,2020-02-15,14,Capital Call,-625000,-4687500,0,-4687500
98507,2020-03-31,14,Value,5103300,-4687500,0,-4687500
98508,2020-03-31,14,Value,3578470,-3671875,0,-3671875
98509,2020-02-15,14,Capital Call,-600000,-2650000,0,-2650000
98509,2020-03-31,14,Value,2456740,-2650000,0,-2650000
98608,2020-03-31,461,Value,10718730,-10000000,0,-10000000
98608,2020-06-30,461,Value,11525510,-10000000,0,-10000000
98608,2020-09-30,461,Value,11517440,-10000000,0,-10000000
98608,2020-11-15,461,Capital Call,-42857,-10042857,0,-10042857
98608,2020-12-31,461,Value,12446030,-10042857,0,-10042857
98608,2021-03-31,461,Value,12185830,-10042857,0,-10042857
98608,2021-06-30,461,Value,13231410,-10042857,0,-10042857
98608,2021-09-30,461,Value,14825210,-10042857,0,-10042857
98656,2020-02-15,109604,Capital Call,-597000,-9380000,50063,-9329937
98656,2020-02-15,109604,Distribution,43737,-9380000,93800,-9286200
98656,2020-03-31,109604,Value,13507200,-9380000,93800,-9286200
98656,2020-05-16,109604,Capital Call,-30000,-9410000,93800,-9316200
98656,2020-05-16,109604,Distribution,300,-9410000,94100,-9315900
98656,2020-06-30,109604,Value,17784900,-9410000,94100,-9315900
98656,2020-09-30,109604,Capital Call,3000,-9407000,94100,-9312900
98656,2020-09-30,109604,Distribution,1881370,-9407000,1975470,-7431530
98656,2020-12-31,109604,Value,25963320,-9407000,1975470,-7431530
98683,2020-06-30,8072,Capital Call,-649903,-649903,0,-649903
98683,2020-06-30,8072,Value,584990,-649903,0,-649903
98683,2020-08-15,8072,Capital Call,-250089,-899992,0,-899992
98683,2020-09-30,8072,Value,764720,-899992,0,-899992
98683,2020-11-15,8072,Capital Call,-1000082,-1900074,0,-1900074
98683,2020-12-31,8072,Value,1694710,-1900074,0,-1900074
98683,2021-02-14,8072,Capital Call,-1349988,-3250062,0,-3250062
98683,2021-03-31,8072,Value,3014690,-3250062,0,-3250062
98683,2021-05-16,8072,Capital Call,-999809,-4249871,0,-4249871
98683,2021-06-30,8072,Value,3943600,-4249871,0,-4249871
98684,2020-06-30,8072,Capital Call,-450000,-450000,0,-450000
98684,2020-06-30,8072,Value,385000,-450000,0,-450000
98684,2020-08-15,8072,Capital Call,-900000,-1350000,0,-1350000
98684,2020-09-30,8072,Value,1218330,-1350000,0,-1350000
98684,2020-11-15,8072,Capital Call,-1100000,-2450000,0,-2450000
98684,2020-12-31,8072,Value,2251660,-2450000,0,-2450000
98695,2020-03-31,334,Value,301760,-582279,0,-582279
98695,2020-06-30,334,Value,301760,-582279,0,-582279
98695,2020-08-15,334,Distribution,3186,-582279,3186,-579093
98695,2020-09-30,334,Value,315640,-582279,3186,-579093
98695,2020-11-15,334,Capital Call,-1699430,-2281709,3186,-2278523
98695,2020-11-15,334,Distribution,70099,-2281709,73285,-2208424
98695,2020-12-31,334,Value,1759570,-2281709,73285,-2208424
98695,2021-03-31,334,Value,2795660,-2281709,73285,-2208424
98695,2021-05-16,334,Capital Call,475867,-1805842,73285,-1732557
98695,2021-06-30,334,Value,3437850,-1805842,73285,-1732557
98727,2020-07-01,14457,Capital Call,-2690000,-4390000,0,-4390000
98727,2020-12-31,14457,Value,7463000,-4390000,0,-4390000
98727,2021-02-14,14457,Capital Call,-1148000,-5538000,0,-5538000
98727,2021-03-31,14457,Value,8927250,-5538000,0,-5538000
98729,2020-02-14,177606,Capital Call,-1380000,-1590000,0,-1590000
98729,2020-09-30,177606,Value,1317060,-1590000,0,-1590000
98746,2020-02-15,17188,Capital Call,-830443,-2000000,0,-2000000
98746,2020-03-31,17188,Value,2321500,-2000000,0,-2000000
98746,2020-05-16,17188,Capital Call,-500000,-2500000,0,-2500000
98746,2020-06-30,17188,Value,3118200,-2500000,0,-2500000
98746,2020-08-15,17188,Capital Call,-500000,-3000000,0,-3000000
98746,2020-09-30,17188,Value,4260000,-3000000,0,-3000000
98746,2020-11-15,17188,Capital Call,-500000,-3500000,0,-3500000
98746,2020-12-31,17188,Value,5129600,-3500000,0,-3500000
98746,2021-02-14,17188,Capital Call,-500000,-4000000,0,-4000000
98746,2021-03-31,17188,Value,6722400,-4000000,0,-4000000
98746,2021-06-30,17188,Value,8009600,-4000000,0,-4000000
98746,2021-09-30,17188,Value,8140400,-4000000,0,-4000000
98746,2021-11-15,17188,Capital Call,-2250000,-6250000,0,-6250000
98746,2021-12-31,17188,Value,12881250,-6250000,0,-6250000
98848,2020-07-01,783,Capital Call,-2775000,-7340000,0,-7340000
98848,2020-07-01,783,Distribution,1095000,-7340000,1095000,-6245000
98848,2020-12-31,783,Value,10030000,-7340000,1095000,-6245000
98922,2020-06-30,2166,Capital Call,-717138,-717138,0,-717138
98922,2020-06-30,2166,Value,695320,-717138,0,-717138
98922,2020-08-15,2166,Capital Call,-1031580,-1748718,0,-1748718
98922,2020-08-15,2166,Distribution,141488,-1748718,141488,-1607230
98922,2020-09-30,2166,Value,1664770,-1748718,141488,-1607230
98922,2020-11-15,2166,Capital Call,-1638665,-3387383,141488,-3245895
98922,2020-12-31,2166,Value,3517220,-3387383,141488,-3245895
98922,2021-03-31,2166,Value,3907390,-3387383,141488,-3245895
98922,2021-05-16,2166,Capital Call,-2755113,-6142496,141488,-6001008
98922,2021-06-30,2166,Value,7020980,-6142496,141488,-6001008
99057,2020-03-25,190539,Capital Call,-3429422,-3429422,0,-3429422
99057,2020-03-31,190539,Value,1712090,-3429422,0,-3429422
99057,2020-06-04,190539,Capital Call,-108417,-3537839,0,-3537839
99057,2020-06-30,190539,Value,1697060,-3537839,0,-3537839
99057,2020-07-15,190539,Capital Call,-27285,-3565124,0,-3565124
99057,2020-08-28,190539,Capital Call,-164871,-3729995,0,-3729995
99057,2020-09-02,190539,Capital Call,-27501,-3757496,0,-3757496
99057,2020-09-28,190539,Capital Call,-2355002,-6112498,0,-6112498
99057,2020-09-30,190539,Value,4175630,-6112498,0,-6112498
99057,2020-11-04,190539,Capital Call,-89814,-6202312,0,-6202312
99057,2020-12-21,190539,Capital Call,-1867161,-8069473,0,-8069473
99057,2020-12-31,190539,Value,6568700,-8069473,0,-8069473
99057,2021-01-21,190539,Capital Call,-342032,-8411505,0,-8411505
99057,2021-03-31,190539,Value,6750020,-8411505,0,-8411505
99057,2021-04-12,190539,Capital Call,-86619,-8498124,0,-8498124
99057,2021-04-13,190539,Capital Call,-41724,-8539848,0,-8539848
99057,2021-05-18,190539,Capital Call,-174226,-8714074,0,-8714074
99057,2021-05-27,190539,Capital Call,-5234,-8719308,0,-8719308
99057,2021-06-30,190539,Value,7822150,-8719308,0,-8719308
99057,2021-07-02,190539,Capital Call,-175461,-8894769,0,-8894769
99057,2021-07-08,190539,Capital Call,-980387,-9875156,0,-9875156
99057,2021-07-16,190539,Capital Call,-99690,-9974846,0,-9974846
99057,2021-09-13,190539,Capital Call,-25153,-9999999,0,-9999999
99057,2021-09-30,190539,Value,7894270,-9999999,0,-9999999
99097,2020-01-15,40,Capital Call,-1196542,-1854377,0,-1854377
99097,2020-02-29,40,Value,1632100,-1854377,0,-1854377
99097,2020-05-31,40,Value,1587490,-1854377,0,-1854377
99097,2020-07-16,40,Capital Call,-1329491,-3183868,0,-3183868
99097,2020-08-31,40,Value,2851280,-3183868,0,-3183868
99097,2020-10-16,40,Capital Call,-531798,-3715666,0,-3715666
99097,2020-11-30,40,Value,3998590,-3715666,0,-3715666
99097,2021-01-14,40,Capital Call,-618213,-4333879,0,-4333879
99097,2021-02-28,40,Value,4423770,-4333879,0,-4333879
99097,2021-04-15,40,Capital Call,-864169,-5198048,0,-5198048
99097,2021-05-31,40,Value,7497170,-5198048,0,-5198048
99097,2021-08-31,40,Value,7445940,-5198048,0,-5198048
99097,2021-10-16,40,Capital Call,-1229778,-6427826,0,-6427826
99097,2021-11-30,40,Value,9492210,-6427826,0,-6427826
99155,2020-02-15,537,Capital Call,-600000,-1750000,0,-1750000
99155,2020-03-31,537,Value,1677200,-1750000,0,-1750000
99155,2020-05-16,537,Capital Call,-150000,-1900000,0,-1900000
99155,2020-06-30,537,Value,1942600,-1900000,0,-1900000
99155,2020-08-15,537,Capital Call,-875000,-2775000,0,-2775000
99155,2020-09-30,537,Value,3131900,-2775000,0,-2775000
99155,2020-11-15,537,Capital Call,-725000,-3500000,0,-3500000
99155,2020-12-31,537,Value,4185500,-3500000,0,-3500000
99155,2021-02-14,537,Capital Call,-600000,-4100000,0,-4100000
99155,2021-03-31,537,Value,6362800,-4100000,0,-4100000
99155,2021-05-16,537,Capital Call,-750000,-4850000,0,-4850000
99155,2021-05-16,537,Distribution,282900,-4850000,282900,-4567100
99155,2021-06-30,537,Value,7550100,-4850000,282900,-4567100
99160,2020-03-31,42,Capital Call,-380000,-530000,0,-530000
99160,2020-06-30,42,Value,446100,-530000,0,-530000
99160,2020-09-30,42,Value,495440,-530000,0,-530000
99160,2020-11-15,42,Capital Call,1000,-529000,0,-529000
99160,2020-12-31,42,Value,558540,-529000,0,-529000
99160,2021-02-14,42,Capital Call,-2711000,-3240000,0,-3240000
99160,2021-03-31,42,Value,3314840,-3240000,0,-3240000
99160,2021-05-16,42,Capital Call,-980000,-4220000,0,-4220000
99160,2021-06-30,42,Value,4276540,-4220000,0,-4220000
99189,2020-03-31,718,Value,1257880,-1500000,0,-1500000
99189,2020-06-30,718,Value,1477880,-1500000,0,-1500000
99189,2020-08-15,718,Capital Call,-2500000,-4000000,0,-4000000
99189,2020-09-30,718,Value,4199220,-4000000,0,-4000000
99189,2020-11-15,718,Capital Call,-1500000,-5500000,0,-5500000
99189,2020-12-31,718,Value,5966550,-5500000,0,-5500000
99189,2021-02-14,718,Capital Call,-1000000,-6500000,0,-6500000
99189,2021-02-14,718,Distribution,150000,-6500000,150000,-6350000
99189,2021-03-31,718,Value,8477880,-6500000,150000,-6350000
99189,2021-05-16,718,Capital Call,-1200000,-7700000,150000,-7550000
99189,2021-05-16,718,Distribution,1600000,-7700000,1750000,-5950000
99189,2021-06-30,718,Value,9032660,-7700000,1750000,-5950000
99219,2020-03-31,10775,Value,864070,-1000000,0,-1000000
99219,2020-05-16,10775,Capital Call,-340000,-1340000,0,-1340000
99219,2020-06-30,10775,Value,1144490,-1340000,0,-1340000
99219,2020-09-30,10775,Value,1079020,-1340000,0,-1340000
99219,2020-11-15,10775,Capital Call,-345000,-1685000,0,-1685000
99219,2020-12-31,10775,Value,1685000,-1685000,0,-1685000
99219,2021-02-14,10775,Capital Call,-395000,-2080000,0,-2080000
99219,2021-03-31,10775,Value,2130920,-2080000,0,-2080000
99219,2021-05-16,10775,Capital Call,-780000,-2860000,0,-2860000
99219,2021-06-30,10775,Value,3346720,-2860000,0,-2860000
99344,2020-05-16,60,Capital Call,-2001000,-4690000,0,-4690000
99344,2020-05-16,60,Distribution,4690,-4690000,4690,-4685310
99344,2020-09-30,60,Value,4957330,-4690000,4690,-4685310
99344,2020-11-15,60,Capital Call,-1030000,-5720000,4690,-5715310
99344,2020-11-15,60,Distribution,6750,-5720000,11440,-5708560
99344,2020-12-31,60,Value,6309160,-5720000,11440,-5708560
99344,2021-02-14,60,Capital Call,-930000,-6650000,11440,-6638560
99344,2021-02-14,60,Distribution,1860,-6650000,13300,-6636700
99344,2021-03-31,60,Value,8239350,-6650000,13300,-6636700
99344,2021-05-16,60,Capital Call,2114,-6647886,13300,-6634586
99344,2021-05-16,60,Distribution,1755,-6647886,15055,-6632831
99344,2021-06-30,60,Value,8797290,-6647886,15055,-6632831
99344,2021-08-15,60,Capital Call,-862114,-7510000,15055,-7494945
99344,2021-08-15,60,Distribution,-35,-7510000,15020,-7494980
99344,2021-09-30,60,Value,9905690,-7510000,15020,-7494980
99397,2020-03-31,32278,Capital Call,-1714286,-4000000,0,-4000000
99397,2020-09-30,32278,Value,4000000,-4000000,0,-4000000
99397,2020-12-30,32278,Capital Call,-1040000,-5040000,0,-5040000
99397,2021-03-31,32278,Value,5040000,-5040000,0,-5040000
99397,2021-07-01,32278,Capital Call,-1250000,-6290000,0,-6290000
99397,2021-09-30,32278,Value,6604500,-6290000,0,-6290000
99397,2021-11-15,32278,Capital Call,-510000,-6800000,0,-6800000
99397,2021-12-31,32278,Value,7616000,-6800000,0,-6800000
99416,2020-06-30,11832,Capital Call,-95967,-95967,0,-95967
99416,2020-06-30,11832,Value,49720,-95967,0,-95967
99416,2020-08-15,11832,Capital Call,-204033,-300000,0,-300000
99416,2020-09-30,11832,Value,182750,-300000,0,-300000
99416,2020-12-31,11832,Value,137000,-300000,0,-300000
99416,2021-02-14,11832,Capital Call,-999475,-1299475,0,-1299475
99416,2021-02-14,11832,Distribution,10157,-1299475,10157,-1289318
99416,2021-03-31,11832,Value,933600,-1299475,10157,-1289318
99416,2021-05-16,11832,Capital Call,-695265,-1994740,10157,-1984583
99416,2021-05-16,11832,Distribution,484,-1994740,10641,-1984099
99416,2021-06-30,11832,Value,1671230,-1994740,10641,-1984099
99416,2021-08-15,11832,Capital Call,-781909,-2776649,10641,-2766008
99416,2021-09-30,11832,Value,2549020,-2776649,10641,-2766008
99453,2020-03-31,5682,Capital Call,-43000,-8425000,0,-8425000
99453,2020-06-30,5682,Value,8108220,-8425000,0,-8425000
99453,2020-09-30,5682,Capital Call,256000,-8169000,0,-8169000
99453,2020-12-31,5682,Value,7463190,-8169000,0,-8169000
99454,2020-06-30,5682,Value,2404590,-2983000,14617,-2968383
99454,2020-09-30,5682,Distribution,-298,-2983000,14319,-2968681
99454,2020-12-31,5682,Value,2286460,-2983000,14319,-2968681
99644,2020-08-15,2011,Capital Call,-2269000,-3818000,0,-3818000
99644,2021-03-31,2011,Value,3818000,-3818000,0,-3818000
99680,2020-02-15,8729,Capital Call,-390864,-3050000,1382,-3048618
99680,2020-02-15,8729,Distribution,-1382,-3050000,0,-3050000
99680,2020-03-31,8729,Value,2992050,-3050000,0,-3050000
99680,2020-05-16,8729,Capital Call,-711733,-3761733,0,-3761733
99680,2020-05-16,8729,Distribution,1382,-3761733,1382,-3760351
99680,2020-06-30,8729,Value,3532330,-3761733,1382,-3760351
99680,2020-08-15,8729,Capital Call,-1671860,-5433593,1382,-5432211
99680,2020-08-15,8729,Distribution,1326,-5433593,2708,-5430885
99680,2020-09-30,8729,Value,6151030,-5433593,2708,-5430885
99680,2020-11-15,8729,Capital Call,-98272,-5531865,2708,-5529157
99680,2020-11-15,8729,Distribution,1718,-5531865,4426,-5527439
99680,2020-12-31,8729,Value,6559170,-5531865,4426,-5527439
99680,2021-04-01,8729,Capital Call,-968135,-6500000,4426,-6495574
99680,2021-04-01,8729,Distribution,775,-6500000,5201,-6494799
99680,2021-06-30,8729,Value,6734000,-6500000,5201,-6494799
99680,2021-08-15,8729,Distribution,98,-6500000,5299,-6494701
99680,2021-09-30,8729,Value,7787650,-6500000,5299,-6494701
99688,2020-02-15,2562,Capital Call,-500000,-2500000,0,-2500000
99688,2020-03-31,2562,Value,2232250,-2500000,0,-2500000
99688,2020-06-30,2562,Value,2275250,-2500000,0,-2500000
99688,2020-09-30,2562,Value,2605000,-2500000,0,-2500000
99688,2021-02-14,2562,Capital Call,-2500000,-5000000,0,-5000000
99688,2021-06-30,2562,Value,7210000,-5000000,0,-5000000
99688,2021-09-30,2562,Capital Call,-2000000,-7000000,0,-7000000
99688,2021-12-31,2562,Value,10689000,-7000000,0,-7000000
99691,2020-03-31,139051,Value,18039680,-10000000,0,-10000000
99691,2020-09-30,139051,Value,18039680,-10000000,0,-10000000
99772,2020-03-31,191019,Capital Call,-1644692,-2318729,0,-2318729
99772,2020-06-30,191019,Value,2035480,-2318729,0,-2318729
99772,2020-08-15,191019,Capital Call,139124,-2179605,0,-2179605
99772,2020-09-30,191019,Value,1849440,-2179605,0,-2179605
99772,2020-12-31,191019,Value,2106350,-2179605,0,-2179605
99780,2020-02-15,6198,Capital Call,-3015000,-4830000,0,-4830000
99780,2020-03-31,6198,Value,4640660,-4830000,0,-4830000
99780,2020-06-30,6198,Value,4601540,-4830000,0,-4830000
99780,2020-08-15,6198,Capital Call,-1040000,-5870000,0,-5870000
99780,2020-09-30,6198,Value,12781330,-5870000,0,-5870000
99780,2020-11-15,6198,Capital Call,-110000,-5980000,0,-5980000
99780,2020-11-15,6198,Distribution,3689660,-5980000,3689660,-2290340
99780,2020-12-31,6198,Value,8502360,-5980000,3689660,-2290340
99780,2021-02-14,6198,Capital Call,-1110000,-7090000,3689660,-3400340
99780,2021-02-14,6198,Distribution,-24,-7090000,3689636,-3400364
99780,2021-03-31,6198,Value,9705500,-7090000,3689636,-3400364
99780,2021-06-30,6198,Value,11105060,-7090000,3689636,-3400364
99780,2021-08-15,6198,Capital Call,-675000,-7765000,3689636,-4075364
99780,2021-08-15,6198,Distribution,775239,-7765000,4464875,-3300125
99780,2021-09-30,6198,Value,11176160,-7765000,4464875,-3300125
99856,2021-06-30,3616,Capital Call,-4465000,-4465000,0,-4465000
99856,2021-06-30,3616,Distribution,1339,-4465000,1339,-4463661
99856,2021-06-30,3616,Value,5789310,-4465000,1339,-4463661
99861,2020-02-15,10699,Capital Call,336,-2416999,0,-2416999
99861,2020-03-31,10699,Value,2339890,-2416999,0,-2416999
99861,2020-05-16,10699,Capital Call,-851000,-3267999,0,-3267999
99861,2020-06-30,10699,Value,3606890,-3267999,0,-3267999
99861,2020-08-15,10699,Capital Call,-1078037,-4346036,0,-4346036
99861,2020-09-30,10699,Value,5059140,-4346036,0,-4346036
99861,2021-02-14,10699,Capital Call,-42963,-4388999,0,-4388999
99861,2021-06-30,10699,Value,6587010,-4388999,0,-4388999
99898,2020-05-31,780,Capital Call,-78128,-78128,0,-78128
99898,2020-05-31,780,Value,78120,-78128,0,-78128
99898,2020-07-16,780,Capital Call,-48604,-126732,0,-126732
99898,2020-08-31,780,Value,33610,-126732,0,-126732
99898,2020-10-16,780,Capital Call,-1849722,-1976454,0,-1976454
99898,2020-11-30,780,Value,1839740,-1976454,0,-1976454
99898,2021-01-14,780,Capital Call,-2451350,-4427804,0,-4427804
99898,2021-02-28,780,Value,4291090,-4427804,0,-4427804
99898,2021-04-15,780,Capital Call,-1625217,-6053021,0,-6053021
99898,2021-05-31,780,Value,5863120,-6053021,0,-6053021
99898,2021-07-16,780,Capital Call,-1182410,-7235431,0,-7235431
99898,2021-07-16,780,Distribution,1381889,-7235431,1381889,-5853542
99898,2021-08-31,780,Value,7907440,-7235431,1381889,-5853542
99898,2021-10-16,780,Capital Call,-37622,-7273053,1381889,-5891164
99898,2021-11-30,780,Value,9285550,-7273053,1381889,-5891164
100025,2020-03-31,1878,Value,2525000,-2500000,0,-2500000
100025,2020-06-30,1878,Value,2825000,-2500000,0,-2500000
100025,2020-09-30,1878,Value,2900000,-2500000,0,-2500000
100025,2020-11-15,1878,Capital Call,-2900000,-5400000,0,-5400000
100025,2020-12-31,1878,Value,6210000,-5400000,0,-5400000
100025,2021-02-14,1878,Capital Call,-600000,-6000000,0,-6000000
100025,2021-03-31,1878,Value,6720000,-6000000,0,-6000000
100025,2021-05-16,1878,Capital Call,-1200000,-7200000,0,-7200000
100025,2021-06-30,1878,Value,9000000,-7200000,0,-7200000
100025,2021-08-15,1878,Capital Call,-1000000,-8200000,0,-8200000
100025,2021-09-30,1878,Value,10660000,-8200000,0,-8200000
100035,2020-02-15,461,Capital Call,-500000,-3050000,0,-3050000
100035,2020-03-31,461,Value,3040440,-3050000,0,-3050000
100035,2020-06-30,461,Value,3033960,-3050000,0,-3050000
100035,2020-08-15,461,Capital Call,-650000,-3700000,0,-3700000
100035,2020-09-30,461,Value,3673070,-3700000,0,-3700000
100035,2020-11-15,461,Capital Call,-650000,-4350000,0,-4350000
100035,2020-12-31,461,Value,4607740,-4350000,0,-4350000
100035,2021-02-14,461,Capital Call,-1550000,-5900000,0,-5900000
100035,2021-03-31,461,Value,6984210,-5900000,0,-5900000
100035,2021-05-16,461,Capital Call,-1200000,-7100000,0,-7100000
100035,2021-06-30,461,Value,8540510,-7100000,0,-7100000
100037,2020-02-15,2317,Capital Call,-1900000,-2280000,0,-2280000
100037,2020-03-31,2317,Value,2270880,-2280000,0,-2280000
100037,2020-05-16,2317,Capital Call,-30000,-2310000,0,-2310000
100037,2020-06-30,2317,Value,2303070,-2310000,0,-2310000
100037,2020-08-15,2317,Capital Call,-510000,-2820000,0,-2820000
100037,2020-09-30,2317,Value,2961000,-2820000,0,-2820000
100037,2020-12-31,2317,Value,3118920,-2820000,0,-2820000
100037,2021-02-14,2317,Capital Call,-1730000,-4550000,0,-4550000
100037,2021-03-31,2317,Value,5573750,-4550000,0,-4550000
100038,2020-02-15,2317,Capital Call,-80000,-220000,0,-220000
100038,2020-03-31,2317,Value,138600,-220000,0,-220000
100107,2020-03-31,116934,Capital Call,-1802000,-1802000,0,-1802000
100107,2020-03-31,116934,Value,1693000,-1802000,0,-1802000
100107,2020-05-16,116934,Capital Call,211000,-1591000,0,-1591000
100107,2020-06-30,116934,Value,1396000,-1591000,0,-1591000
100107,2020-08-15,116934,Capital Call,-1132000,-2723000,0,-2723000
100107,2020-09-30,116934,Value,2820000,-2723000,0,-2723000
100107,2020-11-15,116934,Capital Call,677000,-2046000,0,-2046000
100107,2020-12-31,116934,Value,2345000,-2046000,0,-2046000
100146,2020-06-30,112924,Capital Call,-720909,-720909,0,-720909
100146,2020-06-30,112924,Value,564590,-720909,0,-720909
100148,2020-03-31,112924,Value,3632880,-3821804,0,-3821804
100148,2020-05-16,112924,Capital Call,-1614847,-5436651,0,-5436651
100148,2020-06-30,112924,Value,5200510,-5436651,0,-5436651
100148,2020-09-30,112924,Value,5252240,-5436651,0,-5436651
100148,2020-12-30,112924,Capital Call,-1453087,-6889738,0,-6889738
100148,2020-12-30,112924,Distribution,16656,-6889738,16656,-6873082
100148,2021-03-31,112924,Value,10284000,-6889738,16656,-6873082
100148,2021-06-30,112924,Value,10307240,-6889738,16656,-6873082
100157,2020-03-31,355,Value,500000,-500000,0,-500000
100157,2020-05-16,355,Capital Call,-550000,-1050000,0,-1050000
100157,2020-06-30,355,Value,950000,-1050000,0,-1050000
100161,2020-02-15,54274,Capital Call,304000,-1480000,0,-1480000
100161,2020-03-31,54274,Value,2108000,-1480000,0,-1480000
100161,2020-05-16,54274,Capital Call,-702000,-2182000,0,-2182000
100161,2020-05-16,54274,Distribution,48000,-2182000,48000,-2134000
100161,2020-06-30,54274,Value,2774000,-2182000,48000,-2134000
100161,2020-08-15,54274,Capital Call,-54000,-2236000,48000,-2188000
100161,2020-09-30,54274,Value,2966000,-2236000,48000,-2188000
100161,2020-11-15,54274,Capital Call,-110000,-2346000,48000,-2298000
100161,2020-11-15,54274,Distribution,186000,-2346000,234000,-2112000
100161,2020-12-31,54274,Value,2902000,-2346000,234000,-2112000
100167,2020-03-31,155472,Value,1920000,-2000000,0,-2000000
100255,2020-03-31,321276,Capital Call,-2000000,-2000000,0,-2000000
100255,2020-03-31,321276,Value,2128000,-2000000,0,-2000000
100255,2020-06-30,321276,Value,2192000,-2000000,0,-2000000
100255,2020-08-15,321276,Capital Call,-1000000,-3000000,0,-3000000
100255,2020-09-30,321276,Value,3092000,-3000000,0,-3000000
100255,2020-12-31,321276,Value,3274000,-3000000,0,-3000000
100268,2020-02-15,355,Capital Call,-1100000,-1800000,0,-1800000
100268,2020-02-15,355,Distribution,37733,-1800000,37733,-1762267
100268,2020-03-31,355,Value,1677540,-1800000,37733,-1762267
100268,2020-05-16,355,Capital Call,-550000,-2350000,37733,-2312267
100268,2020-06-30,355,Value,2455550,-2350000,37733,-2312267
100268,2020-08-15,355,Capital Call,-550000,-2900000,37733,-2862267
100268,2020-08-15,355,Distribution,29027,-2900000,66760,-2833240
100268,2020-09-30,355,Value,3438950,-2900000,66760,-2833240
100268,2020-11-15,355,Capital Call,-650000,-3550000,66760,-3483240
100268,2020-11-15,355,Distribution,44993,-3550000,111753,-3438247
100268,2020-12-31,355,Value,4811220,-3550000,111753,-3438247
100268,2021-02-14,355,Capital Call,-600000,-4150000,111753,-4038247
100268,2021-02-14,355,Distribution,123367,-4150000,235120,-3914880
100268,2021-03-31,355,Value,6295270,-4150000,235120,-3914880
100268,2021-05-16,355,Capital Call,-900000,-5050000,235120,-4814880
100268,2021-05-16,355,Distribution,304793,-5050000,539913,-4510087
100268,2021-06-30,355,Value,8063260,-5050000,539913,-4510087
100337,2020-02-15,6140,Capital Call,-52149,-183642,0,-183642
100337,2020-03-31,6140,Value,50300,-183642,0,-183642
100337,2020-05-16,6140,Capital Call,-1125380,-1309022,0,-1309022
100337,2020-06-30,6140,Value,1327340,-1309022,0,-1309022
100337,2020-08-15,6140,Capital Call,-31526,-1340548,0,-1340548
100337,2020-09-30,6140,Value,1727160,-1340548,0,-1340548
100337,2020-11-15,6140,Capital Call,-614638,-1955186,0,-1955186
100337,2020-12-31,6140,Value,2502350,-1955186,0,-1955186
100337,2021-02-14,6140,Capital Call,-41559,-1996745,0,-1996745
100337,2021-03-31,6140,Value,2611550,-1996745,0,-1996745
100337,2021-05-16,6140,Capital Call,-1634704,-3631449,0,-3631449
100337,2021-06-30,6140,Value,4560190,-3631449,0,-3631449
100340,2020-02-24,190539,Capital Call,-1954506,-8043499,0,-8043499
100340,2020-03-31,190539,Value,8102130,-8043499,0,-8043499
100340,2020-06-30,190539,Value,8205020,-8043499,0,-8043499
100377,2020-02-15,93335,Capital Call,-250000,-1125111,0,-1125111
100377,2020-03-31,93335,Value,964880,-1125111,0,-1125111
100377,2020-05-16,93335,Capital Call,-750000,-1875111,0,-1875111
100377,2020-06-30,93335,Value,1690660,-1875111,0,-1875111
100377,2020-08-15,93335,Capital Call,-850000,-2725111,0,-2725111
100377,2020-09-30,93335,Value,2604000,-2725111,0,-2725111
100377,2020-11-15,93335,Capital Call,-724889,-3450000,0,-3450000
100377,2020-12-31,93335,Value,3598440,-3450000,0,-3450000
100377,2021-02-14,93335,Capital Call,-125111,-3575111,0,-3575111
100377,2021-03-31,93335,Value,3710220,-3575111,0,-3575111
100377,2021-05-16,93335,Capital Call,-850000,-4425111,0,-4425111
100377,2021-06-30,93335,Value,6592440,-4425111,0,-4425111
100379,2020-01-15,18159,Capital Call,-2453469,-2542046,0,-2542046
100379,2020-02-29,18159,Value,2453560,-2542046,0,-2542046
100379,2020-04-15,18159,Capital Call,-56001,-2598047,0,-2598047
100379,2020-05-31,18159,Value,2137250,-2598047,0,-2598047
100379,2020-07-16,18159,Capital Call,-2398141,-4996188,0,-4996188
100379,2020-08-31,18159,Value,4717870,-4996188,0,-4996188
100379,2020-10-16,18159,Capital Call,-94661,-5090849,0,-5090849
100379,2020-11-30,18159,Value,4986790,-5090849,0,-5090849
100379,2021-01-14,18159,Capital Call,-56660,-5147509,0,-5147509
100379,2021-02-28,18159,Value,5431910,-5147509,0,-5147509
100379,2021-04-15,18159,Capital Call,-701161,-5848670,0,-5848670
100379,2021-05-31,18159,Value,6358320,-5848670,0,-5848670
100379,2021-07-16,18159,Capital Call,-964012,-6812682,0,-6812682
100379,2021-08-31,18159,Value,8162080,-6812682,0,-6812682
100379,2021-10-16,18159,Capital Call,-51252,-6863934,0,-6863934
100379,2021-11-30,18159,Value,8200680,-6863934,0,-6863934
100404,2020-03-31,9389,Capital Call,-1538000,-1538000,0,-1538000
100404,2020-03-31,9389,Value,1444330,-1538000,0,-1538000
100404,2020-06-30,9389,Value,1444330,-1538000,0,-1538000
100435,2020-02-15,6372,Capital Call,-1270100,-4299576,0,-4299576
100435,2020-03-31,6372,Value,3916910,-4299576,0,-4299576
100435,2020-05-16,6372,Capital Call,-821010,-5120586,0,-5120586
100435,2020-06-30,6372,Value,5177480,-5120586,0,-5120586
100435,2020-08-15,6372,Capital Call,-1117801,-6238387,0,-6238387
100435,2020-08-15,6372,Distribution,4853,-6238387,4853,-6233534
100435,2020-09-30,6372,Value,6626480,-6238387,4853,-6233534
100435,2020-11-15,6372,Capital Call,-1524799,-7763186,4853,-7758333
100435,2020-11-15,6372,Distribution,52965,-7763186,57818,-7705368
100435,2020-12-31,6372,Value,8078660,-7763186,57818,-7705368
100439,2020-02-15,198087,Capital Call,-1000000,-1500000,0,-1500000
100439,2020-03-31,198087,Value,1349890,-1500000,0,-1500000
100439,2020-06-30,198087,Value,1300550,-1500000,0,-1500000
100439,2020-08-15,198087,Capital Call,-800000,-2300000,0,-2300000
100439,2020-09-30,198087,Value,2052800,-2300000,0,-2300000
100439,2020-12-31,198087,Value,3517640,-2300000,0,-2300000
100441,2020-03-31,121464,Value,1063830,-1265859,0,-1265859
100441,2020-05-16,121464,Capital Call,-948410,-2214269,0,-2214269
100441,2020-05-16,121464,Distribution,86,-2214269,86,-2214183
100441,2020-06-30,121464,Value,1965510,-2214269,86,-2214183
100441,2020-09-30,121464,Capital Call,-3362246,-5576515,86,-5576429
100441,2020-12-31,121464,Value,5791450,-5576515,86,-5576429
100441,2021-03-31,121464,Value,5785690,-5576515,86,-5576429
100441,2021-06-30,121464,Value,6020370,-5576515,86,-5576429
100608,2020-09-30,297291,Capital Call,-7200000,-7200000,0,-7200000
100608,2020-09-30,297291,Value,7320000,-7200000,0,-7200000
100608,2020-12-31,297291,Value,8580000,-7200000,0,-7200000
100608,2021-02-14,297291,Capital Call,-1400000,-8600000,0,-8600000
100608,2021-03-31,297291,Value,12100000,-8600000,0,-8600000
100608,2021-05-16,297291,Capital Call,-760000,-9360000,0,-9360000
100608,2021-06-30,297291,Value,14540000,-9360000,0,-9360000
100608,2021-08-15,297291,Distribution,340000,-9360000,340000,-9020000
100608,2021-09-30,297291,Value,14960000,-9360000,340000,-9020000
100960,2020-04-03,15554,Capital Call,-184463,-292907,0,-292907
100960,2020-09-01,15554,Capital Call,-1495329,-1788236,0,-1788236
100960,2021-02-05,15554,Capital Call,-443787,-2232023,0,-2232023
100960,2021-06-14,15554,Capital Call,-1582840,-3814863,0,-3814863
100960,2021-06-30,15554,Value,1825230,-3814863,0,-3814863
100960,2021-09-23,15554,Capital Call,-51775,-3866638,0,-3866638
100960,2021-12-17,15554,Capital Call,-1628749,-5495387,0,-5495387
100960,2021-12-31,15554,Value,4093270,-5495387,0,-5495387
100961,2020-02-15,672,Capital Call,-835001,-1290001,0,-1290001
100961,2020-02-15,672,Distribution,15561,-1290001,15561,-1274440
100961,2020-03-31,672,Value,1274430,-1290001,15561,-1274440
100961,2020-05-16,672,Capital Call,-304999,-1595000,15561,-1579439
100961,2020-05-16,672,Distribution,5000,-1595000,20561,-1574439
100961,2020-06-30,672,Value,1484890,-1595000,20561,-1574439
100972,2020-03-02,246549,Capital Call,-1180000,-1180000,0,-1180000
100972,2020-03-31,246549,Value,3787340,-1180000,0,-1180000
100972,2020-06-22,246549,Capital Call,-675000,-1855000,0,-1855000
100972,2020-06-30,246549,Value,4840300,-1855000,0,-1855000
100972,2020-09-09,246549,Capital Call,-645000,-2500000,0,-2500000
100972,2020-12-31,246549,Capital Call,-3341853,-5841853,0,-5841853
100972,2020-12-31,246549,Value,5335840,-5841853,0,-5841853
101066,2020-12-31,479,Capital Call,-1135000,-1135000,0,-1135000
101066,2020-12-31,479,Value,1633600,-1135000,0,-1135000
101066,2021-03-31,479,Value,1633600,-1135000,0,-1135000
101066,2021-05-16,479,Capital Call,-1098000,-2233000,0,-2233000
101066,2021-06-30,479,Value,3156120,-2233000,0,-2233000
101066,2021-09-30,479,Capital Call,-939000,-3172000,0,-3172000
101066,2021-09-30,479,Distribution,762549,-3172000,762549,-2409451
101066,2021-12-31,479,Value,3672540,-3172000,762549,-2409451
101098,2020-03-31,361,Capital Call,-10007313,-10007313,0,-10007313
101098,2020-03-31,361,Value,9115170,-10007313,0,-10007313
101098,2020-06-30,361,Value,10338200,-10007313,0,-10007313
101098,2020-09-30,361,Value,11074950,-10007313,0,-10007313
101098,2020-12-31,361,Value,11930530,-10007313,0,-10007313
101098,2021-03-31,361,Value,12930530,-10007313,0,-10007313
101098,2021-06-30,361,Value,14435100,-10007313,0,-10007313
101114,2020-06-30,332,Capital Call,-29000,-29000,0,-29000
101114,2020-06-30,332,Value,29500,-29000,0,-29000
101114,2020-09-30,332,Value,7840,-29000,0,-29000
101114,2020-12-31,332,Value,17140,-29000,0,-29000
101114,2021-02-14,332,Capital Call,-745578,-774578,0,-774578
101114,2021-03-31,332,Value,719380,-774578,0,-774578
101114,2021-05-16,332,Distribution,74578,-774578,74578,-700000
101114,2021-06-30,332,Value,754800,-774578,74578,-700000
101180,2020-03-31,308503,Value,2039260,-2352806,0,-2352806
101180,2020-07-01,308503,Capital Call,-1082956,-3435762,0,-3435762
101180,2020-09-30,308503,Value,2990500,-3435762,0,-3435762
101180,2020-11-15,308503,Capital Call,-156685,-3592447,0,-3592447
101180,2020-11-15,308503,Distribution,23787,-3592447,23787,-3568660
101180,2020-12-31,308503,Value,3086990,-3592447,23787,-3568660
101180,2021-02-14,308503,Capital Call,-1059000,-4651447,23787,-4627660
101180,2021-03-31,308503,Value,4809020,-4651447,23787,-4627660
101180,2021-06-30,308503,Value,5135940,-4651447,23787,-4627660
101199,2020-02-15,40167,Capital Call,-335087,-756896,0,-756896
101199,2020-03-31,40167,Value,742710,-756896,0,-756896
101199,2020-05-16,40167,Capital Call,-1323666,-2080562,0,-2080562
101199,2020-06-30,40167,Value,2015110,-2080562,0,-2080562
101199,2020-08-15,40167,Capital Call,-746870,-2827432,0,-2827432
101199,2020-09-30,40167,Value,2735540,-2827432,0,-2827432
101199,2020-11-15,40167,Capital Call,-1024876,-3852308,0,-3852308
101199,2020-12-31,40167,Value,3891110,-3852308,0,-3852308
101199,2021-02-14,40167,Capital Call,-1089390,-4941698,0,-4941698
101199,2021-02-14,40167,Distribution,2392,-4941698,2392,-4939306
101199,2021-03-31,40167,Value,4996630,-4941698,2392,-4939306
101284,2020-06-30,8114,Capital Call,-1715000,-1715000,0,-1715000
101284,2020-06-30,8114,Value,1375000,-1715000,0,-1715000
101284,2020-09-30,8114,Value,1315000,-1715000,0,-1715000
101284,2020-11-15,8114,Capital Call,-800000,-2515000,0,-2515000
101284,2020-12-31,8114,Value,2330000,-2515000,0,-2515000
101284,2021-02-14,8114,Capital Call,-600000,-3115000,0,-3115000
101284,2021-03-31,8114,Value,3235000,-3115000,0,-3115000
101284,2021-05-16,8114,Capital Call,-2130000,-5245000,0,-5245000
101284,2021-06-30,8114,Value,5604990,-5245000,0,-5245000
101284,2021-08-15,8114,Capital Call,-1700000,-6945000,0,-6945000
101284,2021-09-30,8114,Value,7714990,-6945000,0,-6945000
101320,2020-06-26,128815,Capital Call,-92673,-2189204,0,-2189204
101320,2020-06-26,128815,Distribution,42580,-2189204,42580,-2146624
101320,2020-10-22,128815,Capital Call,-35619,-2224823,42580,-2182243
101320,2021-01-04,128815,Capital Call,-129503,-2354326,42580,-2311746
101320,2021-01-04,128815,Distribution,20794,-2354326,63374,-2290952
101320,2021-03-31,128815,Value,2290950,-2354326,63374,-2290952
101320,2021-04-29,128815,Capital Call,-2189671,-4543997,63374,-4480623
101320,2021-06-15,128815,Capital Call,-277235,-4821232,63374,-4757858
101320,2021-06-30,128815,Value,4990250,-4821232,63374,-4757858
101459,2020-03-31,196741,Value,3050000,-3100000,0,-3100000
101459,2020-05-16,196741,Capital Call,-700000,-3800000,0,-3800000
101459,2020-06-30,196741,Value,3754000,-3800000,0,-3800000
101459,2020-08-15,196741,Capital Call,-500000,-4300000,0,-4300000
101459,2020-09-30,196741,Value,4333000,-4300000,0,-4300000
101573,2020-02-15,14,Capital Call,-480769,-2019230,0,-2019230
101573,2020-03-31,14,Value,1501040,-2019230,0,-2019230
101580,2020-03-31,109575,Capital Call,-133000,-1480000,0,-1480000
101580,2020-06-30,109575,Value,1178960,-1480000,0,-1480000
101580,2020-08-15,109575,Capital Call,93000,-1387000,0,-1387000
101580,2020-09-30,109575,Value,1080050,-1387000,0,-1387000
101580,2020-11-15,109575,Capital Call,-828000,-2215000,0,-2215000
101580,2020-12-31,109575,Value,1750510,-2215000,0,-2215000
101580,2021-03-31,109575,Value,1689380,-2215000,0,-2215000
101580,2021-05-16,109575,Capital Call,-111000,-2326000,0,-2326000
101580,2021-06-30,109575,Value,1759150,-2326000,0,-2326000
101580,2021-08-15,109575,Capital Call,-277000,-2603000,0,-2603000
101580,2021-09-30,109575,Value,2053760,-2603000,0,-2603000
101580,2021-11-15,109575,Capital Call,-105000,-2708000,0,-2708000
101580,2021-12-31,109575,Value,2699330,-2708000,0,-2708000
101688,2021-06-30,343728,Capital Call,-2370000,-2370000,0,-2370000
101688,2021-06-30,343728,Value,2156700,-2370000,0,-2370000
101688,2021-08-15,343728,Capital Call,-30000,-2400000,0,-2400000
101688,2021-09-30,343728,Value,2160000,-2400000,0,-2400000
101787,2020-03-31,208359,Capital Call,-1000000,-1000000,0,-1000000
101787,2020-03-31,208359,Value,1000000,-1000000,0,-1000000
101787,2020-06-30,208359,Value,932000,-1000000,0,-1000000
101787,2020-08-15,208359,Capital Call,-1000000,-2000000,0,-2000000
101787,2020-09-30,208359,Value,1881330,-2000000,0,-2000000
101787,2020-12-31,208359,Value,2018660,-2000000,0,-2000000
101788,2020-03-31,64993,Value,9072640,-8014000,0,-8014000
101788,2020-06-30,64993,Value,9303450,-8014000,0,-8014000
101788,2020-09-30,64993,Value,9527840,-8014000,0,-8014000
101788,2020-11-15,64993,Capital Call,293000,-7721000,0,-7721000
101788,2020-11-15,64993,Distribution,67173,-7721000,67173,-7653827
101788,2020-12-31,64993,Value,11747500,-7721000,67173,-7653827
101788,2021-03-31,64993,Value,12078730,-7721000,67173,-7653827
101788,2021-05-16,64993,Capital Call,-348000,-8069000,67173,-8001827
101788,2021-05-16,64993,Distribution,3028,-8069000,70201,-7998799
101788,2021-06-30,64993,Value,12822440,-8069000,70201,-7998799
101860,2021-03-31,328876,Capital Call,-3000000,-3000000,0,-3000000
101860,2021-03-31,328876,Distribution,960000,-3000000,960000,-2040000
101860,2021-03-31,328876,Value,3810000,-3000000,960000,-2040000
102413,2020-03-31,25642,Capital Call,-1160000,-1160000,0,-1160000
102413,2020-03-31,25642,Value,1026660,-1160000,0,-1160000
102413,2020-07-01,25642,Capital Call,-1066667,-2226667,0,-2226667
102413,2020-09-30,25642,Value,1973330,-2226667,0,-2226667
102413,2020-11-15,25642,Capital Call,-1445796,-3672463,0,-3672463
102413,2020-11-15,25642,Distribution,74,-3672463,74,-3672389
102413,2020-12-31,25642,Value,4054400,-3672463,74,-3672389
102468,2020-03-31,1597,Value,628250,-700000,0,-700000
102468,2020-05-16,1597,Capital Call,-1100000,-1800000,0,-1800000
102468,2020-06-30,1597,Value,1687500,-1800000,0,-1800000
102468,2020-09-30,1597,Value,1643220,-1800000,0,-1800000
102468,2020-11-15,1597,Capital Call,-1200000,-3000000,0,-3000000
102468,2020-12-31,1597,Value,3943200,-3000000,0,-3000000
102468,2021-02-14,1597,Capital Call,-1200000,-4200000,0,-4200000
102468,2021-03-31,1597,Value,6294960,-4200000,0,-4200000
102468,2021-05-16,1597,Capital Call,-900000,-5100000,0,-5100000
102468,2021-06-30,1597,Value,7937130,-5100000,0,-5100000
102468,2021-09-30,1597,Value,10476930,-5100000,0,-5100000
102483,2020-03-31,177882,Value,442690,-833129,0,-833129
102483,2020-05-16,177882,Capital Call,-550404,-1383533,0,-1383533
102483,2020-06-30,177882,Value,175670,-1383533,0,-1383533
102483,2020-08-15,177882,Capital Call,-1161115,-2544648,0,-2544648
102483,2020-09-30,177882,Value,1965150,-2544648,0,-2544648
102483,2020-11-15,177882,Capital Call,-152806,-2697454,0,-2697454
102483,2020-12-31,177882,Value,2117960,-2697454,0,-2697454
102483,2021-02-14,177882,Capital Call,-180234,-2877688,0,-2877688
102483,2021-02-14,177882,Distribution,1024135,-2877688,1024135,-1853553
102483,2021-03-31,177882,Value,884780,-2877688,1024135,-1853553
102483,2021-06-30,177882,Value,2105570,-2877688,1024135,-1853553
102483,2021-08-15,177882,Capital Call,-1012403,-3890091,1024135,-2865956
102483,2021-08-15,177882,Distribution,1012403,-3890091,2036538,-1853553
102483,2021-09-30,177882,Value,2232340,-3890091,2036538,-1853553
102558,2020-02-15,367,Capital Call,-45800,-160200,0,-160200
102558,2020-03-31,367,Value,10400,-160200,0,-160200
102558,2020-05-16,367,Capital Call,-340000,-500200,0,-500200
102558,2020-06-30,367,Value,261000,-500200,0,-500200
102558,2020-09-30,367,Value,196400,-500200,0,-500200
102558,2020-12-31,367,Value,354600,-500200,0,-500200
102558,2021-02-14,367,Capital Call,-294200,-794400,0,-794400
102558,2021-03-31,367,Value,597400,-794400,0,-794400
102558,2021-06-30,367,Value,747600,-794400,0,-794400
102583,2020-02-15,355,Capital Call,-1200000,-1800000,0,-1800000
102583,2020-02-15,355,Distribution,37337,-1800000,37337,-1762663
102583,2020-03-31,355,Value,1625740,-1800000,37337,-1762663
102583,2020-06-30,355,Value,1851510,-1800000,37337,-1762663
102583,2020-08-15,355,Capital Call,-250000,-2050000,37337,-2012663
102583,2020-08-15,355,Distribution,30223,-2050000,67560,-1982440
102583,2020-09-30,355,Value,2363060,-2050000,67560,-1982440
102583,2020-11-15,355,Capital Call,-300000,-2350000,67560,-2282440
102583,2020-11-15,355,Distribution,101343,-2350000,168903,-2181097
102583,2020-12-31,355,Value,3006080,-2350000,168903,-2181097
102583,2021-02-14,355,Capital Call,-350000,-2700000,168903,-2531097
102583,2021-02-14,355,Distribution,88897,-2700000,257800,-2442200
102583,2021-03-31,355,Value,3755090,-2700000,257800,-2442200
102589,2021-03-31,179775,Capital Call,-1000000,-1000000,0,-1000000
102589,2021-03-31,179775,Value,1170000,-1000000,0,-1000000
102589,2021-06-30,179775,Value,1350000,-1000000,0,-1000000
102589,2021-09-30,179775,Value,1600000,-1000000,0,-1000000
102697,2020-01-15,107175,Capital Call,-300000,-1000000,0,-1000000
102697,2020-02-29,107175,Value,932900,-1000000,0,-1000000
102697,2020-04-15,107175,Distribution,1536,-1000000,1536,-998464
102697,2020-05-31,107175,Value,901710,-1000000,1536,-998464
102697,2020-07-16,107175,Capital Call,-500000,-1500000,1536,-1498464
102697,2020-08-31,107175,Value,1404790,-1500000,1536,-1498464
102697,2020-11-30,107175,Value,1443660,-1500000,1536,-1498464
102697,2021-01-14,107175,Capital Call,-600000,-2100000,1536,-2098464
102697,2021-02-28,107175,Value,2025490,-2100000,1536,-2098464
102697,2021-04-15,107175,Capital Call,-400000,-2500000,1536,-2498464
102697,2021-05-31,107175,Value,3089390,-2500000,1536,-2498464
102697,2021-08-31,107175,Value,3073140,-2500000,1536,-2498464
102697,2021-10-16,107175,Capital Call,-400000,-2900000,1536,-2898464
102697,2021-10-16,107175,Distribution,0,-2900000,1536,-2898464
102697,2021-11-30,107175,Value,3499140,-2900000,1536,-2898464
102699,2020-09-30,222913,Capital Call,-1864812,-1864812,0,-1864812
102699,2020-09-30,222913,Value,1678140,-1864812,0,-1864812
102699,2020-12-31,222913,Value,1685230,-1864812,0,-1864812
102699,2021-03-31,222913,Value,1828290,-1864812,0,-1864812
102699,2021-05-16,222913,Capital Call,-410639,-2275451,0,-2275451
102699,2021-05-16,222913,Distribution,18101,-2275451,18101,-2257350
102699,2021-06-30,222913,Value,2282850,-2275451,18101,-2257350
102741,2020-09-30,455,Capital Call,-1030000,-1030000,0,-1030000
102741,2020-09-30,455,Value,1030000,-1030000,0,-1030000
102774,2020-06-30,6923,Capital Call,-333519,-333519,0,-333519
102774,2020-06-30,6923,Value,189530,-333519,0,-333519
102774,2020-09-30,6923,Value,159680,-333519,0,-333519
102774,2020-11-15,6923,Capital Call,-923161,-1256680,0,-1256680
102774,2020-12-31,6923,Value,834730,-1256680,0,-1256680
102810,2020-03-31,1480,Value,9581910,-8875000,0,-8875000
102845,2020-03-31,2017,Value,1519060,-1668560,6882,-1661678
102845,2020-05-16,2017,Capital Call,-1249492,-2918052,6882,-2911170
102845,2020-05-16,2017,Distribution,1002,-2918052,7884,-2910168
102845,2020-06-30,2017,Value,2729160,-2918052,7884,-2910168
102845,2020-09-30,2017,Value,2502740,-2918052,7884,-2910168
102845,2020-11-15,2017,Capital Call,-23815,-2941867,7884,-2933983
102845,2020-11-15,2017,Distribution,6343,-2941867,14227,-2927640
102845,2020-12-31,2017,Value,2767590,-2941867,14227,-2927640
102845,2021-02-14,2017,Capital Call,-806126,-3747993,14227,-3733766
102845,2021-03-31,2017,Value,4121860,-3747993,14227,-3733766
102845,2021-05-16,2017,Capital Call,-440387,-4188380,14227,-4174153
102845,2021-05-16,2017,Distribution,588291,-4188380,602518,-3585862
102845,2021-06-30,2017,Value,4322870,-4188380,602518,-3585862
102845,2021-08-15,2017,Capital Call,-254774,-4443154,602518,-3840636
102845,2021-09-30,2017,Value,4592470,-4443154,602518,-3840636
102849,2020-02-15,91659,Capital Call,-257808,-782808,0,-782808
102849,2020-02-15,91659,Distribution,5495,-782808,5495,-777313
102849,2020-03-31,91659,Value,613920,-782808,5495,-777313
102849,2020-05-16,91659,Capital Call,-570036,-1352844,5495,-1347349
102849,2020-06-30,91659,Value,1044440,-1352844,5495,-1347349
102849,2020-08-15,91659,Capital Call,-993380,-2346224,5495,-2340729
102849,2020-09-30,91659,Value,1983930,-2346224,5495,-2340729
102849,2020-11-15,91659,Capital Call,-495867,-2842091,5495,-2836596
102849,2020-12-31,91659,Value,2464820,-2842091,5495,-2836596
102849,2021-02-14,91659,Capital Call,-495866,-3337957,5495,-3332462
102849,2021-03-31,91659,Value,3152180,-3337957,5495,-3332462
102872,2020-02-15,11324,Capital Call,-125416,-856416,0,-856416
102872,2020-03-31,11324,Value,949330,-856416,0,-856416
102872,2020-05-16,11324,Capital Call,-44021,-900437,0,-900437
102872,2020-06-30,11324,Value,827140,-900437,0,-900437
102872,2020-08-15,11324,Capital Call,-129063,-1029500,0,-1029500
102872,2020-09-30,11324,Value,935500,-1029500,0,-1029500
102872,2020-12-31,11324,Value,876920,-1029500,0,-1029500
102872,2021-02-14,11324,Capital Call,-726353,-1755853,0,-1755853
102872,2021-03-31,11324,Value,1601860,-1755853,0,-1755853
102872,2021-05-16,11324,Capital Call,853,-1755000,0,-1755000
102872,2021-06-30,11324,Value,1632320,-1755000,0,-1755000
102872,2021-08-15,11324,Capital Call,-259000,-2014000,0,-2014000
102872,2021-09-30,11324,Value,1991040,-2014000,0,-2014000
102895,2020-02-15,167467,Capital Call,-1289091,-3241454,0,-3241454
102895,2020-03-31,167467,Value,3086900,-3241454,0,-3241454
102895,2020-05-16,167467,Capital Call,-630182,-3871636,0,-3871636
102895,2020-06-30,167467,Value,4299630,-3871636,0,-3871636
102895,2020-08-15,167467,Capital Call,-335818,-4207454,0,-4207454
102895,2020-09-30,167467,Value,4641450,-4207454,0,-4207454
102895,2020-12-31,167467,Value,5173810,-4207454,0,-4207454
102895,2021-02-14,167467,Capital Call,-529091,-4736545,0,-4736545
102895,2021-03-31,167467,Value,7185630,-4736545,0,-4736545
102895,2021-05-16,167467,Capital Call,-895636,-5632181,0,-5632181
102895,2021-06-30,167467,Value,9218360,-5632181,0,-5632181
102909,2020-09-30,161,Capital Call,-975200,-975200,0,-975200
102909,2020-09-30,161,Value,1227000,-975200,0,-975200
102909,2020-11-15,161,Capital Call,-1175200,-2150400,0,-2150400
102909,2020-11-15,161,Distribution,9000,-2150400,9000,-2141400
102909,2020-12-31,161,Value,3188000,-2150400,9000,-2141400
102909,2021-02-14,161,Capital Call,-43800,-2194200,9000,-2185200
102909,2021-03-31,161,Value,3908800,-2194200,9000,-2185200
102909,2021-05-16,161,Capital Call,-684600,-2878800,9000,-2869800
102909,2021-05-16,161,Distribution,880000,-2878800,889000,-1989800
102909,2021-06-30,161,Value,4395800,-2878800,889000,-1989800
102912,2020-02-15,164017,Capital Call,-1001412,-2095654,1362508,-733146
102912,2020-03-31,164017,Value,2948450,-2095654,1362508,-733146
102912,2020-05-16,164017,Capital Call,-18372,-2114026,1362508,-751518
102912,2020-06-30,164017,Value,5276980,-2114026,1362508,-751518
102912,2020-08-15,164017,Capital Call,-2728968,-4842994,1362508,-3480486
102912,2020-09-30,164017,Value,8187460,-4842994,1362508,-3480486
102912,2020-11-15,164017,Capital Call,-1629541,-6472535,1362508,-5110027
102912,2020-11-15,164017,Distribution,2907598,-6472535,4270106,-2202429
102912,2020-12-31,164017,Value,10443720,-6472535,4270106,-2202429
102912,2021-02-14,164017,Distribution,685558,-6472535,4955664,-1516871
102912,2021-03-31,164017,Value,10539310,-6472535,4955664,-1516871
102912,2021-05-16,164017,Capital Call,-2384280,-8856815,4955664,-3901151
102912,2021-06-30,164017,Value,15029100,-8856815,4955664,-3901151
102912,2021-08-15,164017,Capital Call,-374761,-9231576,4955664,-4275912
102912,2021-08-15,164017,Distribution,2206087,-9231576,7161751,-2069825
102912,2021-09-30,164017,Value,14084140,-9231576,7161751,-2069825
102912,2021-11-15,164017,Capital Call,-576735,-9808311,7161751,-2646560
102912,2021-11-15,164017,Distribution,1750765,-9808311,8912516,-895795
102912,2021-12-31,164017,Value,12935540,-9808311,8912516,-895795
102931,2020-12-31,5655,Capital Call,-2000000,-2000000,0,-2000000
102931,2020-12-31,5655,Value,1950000,-2000000,0,-2000000
102931,2021-02-14,5655,Capital Call,-1340000,-3340000,0,-3340000
102931,2021-03-31,5655,Value,3203060,-3340000,0,-3340000
102931,2021-06-30,5655,Value,3397440,-3340000,0,-3340000
102931,2021-08-15,5655,Capital Call,-1130000,-4470000,0,-4470000
102931,2021-09-30,5655,Value,4827600,-4470000,0,-4470000
102931,2021-12-31,5655,Value,5198160,-4470000,0,-4470000
103052,2020-12-31,77220,Value,21491000,-10000000,0,-10000000
103055,2020-06-30,2476,Capital Call,-1500000,-1500000,0,-1500000
103055,2020-06-30,2476,Value,1416000,-1500000,0,-1500000
103055,2020-08-15,2476,Capital Call,-750000,-2250000,0,-2250000
103055,2020-09-30,2476,Value,2319750,-2250000,0,-2250000
103055,2020-11-15,2476,Capital Call,-600000,-2850000,0,-2850000
103055,2020-12-31,2476,Value,3605250,-2850000,0,-2850000
103055,2021-02-14,2476,Capital Call,-705000,-3555000,0,-3555000
103055,2021-03-31,2476,Value,5096090,-3555000,0,-3555000
103055,2021-05-16,2476,Capital Call,-1392000,-4947000,0,-4947000
103055,2021-06-30,2476,Value,7370530,-4947000,0,-4947000
103055,2021-08-15,2476,Capital Call,-1513000,-6460000,0,-6460000
103055,2021-09-30,2476,Value,10052400,-6460000,0,-6460000
103055,2021-11-15,2476,Capital Call,-684000,-7144000,0,-7144000
103055,2021-12-31,2476,Value,10797440,-7144000,0,-7144000
103062,2020-09-30,6663,Capital Call,-1954186,-1954186,0,-1954186
103062,2020-09-30,6663,Value,1800260,-1954186,0,-1954186
103062,2020-11-15,6663,Capital Call,-988372,-2942558,0,-2942558
103062,2020-12-31,6663,Value,2732720,-2942558,0,-2942558
103112,2020-03-31,29928,Capital Call,-540000,-750000,0,-750000
103112,2020-06-30,29928,Value,529050,-750000,0,-750000
103112,2020-09-30,29928,Capital Call,-1102000,-1852000,0,-1852000
103112,2020-12-31,29928,Value,1522890,-1852000,0,-1852000
103112,2021-04-01,29928,Capital Call,-862405,-2714405,0,-2714405
103112,2021-06-30,29928,Value,2300480,-2714405,0,-2714405
103112,2021-08-15,29928,Capital Call,-2315595,-5030000,0,-5030000
103112,2021-09-30,29928,Value,4566230,-5030000,0,-5030000
103175,2020-03-31,25049,Value,237110,-395194,0,-395194
103175,2020-06-30,25049,Value,189690,-395194,0,-395194
103175,2020-09-30,25049,Value,130410,-395194,0,-395194
103175,2020-12-31,25049,Value,71130,-395194,0,-395194
103175,2021-03-31,25049,Value,15800,-395194,0,-395194
103175,2021-05-16,25049,Capital Call,-1190411,-1585605,0,-1585605
103175,2021-06-30,25049,Value,1109920,-1585605,0,-1585605
103203,2020-03-31,5571,Capital Call,-1500000,-1500000,0,-1500000
103203,2020-03-31,5571,Value,1380000,-1500000,0,-1500000
103203,2020-06-30,5571,Value,1452650,-1500000,0,-1500000
103203,2020-09-30,5571,Value,1510640,-1500000,0,-1500000
103203,2020-12-31,5571,Value,1956750,-1500000,0,-1500000
103203,2021-02-14,5571,Capital Call,-1500000,-3000000,0,-3000000
103203,2021-03-31,5571,Value,4166420,-3000000,0,-3000000
103203,2021-05-16,5571,Capital Call,-1000000,-4000000,0,-4000000
103203,2021-06-30,5571,Value,5335690,-4000000,0,-4000000
103203,2021-09-30,5571,Value,5192000,-4000000,0,-4000000
103204,2020-09-30,2214,Capital Call,-1000000,-1000000,0,-1000000
103204,2021-02-14,2214,Capital Call,-400000,-1400000,0,-1400000
103204,2021-03-31,2214,Value,1470000,-1400000,0,-1400000
103204,2021-05-16,2214,Capital Call,-500000,-1900000,0,-1900000
103204,2021-06-30,2214,Value,1653000,-1900000,0,-1900000
103204,2021-08-15,2214,Capital Call,-600000,-2500000,0,-2500000
103204,2021-09-30,2214,Value,2275000,-2500000,0,-2500000
103204,2021-12-31,2214,Value,3600000,-2500000,0,-2500000
103209,2020-06-30,66777,Capital Call,-1392381,-1392381,0,-1392381
103209,2020-06-30,66777,Value,2757230,-1392381,0,-1392381
103316,2020-03-31,97941,Value,3143870,-2575290,33984,-2541306
103316,2020-07-01,97941,Distribution,98227,-2575290,132211,-2443079
103316,2020-09-30,97941,Value,4145780,-2575290,132211,-2443079
103316,2020-11-15,97941,Distribution,22462,-2575290,154673,-2420617
103316,2020-12-31,97941,Value,4433370,-2575290,154673,-2420617
103316,2021-02-14,97941,Capital Call,-2518183,-5093473,154673,-4938800
103316,2021-03-31,97941,Value,7831620,-5093473,154673,-4938800
103316,2021-05-16,97941,Distribution,87012,-5093473,241685,-4851788
103316,2021-06-30,97941,Value,8575510,-5093473,241685,-4851788
103467,2020-02-15,14825,Capital Call,-54500,-886000,0,-886000
103467,2020-03-31,14825,Value,692500,-886000,0,-886000
103467,2020-05-16,14825,Capital Call,-50000,-936000,0,-936000
103467,2020-06-30,14825,Value,633500,-936000,0,-936000
103467,2020-08-15,14825,Capital Call,-55000,-991000,0,-991000
103467,2020-09-30,14825,Value,803500,-991000,0,-991000
103467,2020-12-31,14825,Value,744000,-991000,0,-991000
103467,2021-02-14,14825,Capital Call,-1105000,-2096000,0,-2096000
103467,2021-03-31,14825,Value,1821500,-2096000,0,-2096000
103467,2021-06-30,14825,Value,1944500,-2096000,0,-2096000
103470,2020-03-31,6923,Capital Call,-6000,-8366000,0,-8366000
103470,2020-03-31,6923,Distribution,10,-8366000,10,-8365990
103470,2020-06-30,6923,Value,11540890,-8366000,10,-8365990
103470,2020-08-15,6923,Distribution,243998,-8366000,244008,-8121992
103470,2020-09-30,6923,Value,12160810,-8366000,244008,-8121992
103470,2020-11-15,6923,Capital Call,2989,-8363011,244008,-8119003
103470,2020-12-31,6923,Value,17022090,-8363011,244008,-8119003
103470,2021-04-01,6923,Capital Call,-2989,-8366000,244008,-8121992
103470,2021-04-01,6923,Distribution,15887313,-8366000,16131321,7765321
103470,2021-06-30,6923,Value,2748230,-8366000,16131321,7765321
103768,2020-02-15,168964,Capital Call,-1162768,-1798130,0,-1798130
103768,2020-03-31,168964,Value,1629120,-1798130,0,-1798130
103768,2020-05-16,168964,Capital Call,-598089,-2396219,0,-2396219
103768,2020-06-30,168964,Value,2178830,-2396219,0,-2396219
103768,2020-08-15,168964,Capital Call,-1867806,-4264025,0,-4264025
103768,2020-09-30,168964,Value,4828350,-4264025,0,-4264025
103768,2020-11-15,168964,Capital Call,-2203198,-6467223,0,-6467223
103768,2020-12-31,168964,Value,8993210,-6467223,0,-6467223
103773,2020-09-30,1357,Capital Call,-3000000,-3000000,0,-3000000
103773,2020-09-30,1357,Distribution,100000,-3000000,100000,-2900000
103773,2020-09-30,1357,Value,3692490,-3000000,100000,-2900000
103773,2020-11-15,1357,Capital Call,-2300000,-5300000,100000,-5200000
103773,2020-12-31,1357,Value,7993280,-5300000,100000,-5200000
103773,2021-02-14,1357,Capital Call,-1200000,-6500000,100000,-6400000
103773,2021-03-31,1357,Value,10901090,-6500000,100000,-6400000
103776,2020-02-15,814,Capital Call,-1047540,-1123000,0,-1123000
103776,2020-03-31,814,Value,960830,-1123000,0,-1123000
103776,2020-05-16,814,Capital Call,-622000,-1745000,0,-1745000
103776,2020-06-30,814,Value,1546070,-1745000,0,-1745000
103776,2020-08-15,814,Capital Call,30000,-1715000,0,-1715000
103776,2020-09-30,814,Value,1467690,-1715000,0,-1715000
103776,2020-11-15,814,Capital Call,-172000,-1887000,0,-1887000
103776,2020-12-31,814,Value,1895490,-1887000,0,-1887000
103776,2021-02-14,814,Capital Call,-622000,-2509000,0,-2509000
103776,2021-03-31,814,Value,2405120,-2509000,0,-2509000
103776,2021-05-16,814,Capital Call,-691000,-3200000,0,-3200000
103776,2021-05-16,814,Distribution,172160,-3200000,172160,-3027840
103776,2021-06-30,814,Value,3054400,-3200000,172160,-3027840
103776,2021-08-15,814,Capital Call,-460000,-3660000,172160,-3487840
103776,2021-08-15,814,Distribution,19258,-3660000,191418,-3468582
103776,2021-09-30,814,Value,3531160,-3660000,191418,-3468582
103842,2020-01-15,438,Capital Call,-377415,-1257346,0,-1257346
103842,2020-02-29,438,Value,1257340,-1257346,0,-1257346
103842,2020-04-15,438,Capital Call,-515843,-1773189,0,-1773189
103842,2020-05-31,438,Value,1707770,-1773189,0,-1773189
103842,2020-07-16,438,Capital Call,-35544,-1808733,0,-1808733
103842,2020-08-31,438,Value,1719180,-1808733,0,-1808733
103842,2020-10-16,438,Capital Call,-31250,-1839983,0,-1839983
103842,2020-11-30,438,Value,1717130,-1839983,0,-1839983
103842,2021-01-14,438,Capital Call,-307512,-2147495,0,-2147495
103842,2021-02-28,438,Value,2024640,-2147495,0,-2147495
103842,2021-05-31,438,Value,2192600,-2147495,0,-2147495
103842,2021-07-16,438,Capital Call,-2150521,-4298016,0,-4298016
103842,2021-07-16,438,Distribution,322467,-4298016,322467,-3975549
103842,2021-08-31,438,Value,4142000,-4298016,322467,-3975549
103842,2021-10-16,438,Capital Call,0,-4298016,322467,-3975549
103842,2021-10-16,438,Distribution,0,-4298016,322467,-3975549
103842,2021-11-30,438,Value,4117820,-4298016,322467,-3975549
103934,2020-03-31,725,Value,6208000,-10000000,0,-10000000
103934,2020-06-30,725,Value,7988000,-10000000,0,-10000000
103934,2020-09-30,725,Value,9822000,-10000000,0,-10000000
103934,2020-12-31,725,Value,11704000,-10000000,0,-10000000
103934,2021-03-31,725,Value,16328000,-10000000,0,-10000000
103934,2021-06-30,725,Value,16488000,-10000000,0,-10000000
103995,2020-03-31,13158,Value,60030,-100000,0,-100000
103995,2020-05-16,13158,Capital Call,-400000,-500000,0,-500000
103995,2020-06-30,13158,Value,423530,-500000,0,-500000
103995,2020-09-30,13158,Value,467110,-500000,0,-500000
103995,2020-11-15,13158,Capital Call,-500000,-1000000,0,-1000000
103995,2020-12-31,13158,Value,1136620,-1000000,0,-1000000
103995,2021-02-14,13158,Capital Call,-800000,-1800000,0,-1800000
103995,2021-03-31,13158,Value,2257650,-1800000,0,-1800000
104138,2020-02-15,130930,Capital Call,-450000,-626000,0,-626000
104138,2020-03-31,130930,Value,564000,-626000,0,-626000
104138,2020-05-16,130930,Capital Call,-174000,-800000,0,-800000
104138,2020-06-30,130930,Value,672000,-800000,0,-800000
104138,2020-08-15,130930,Capital Call,-76000,-876000,0,-876000
104138,2020-09-30,130930,Value,682000,-876000,0,-876000
104138,2020-11-15,130930,Capital Call,-550000,-1426000,0,-1426000
104138,2020-12-31,130930,Value,1164000,-1426000,0,-1426000
104388,2021-05-16,458,Capital Call,-1008761,-1008761,0,-1008761
104388,2021-06-30,458,Value,1004300,-1008761,0,-1008761
104388,2021-09-30,458,Value,1192920,-1008761,0,-1008761
104514,2020-06-30,123559,Capital Call,-4387744,-4387744,0,-4387744
104514,2020-06-30,123559,Distribution,20290,-4387744,20290,-4367454
104514,2020-06-30,123559,Value,4805690,-4387744,20290,-4367454
104539,2020-06-30,147,Capital Call,-539534,-539534,0,-539534
104539,2020-06-30,147,Value,687740,-539534,0,-539534
104539,2020-08-15,147,Capital Call,-709468,-1249002,0,-1249002
104539,2020-08-15,147,Distribution,648,-1249002,648,-1248354
104539,2020-09-30,147,Value,1381390,-1249002,648,-1248354
104539,2020-11-15,147,Capital Call,-749790,-1998792,648,-1998144
104539,2020-11-15,147,Distribution,250,-1998792,898,-1997894
104539,2020-12-31,147,Value,3180670,-1998792,898,-1997894
104553,2020-03-31,10551,Value,265960,-674000,0,-674000
104553,2020-05-16,10551,Capital Call,-409000,-1083000,0,-1083000
104553,2020-06-30,10551,Value,807910,-1083000,0,-1083000
104553,2020-08-15,10551,Capital Call,-1000,-1084000,0,-1084000
104553,2020-09-30,10551,Value,935490,-1084000,0,-1084000
104553,2020-11-15,10551,Capital Call,-293000,-1377000,0,-1377000
104553,2020-11-15,10551,Distribution,5508,-1377000,5508,-1371492
104553,2020-12-31,10551,Value,1134640,-1377000,5508,-1371492
104553,2021-02-14,10551,Capital Call,-193000,-1570000,5508,-1564492
104553,2021-02-14,10551,Distribution,2342,-1570000,7850,-1562150
104553,2021-03-31,10551,Value,1334500,-1570000,7850,-1562150
104553,2021-05-16,10551,Capital Call,-223000,-1793000,7850,-1785150
104553,2021-05-16,10551,Distribution,1115,-1793000,8965,-1784035
104553,2021-06-30,10551,Value,1549150,-1793000,8965,-1784035
104553,2021-08-15,10551,Capital Call,-529000,-2322000,8965,-2313035
104553,2021-08-15,10551,Distribution,323,-2322000,9288,-2312712
104553,2021-09-30,10551,Value,2233760,-2322000,9288,-2312712
104553,2021-11-15,10551,Capital Call,-627000,-2949000,9288,-2939712
104553,2021-11-15,10551,Distribution,-441,-2949000,8847,-2940153
104553,2021-12-31,10551,Value,2831040,-2949000,8847,-2940153
104559,2020-12-31,6387,Capital Call,-760000,-760000,0,-760000
104559,2020-12-31,6387,Value,729600,-760000,0,-760000
104559,2021-02-14,6387,Capital Call,-792000,-1552000,0,-1552000
104559,2021-03-31,6387,Value,1458880,-1552000,0,-1552000
104559,2021-05-16,6387,Capital Call,-648000,-2200000,0,-2200000
104559,2021-06-30,6387,Value,2486000,-2200000,0,-2200000
104559,2021-08-15,6387,Capital Call,-3000,-2203000,0,-2203000
104559,2021-09-30,6387,Value,2511420,-2203000,0,-2203000
104559,2021-11-15,6387,Capital Call,-414000,-2617000,0,-2617000
104559,2021-12-31,6387,Value,3088060,-2617000,0,-2617000
104604,2020-02-15,329241,Capital Call,-863560,-1503463,0,-1503463
104604,2020-03-31,329241,Value,1194520,-1503463,0,-1503463
104604,2020-05-16,329241,Capital Call,-1020970,-2524433,0,-2524433
104604,2020-06-30,329241,Value,2155080,-2524433,0,-2524433
104604,2020-09-30,329241,Capital Call,-489880,-3014313,0,-3014313
104604,2020-09-30,329241,Distribution,510230,-3014313,510230,-2504083
104604,2020-12-31,329241,Value,2805790,-3014313,510230,-2504083
104604,2021-02-14,329241,Capital Call,-1261620,-4275933,510230,-3765703
104604,2021-03-31,329241,Value,4033520,-4275933,510230,-3765703
104604,2021-05-16,329241,Capital Call,-400120,-4676053,510230,-4165823
104604,2021-06-30,329241,Value,5043110,-4676053,510230,-4165823
104938,2020-12-31,5177,Capital Call,-2050000,-2050000,0,-2050000
104938,2020-12-31,5177,Value,2076650,-2050000,0,-2050000
104938,2021-02-14,5177,Capital Call,-1000000,-3050000,0,-3050000
104938,2021-03-31,5177,Value,3046950,-3050000,0,-3050000
104938,2021-05-16,5177,Capital Call,-1400000,-4450000,0,-4450000
104938,2021-06-30,5177,Value,5255450,-4450000,0,-4450000
104938,2021-09-30,5177,Value,5642600,-4450000,0,-4450000
105005,2020-12-31,365,Capital Call,-573077,-573077,0,-573077
105005,2020-12-31,365,Distribution,292308,-573077,292308,-280769
105005,2020-12-31,365,Value,1096150,-573077,292308,-280769
105005,2021-02-14,365,Capital Call,-2350000,-2923077,292308,-2630769
105005,2021-03-31,365,Value,3873070,-2923077,292308,-2630769
105005,2021-05-16,365,Capital Call,-46154,-2969231,292308,-2676923
105005,2021-06-30,365,Value,5299990,-2969231,292308,-2676923
105005,2021-08-15,365,Capital Call,-1786154,-4755385,292308,-4463077
105005,2021-08-15,365,Distribution,1538,-4755385,293846,-4461539
105005,2021-09-30,365,Value,7868840,-4755385,293846,-4461539
105078,2020-06-30,332726,Capital Call,-2784000,-2784000,0,-2784000
105078,2020-06-30,332726,Distribution,445440,-2784000,445440,-2338560
105078,2020-06-30,332726,Value,2895360,-2784000,445440,-2338560
105078,2020-08-15,332726,Capital Call,-316000,-3100000,445440,-2654560
105078,2020-08-15,332726,Distribution,-42440,-3100000,403000,-2697000
105078,2020-09-30,332726,Value,3503000,-3100000,403000,-2697000
105078,2020-12-30,332726,Capital Call,-2817000,-5917000,403000,-5514000
105078,2020-12-30,332726,Distribution,1017080,-5917000,1420080,-4496920
105078,2021-03-31,332726,Value,7396250,-5917000,1420080,-4496920
105078,2021-05-16,332726,Capital Call,-1122000,-7039000,1420080,-5618920
105078,2021-05-16,332726,Distribution,1296974,-7039000,2717054,-4321946
105078,2021-06-30,332726,Value,12740590,-7039000,2717054,-4321946
105078,2021-09-30,332726,Value,8634740,-7039000,2717054,-4321946
105129,2020-03-31,12475,Capital Call,-1407884,-1407884,0,-1407884
105129,2020-03-31,12475,Value,1407880,-1407884,0,-1407884
105132,2020-12-31,600,Capital Call,-822282,-822282,0,-822282
105132,2020-12-31,600,Value,822280,-822282,0,-822282
105132,2021-03-31,600,Value,895260,-822282,0,-822282
105132,2021-05-16,600,Capital Call,-845377,-1667659,0,-1667659
105132,2021-06-30,600,Value,1887290,-1667659,0,-1667659
105132,2021-08-15,600,Capital Call,-3247499,-4915158,0,-4915158
105132,2021-09-30,600,Value,5295800,-4915158,0,-4915158
105228,2020-03-31,1886,Value,1411030,-1600000,0,-1600000
105228,2020-05-16,1886,Capital Call,-1270264,-2870264,0,-2870264
105228,2020-06-30,1886,Value,2894390,-2870264,0,-2870264
105228,2020-09-30,1886,Value,3252490,-2870264,0,-2870264
105228,2020-12-30,1886,Capital Call,34,-2870230,0,-2870230
105228,2021-03-31,1886,Value,4266800,-2870230,0,-2870230
105228,2021-05-16,1886,Capital Call,-34,-2870264,0,-2870264
105228,2021-06-30,1886,Value,4899430,-2870264,0,-2870264
105261,2020-09-30,7,Capital Call,-603738,-603738,0,-603738
105261,2020-09-30,7,Value,651050,-603738,0,-603738
105324,2020-02-15,2562,Capital Call,-499717,-1499717,0,-1499717
105324,2020-03-31,2562,Value,1394880,-1499717,0,-1499717
105324,2020-05-16,2562,Capital Call,-283,-1500000,0,-1500000
105324,2020-06-30,2562,Value,1442700,-1500000,0,-1500000
105324,2020-09-30,2562,Value,1455600,-1500000,0,-1500000
105324,2021-02-14,2562,Capital Call,-1500000,-3000000,0,-3000000
105324,2021-06-30,2562,Value,3630000,-3000000,0,-3000000
105324,2021-09-30,2562,Capital Call,-2500000,-5500000,0,-5500000
105324,2021-12-31,2562,Value,8140000,-5500000,0,-5500000
105442,2020-06-30,718,Capital Call,-1375000,-1375000,0,-1375000
105442,2020-06-30,718,Value,1352280,-1375000,0,-1375000
105442,2020-08-15,718,Capital Call,-1600000,-2975000,0,-2975000
105442,2020-09-30,718,Value,2986090,-2975000,0,-2975000
105442,2020-11-15,718,Capital Call,-1550000,-4525000,0,-4525000
105442,2020-12-31,718,Value,4546880,-4525000,0,-4525000
105442,2021-02-14,718,Capital Call,-1775000,-6300000,0,-6300000
105442,2021-03-31,718,Value,6319630,-6300000,0,-6300000
105442,2021-05-16,718,Capital Call,-1575000,-7875000,0,-7875000
105442,2021-06-30,718,Value,8345290,-7875000,0,-7875000
105469,2020-08-15,2011,Capital Call,-600000,-2200000,0,-2200000
105469,2021-03-31,2011,Value,2200000,-2200000,0,-2200000
105471,2020-07-01,58200,Distribution,3100000,-10000000,3100000,-6900000
105471,2020-12-31,58200,Value,4400000,-10000000,3100000,-6900000
105490,2020-02-15,202,Capital Call,-702167,-3592667,0,-3592667
105490,2020-02-15,202,Distribution,1303000,-3592667,1303000,-2289667
105490,2020-03-31,202,Value,2180160,-3592667,1303000,-2289667
105490,2020-05-16,202,Capital Call,-533000,-4125667,1303000,-2822667
105490,2020-06-30,202,Value,3322000,-4125667,1303000,-2822667
105490,2020-08-15,202,Capital Call,-81000,-4206667,1303000,-2903667
105490,2020-08-15,202,Distribution,239500,-4206667,1542500,-2664167
105490,2020-09-30,202,Value,3084660,-4206667,1542500,-2664167
105490,2020-12-31,202,Value,3970160,-4206667,1542500,-2664167
105490,2021-02-14,202,Capital Call,-77833,-4284500,1542500,-2742000
105490,2021-03-31,202,Value,3986000,-4284500,1542500,-2742000
105490,2021-06-30,202,Value,5118000,-4284500,1542500,-2742000
105565,2020-03-31,173553,Capital Call,-930000,-930000,0,-930000
105565,2020-05-16,173553,Capital Call,-140000,-1070000,0,-1070000
105565,2020-08-15,173553,Capital Call,-1070000,-2140000,0,-2140000
105565,2020-08-15,173553,Distribution,120000,-2140000,120000,-2020000
105565,2020-09-30,173553,Value,1810000,-2140000,120000,-2020000
105565,2020-11-15,173553,Capital Call,-1670000,-3810000,120000,-3690000
105565,2020-12-31,173553,Value,4210000,-3810000,120000,-3690000
105565,2021-02-14,173553,Capital Call,-1880000,-5690000,120000,-5570000
105565,2021-03-31,173553,Value,7580000,-5690000,120000,-5570000
105565,2021-05-16,173553,Capital Call,-870000,-6560000,120000,-6440000
105565,2021-05-16,173553,Distribution,80000,-6560000,200000,-6360000
105565,2021-06-30,173553,Value,8210000,-6560000,200000,-6360000
105565,2021-08-15,173553,Capital Call,-1289000,-7849000,200000,-7649000
105565,2021-08-15,173553,Distribution,3000,-7849000,203000,-7646000
105565,2021-09-30,173553,Value,9833000,-7849000,203000,-7646000
105596,2020-05-16,150669,Capital Call,-1000000,-3000000,0,-3000000
105596,2020-09-30,150669,Value,2659200,-3000000,0,-3000000
105596,2020-12-31,150669,Value,2580000,-3000000,0,-3000000
105596,2021-03-31,150669,Value,2550000,-3000000,0,-3000000
105596,2021-06-30,150669,Value,3270000,-3000000,0,-3000000
105684,2020-12-31,244016,Capital Call,-550000,-550000,0,-550000
105684,2020-12-31,244016,Value,478500,-550000,0,-550000
105779,2020-02-15,145994,Capital Call,-2500000,-5000000,0,-5000000
105779,2020-03-31,145994,Value,5000000,-5000000,0,-5000000
105779,2020-06-30,145994,Value,5000000,-5000000,0,-5000000
105779,2020-12-31,145994,Value,5000000,-5000000,0,-5000000
105789,2020-06-30,225545,Capital Call,-400000,-400000,0,-400000
105789,2020-06-30,225545,Value,312590,-400000,0,-400000
105789,2020-12-30,225545,Capital Call,-1400000,-1800000,0,-1800000
105789,2021-06-30,225545,Value,1524960,-1800000,0,-1800000
105840,2020-02-15,212616,Capital Call,-1000000,-1550000,0,-1550000
105840,2020-03-31,212616,Value,1550000,-1550000,0,-1550000
105840,2020-06-30,212616,Value,1404000,-1550000,0,-1550000
105840,2020-08-15,212616,Capital Call,-1250000,-2800000,0,-2800000
105840,2020-09-30,212616,Value,2584000,-2800000,0,-2800000
105840,2020-11-15,212616,Capital Call,-1150000,-3950000,0,-3950000
105840,2020-12-31,212616,Value,3943000,-3950000,0,-3950000
106018,2020-06-30,555,Capital Call,-402182,-402182,0,-402182
106018,2020-06-30,555,Value,309000,-402182,0,-402182
106018,2020-09-30,555,Value,254450,-402182,0,-402182
106018,2020-11-15,555,Capital Call,-1116455,-1518637,0,-1518637
106018,2020-12-31,555,Value,1301000,-1518637,0,-1518637
106018,2021-03-31,555,Value,1377180,-1518637,0,-1518637
106018,2021-05-16,555,Capital Call,-2509182,-4027819,0,-4027819
106018,2021-06-30,555,Value,4517000,-4027819,0,-4027819
106194,2020-03-31,431,Capital Call,-100000,-100000,0,-100000
106194,2020-03-31,431,Value,98270,-100000,0,-100000
106194,2020-06-30,431,Value,111550,-100000,0,-100000
106194,2020-09-30,431,Capital Call,-333000,-433000,0,-433000
106194,2020-12-31,431,Value,303220,-433000,0,-433000
106194,2021-03-31,431,Value,494830,-433000,0,-433000
106194,2021-05-16,431,Capital Call,-195000,-628000,0,-628000
106194,2021-06-30,431,Value,686340,-628000,0,-628000
106194,2021-08-15,431,Capital Call,-289000,-917000,0,-917000
106194,2021-09-30,431,Value,1039960,-917000,0,-917000
106194,2021-11-15,431,Capital Call,-1391000,-2308000,0,-2308000
106194,2021-12-31,431,Value,2081580,-2308000,0,-2308000
106237,2020-12-31,1357,Capital Call,-3000000,-3000000,0,-3000000
106237,2020-12-31,1357,Value,2891410,-3000000,0,-3000000
106237,2021-02-14,1357,Capital Call,-1400000,-4400000,0,-4400000
106237,2021-03-31,1357,Value,4344670,-4400000,0,-4400000
106237,2021-05-16,1357,Capital Call,-896351,-5296351,0,-5296351
106237,2021-06-30,1357,Value,6662780,-5296351,0,-5296351
106237,2021-08-15,1357,Capital Call,-700000,-5996351,0,-5996351
106237,2021-08-15,1357,Distribution,250000,-5996351,250000,-5746351
106237,2021-09-30,1357,Value,8006140,-5996351,250000,-5746351
106294,2021-03-31,171102,Capital Call,-1000000,-1000000,0,-1000000
106294,2021-03-31,171102,Value,1000000,-1000000,0,-1000000
106374,2020-03-31,1368,Value,400480,-9453716,14304414,4850698
106379,2020-12-31,352756,Capital Call,-1610667,-1610667,0,-1610667
106379,2020-12-31,352756,Value,1610660,-1610667,0,-1610667
106380,2020-03-31,1480,Capital Call,-1500000,-1500000,0,-1500000
106380,2020-03-31,1480,Value,1371000,-1500000,0,-1500000
106380,2020-06-30,1480,Value,1669500,-1500000,0,-1500000
106380,2020-09-30,1480,Capital Call,-3300000,-4800000,0,-4800000
106380,2020-12-31,1480,Value,6148800,-4800000,0,-4800000
106380,2021-02-14,1480,Capital Call,-1200000,-6000000,0,-6000000
106380,2021-03-31,1480,Value,9222000,-6000000,0,-6000000
106380,2021-07-01,1480,Capital Call,-2000000,-8000000,0,-8000000
106380,2021-09-30,1480,Value,12638400,-8000000,0,-8000000
106380,2021-11-15,1480,Capital Call,-1500000,-9500000,0,-9500000
106380,2021-11-15,1480,Distribution,17100,-9500000,17100,-9482900
106380,2021-12-31,1480,Value,18411000,-9500000,17100,-9482900
106431,2021-03-31,19665,Capital Call,-5000000,-5000000,0,-5000000
106431,2021-03-31,19665,Distribution,311520,-5000000,311520,-4688480
106431,2021-03-31,19665,Value,5526510,-5000000,311520,-4688480
106431,2021-06-30,19665,Value,5707840,-5000000,311520,-4688480
106439,2020-06-30,77220,Capital Call,-3500000,-3500000,0,-3500000
106439,2020-06-30,77220,Value,3500000,-3500000,0,-3500000
106439,2020-12-31,77220,Value,3644200,-3500000,0,-3500000
106450,2021-03-31,219123,Capital Call,-1948872,-1948872,0,-1948872
106450,2021-03-31,219123,Value,1948870,-1948872,0,-1948872
106466,2020-12-31,435,Capital Call,-924000,-924000,0,-924000
106466,2020-12-31,435,Distribution,162994,-924000,162994,-761006
106466,2020-12-31,435,Value,778000,-924000,162994,-761006
106466,2021-02-14,435,Capital Call,-1000,-925000,162994,-762006
106466,2021-02-14,435,Distribution,-101,-925000,162893,-762107
106466,2021-03-31,435,Value,929620,-925000,162893,-762107
106466,2021-05-16,435,Capital Call,-1139000,-2064000,162893,-1901107
106466,2021-05-16,435,Distribution,-43,-2064000,162850,-1901150
106466,2021-06-30,435,Value,2402900,-2064000,162850,-1901150
106466,2021-08-15,435,Capital Call,-923000,-2987000,162850,-2824150
106466,2021-08-15,435,Distribution,241,-2987000,163091,-2823909
106466,2021-09-30,435,Value,3513300,-2987000,163091,-2823909
106576,2020-06-30,10770,Capital Call,-210000,-210000,0,-210000
106576,2020-06-30,10770,Value,131400,-210000,0,-210000
106576,2020-08-15,10770,Capital Call,-180000,-390000,0,-390000
106576,2020-09-30,10770,Value,246000,-390000,0,-390000
106576,2020-11-15,10770,Capital Call,-635000,-1025000,0,-1025000
106576,2020-12-31,10770,Value,799200,-1025000,0,-1025000
106576,2021-02-14,10770,Capital Call,-1245800,-2270800,0,-2270800
106576,2021-03-31,10770,Value,2276600,-2270800,0,-2270800
106576,2021-06-30,10770,Value,2201600,-2270800,0,-2270800
106623,2020-02-15,90371,Capital Call,10000,-500000,0,-500000
106623,2020-03-31,90371,Value,326000,-500000,0,-500000
106623,2020-05-16,90371,Capital Call,-12000,-512000,0,-512000
106623,2020-06-30,90371,Value,289430,-512000,0,-512000
106623,2020-09-30,90371,Value,258300,-512000,0,-512000
106623,2020-12-31,90371,Value,262700,-512000,0,-512000
106623,2021-02-14,90371,Capital Call,-616000,-1128000,0,-1128000
106623,2021-03-31,90371,Value,863820,-1128000,0,-1128000
106623,2021-05-16,90371,Capital Call,-522000,-1650000,0,-1650000
106623,2021-06-30,90371,Value,1371150,-1650000,0,-1650000
106623,2021-08-15,90371,Capital Call,-792000,-2442000,0,-2442000
106623,2021-09-30,90371,Value,2156040,-2442000,0,-2442000
106636,2020-09-30,22035,Capital Call,-600000,-600000,0,-600000
106636,2020-09-30,22035,Value,600000,-600000,0,-600000
106637,2020-05-16,22035,Capital Call,-600000,-600000,0,-600000
106637,2020-06-30,22035,Value,600000,-600000,0,-600000
106637,2020-08-15,22035,Capital Call,-1350000,-1950000,0,-1950000
106637,2020-09-30,22035,Value,1938100,-1950000,0,-1950000
106760,2020-09-30,67055,Capital Call,-2730000,-2730000,0,-2730000
106760,2020-09-30,67055,Value,3501770,-2730000,0,-2730000
106760,2020-11-15,67055,Capital Call,220000,-2510000,0,-2510000
106760,2020-12-31,67055,Value,3714800,-2510000,0,-2510000
106922,2021-03-31,185160,Capital Call,-10000000,-10000000,0,-10000000
106922,2021-03-31,185160,Distribution,3819512,-10000000,3819512,-6180488
106922,2021-03-31,185160,Value,10098190,-10000000,3819512,-6180488
106981,2020-06-30,60789,Capital Call,-130000,-130000,0,-130000
106981,2020-06-30,60789,Value,9100,-130000,0,-130000
106981,2020-08-15,60789,Capital Call,-50000,-180000,0,-180000
106981,2020-09-30,60789,Value,5940,-180000,0,-180000
107082,2020-09-30,8787,Capital Call,-1153000,-1153000,0,-1153000
107082,2020-09-30,8787,Value,965750,-1153000,0,-1153000
107082,2020-11-15,8787,Capital Call,-645000,-1798000,0,-1798000
107082,2020-12-31,8787,Value,1486580,-1798000,0,-1798000
107082,2021-02-14,8787,Capital Call,10000,-1788000,0,-1788000
107082,2021-03-31,8787,Value,1531600,-1788000,0,-1788000
107082,2021-05-16,8787,Capital Call,-12000,-1800000,0,-1800000
107082,2021-06-30,8787,Value,1647000,-1800000,0,-1800000
107082,2021-08-15,8787,Capital Call,-1270000,-3070000,0,-3070000
107082,2021-09-30,8787,Value,3159640,-3070000,0,-3070000
107101,2020-12-31,1632,Capital Call,-1889000,-1889000,0,-1889000
107101,2020-12-31,1632,Value,1973240,-1889000,0,-1889000
107101,2021-03-31,1632,Value,2428490,-1889000,0,-1889000
107101,2021-05-16,1632,Capital Call,168,-1888832,0,-1888832
107101,2021-06-30,1632,Value,2691580,-1888832,0,-1888832
107101,2021-08-15,1632,Capital Call,-3549168,-5438000,0,-5438000
107101,2021-08-15,1632,Distribution,537818,-5438000,537818,-4900182
107101,2021-09-30,1632,Value,6023120,-5438000,537818,-4900182
107152,2020-06-30,1314,Capital Call,-301000,-301000,0,-301000
107152,2020-06-30,1314,Value,280770,-301000,0,-301000
107154,2020-03-31,1314,Capital Call,-642000,-642000,0,-642000
107154,2020-03-31,1314,Value,499090,-642000,0,-642000
107154,2020-05-16,1314,Capital Call,-1050708,-1692708,0,-1692708
107154,2020-06-30,1314,Value,651040,-1692708,0,-1692708
107154,2020-08-15,1314,Capital Call,-2493292,-4186000,0,-4186000
107154,2020-09-30,1314,Value,4517530,-4186000,0,-4186000
107154,2020-11-15,1314,Capital Call,-1105000,-5291000,0,-5291000
107154,2020-12-31,1314,Value,7761890,-5291000,0,-5291000
107161,2020-03-31,1314,Capital Call,-200006,-200006,0,-200006
107161,2020-03-31,1314,Value,236140,-200006,0,-200006
107161,2020-05-16,1314,Capital Call,-639548,-839554,0,-839554
107161,2020-06-30,1314,Value,938770,-839554,0,-839554
107161,2020-08-15,1314,Capital Call,-360446,-1200000,0,-1200000
107161,2020-09-30,1314,Value,1390440,-1200000,0,-1200000
107161,2020-11-15,1314,Capital Call,-1074000,-2274000,0,-2274000
107161,2020-12-31,1314,Value,3563350,-2274000,0,-2274000
107161,2021-02-14,1314,Capital Call,-826000,-3100000,0,-3100000
107161,2021-03-31,1314,Value,5450110,-3100000,0,-3100000
107161,2021-05-16,1314,Capital Call,-1200000,-4300000,0,-4300000
107161,2021-06-30,1314,Value,7303120,-4300000,0,-4300000
107161,2021-08-15,1314,Capital Call,-1200000,-5500000,0,-5500000
107161,2021-09-30,1314,Value,9093150,-5500000,0,-5500000
107167,2021-03-31,11324,Capital Call,-1083000,-1083000,0,-1083000
107167,2021-03-31,11324,Value,839210,-1083000,0,-1083000
107167,2021-05-16,11324,Capital Call,-1774000,-2857000,0,-2857000
107167,2021-06-30,11324,Value,2562150,-2857000,0,-2857000
107167,2021-08-15,11324,Capital Call,-1077000,-3934000,0,-3934000
107167,2021-09-30,11324,Value,3749880,-3934000,0,-3934000
107173,2020-06-30,1314,Capital Call,-200000,-200000,0,-200000
107173,2020-06-30,1314,Value,191670,-200000,0,-200000
107173,2020-09-30,1314,Value,173640,-200000,0,-200000
107173,2020-12-31,1314,Value,280060,-200000,0,-200000
107173,2021-03-31,1314,Value,401960,-200000,0,-200000
107173,2021-06-30,1314,Value,504080,-200000,0,-200000
107173,2021-08-15,1314,Capital Call,-600000,-800000,0,-800000
107173,2021-09-30,1314,Value,1148000,-800000,0,-800000
107175,2020-06-30,1314,Capital Call,-226386,-226386,0,-226386
107175,2020-06-30,1314,Value,206580,-226386,0,-226386
107175,2020-08-15,1314,Capital Call,26386,-200000,0,-200000
107175,2020-09-30,1314,Value,218980,-200000,0,-200000
107175,2020-12-31,1314,Value,551780,-200000,0,-200000
107175,2021-02-14,1314,Capital Call,12000,-188000,0,-188000
107175,2021-03-31,1314,Value,1101220,-188000,0,-188000
107175,2021-05-16,1314,Capital Call,-912000,-1100000,0,-1100000
107175,2021-06-30,1314,Value,2098030,-1100000,0,-1100000
107175,2021-08-15,1314,Capital Call,-700000,-1800000,0,-1800000
107175,2021-09-30,1314,Value,2855700,-1800000,0,-1800000
107221,2020-08-15,17603,Capital Call,-1548841,-1548841,0,-1548841
107221,2020-11-15,17603,Capital Call,259687,-1289154,0,-1289154
107221,2020-11-15,17603,Distribution,1234,-1289154,1234,-1287920
107221,2020-12-31,17603,Value,1261180,-1289154,1234,-1287920
107221,2021-03-31,17603,Value,3548510,-1289154,1234,-1287920
107221,2021-05-16,17603,Capital Call,-2353343,-3642497,1234,-3641263
107221,2021-05-16,17603,Distribution,8535,-3642497,9769,-3632728
107221,2021-06-30,17603,Value,3892330,-3642497,9769,-3632728
107289,2020-11-15,6955,Capital Call,-3402000,-9097000,0,-9097000
107289,2021-09-30,6955,Value,16285440,-9097000,0,-9097000
107401,2020-06-30,214516,Capital Call,-2200000,-2200000,0,-2200000
107401,2020-06-30,214516,Value,2200000,-2200000,0,-2200000
107464,2020-12-31,5782,Capital Call,-1931440,-1931440,0,-1931440
107464,2020-12-31,5782,Value,2033190,-1931440,0,-1931440
107541,2020-06-30,1317,Capital Call,-125342,-125342,0,-125342
107541,2020-06-30,1317,Value,125340,-125342,0,-125342
107541,2020-08-15,1317,Capital Call,-52463,-177805,0,-177805
107541,2020-09-30,1317,Value,2230,-177805,0,-177805
107541,2020-11-15,1317,Capital Call,-777202,-955007,0,-955007
107541,2020-12-31,1317,Value,719790,-955007,0,-955007
107541,2021-02-14,1317,Capital Call,-1777893,-2732900,0,-2732900
107541,2021-03-31,1317,Value,2547090,-2732900,0,-2732900
107541,2021-05-16,1317,Capital Call,-309032,-3041932,0,-3041932
107541,2021-05-16,1317,Distribution,82399,-3041932,82399,-2959533
107541,2021-06-30,1317,Value,2864440,-3041932,82399,-2959533
107571,2020-03-31,303,Capital Call,-1300000,-1300000,0,-1300000
107571,2020-03-31,303,Value,1208200,-1300000,0,-1300000
107571,2020-05-16,303,Capital Call,-190000,-1490000,0,-1490000
107571,2020-06-30,303,Value,1613070,-1490000,0,-1490000
107571,2020-08-15,303,Capital Call,-490000,-1980000,0,-1980000
107571,2020-09-30,303,Value,2265790,-1980000,0,-1980000
107571,2020-11-15,303,Capital Call,-935000,-2915000,0,-2915000
107571,2020-11-15,303,Distribution,200996,-2915000,200996,-2714004
107571,2020-12-31,303,Value,4042390,-2915000,200996,-2714004
107571,2021-02-14,303,Capital Call,-700000,-3615000,200996,-3414004
107571,2021-02-14,303,Distribution,96505,-3615000,297501,-3317499
107571,2021-03-31,303,Value,4241780,-3615000,297501,-3317499
107571,2021-05-16,303,Capital Call,-705000,-4320000,297501,-4022499
107571,2021-05-16,303,Distribution,47598,-4320000,345099,-3974901
107571,2021-06-30,303,Value,4514930,-4320000,345099,-3974901
107596,2020-06-30,2447,Capital Call,-259848,-259848,0,-259848
107596,2020-06-30,2447,Value,215670,-259848,0,-259848
107596,2020-08-15,2447,Capital Call,-152,-260000,0,-260000
107596,2020-09-30,2447,Value,118610,-260000,0,-260000
107596,2020-11-15,2447,Capital Call,-1010000,-1270000,0,-1270000
107596,2020-12-31,2447,Value,1206880,-1270000,0,-1270000
107598,2020-09-30,34987,Capital Call,-350000,-350000,0,-350000
107598,2020-09-30,34987,Value,339350,-350000,0,-350000
107598,2020-11-15,34987,Capital Call,-1070000,-1420000,0,-1420000
107598,2020-12-31,34987,Value,1984070,-1420000,0,-1420000
107598,2021-03-31,34987,Value,2031900,-1420000,0,-1420000
107655,2020-09-30,4,Capital Call,-10000000,-10000000,0,-10000000
107655,2020-09-30,4,Value,12100000,-10000000,0,-10000000
107789,2021-03-31,175596,Capital Call,-1144000,-1144000,0,-1144000
107789,2021-03-31,175596,Value,1061000,-1144000,0,-1144000
107920,2020-03-31,461,Capital Call,-300000,-300000,0,-300000
107920,2020-03-31,461,Value,299600,-300000,0,-300000
107920,2020-05-16,461,Capital Call,-300000,-600000,0,-600000
107920,2020-06-30,461,Value,583200,-600000,0,-600000
107920,2020-08-15,461,Capital Call,-800000,-1400000,0,-1400000
107920,2020-09-30,461,Value,1328000,-1400000,0,-1400000
107920,2020-11-15,461,Capital Call,-800000,-2200000,0,-2200000
107920,2020-12-31,461,Value,2165200,-2200000,0,-2200000
107920,2021-02-14,461,Capital Call,-1400000,-3600000,0,-3600000
107920,2021-03-31,461,Value,3609200,-3600000,0,-3600000
107920,2021-05-16,461,Capital Call,-1500000,-5100000,0,-5100000
107920,2021-06-30,461,Value,6122400,-5100000,0,-5100000
107921,2020-03-31,461,Capital Call,-500000,-500000,0,-500000
107921,2020-03-31,461,Value,485600,-500000,0,-500000
107921,2020-05-16,461,Capital Call,-500000,-1000000,0,-1000000
107921,2020-06-30,461,Value,923730,-1000000,0,-1000000
107921,2020-08-15,461,Capital Call,-200000,-1200000,0,-1200000
107921,2020-09-30,461,Value,1010000,-1200000,0,-1200000
107921,2020-11-15,461,Capital Call,-1000000,-2200000,0,-2200000
107921,2020-12-31,461,Value,2220000,-2200000,0,-2200000
107921,2021-02-14,461,Capital Call,-1400000,-3600000,0,-3600000
107921,2021-03-31,461,Value,3995330,-3600000,0,-3600000
107921,2021-05-16,461,Capital Call,-1000000,-4600000,0,-4600000
107921,2021-06-30,461,Value,5690660,-4600000,0,-4600000
107958,2020-06-30,13350,Capital Call,-1966605,-1966605,0,-1966605
107958,2020-06-30,13350,Distribution,200354,-1966605,200354,-1766251
107958,2020-06-30,13350,Value,2016990,-1966605,200354,-1766251
107958,2020-08-15,13350,Capital Call,-127778,-2094383,200354,-1894029
107958,2020-08-15,13350,Distribution,102399,-2094383,302753,-1791630
107958,2020-09-30,13350,Value,2153450,-2094383,302753,-1791630
107958,2020-11-15,13350,Capital Call,47619,-2046764,302753,-1744011
107958,2020-12-31,13350,Value,2057480,-2046764,302753,-1744011
107958,2021-04-01,13350,Capital Call,-254738,-2301502,302753,-1998749
107958,2021-04-01,13350,Distribution,71373,-2301502,374126,-1927376
107958,2021-06-30,13350,Value,2584830,-2301502,374126,-1927376
107962,2020-09-30,100681,Capital Call,-1130997,-1130997,0,-1130997
107962,2020-09-30,100681,Value,997890,-1130997,0,-1130997
107962,2020-11-15,100681,Capital Call,-714814,-1845811,0,-1845811
107962,2020-12-31,100681,Value,1677890,-1845811,0,-1845811
107962,2021-02-14,100681,Capital Call,-1439576,-3285387,0,-3285387
107962,2021-03-31,100681,Value,3347340,-3285387,0,-3285387
108386,2021-06-30,1718,Capital Call,-300000,-300000,0,-300000
108386,2021-06-30,1718,Value,195000,-300000,0,-300000
108386,2021-08-15,1718,Capital Call,-550000,-850000,0,-850000
108386,2021-09-30,1718,Value,688500,-850000,0,-850000
108386,2021-11-15,1718,Capital Call,-2950000,-3800000,0,-3800000
108386,2021-12-31,1718,Value,3686000,-3800000,0,-3800000
108388,2021-06-30,1718,Capital Call,-300000,-300000,0,-300000
108388,2021-06-30,1718,Value,213000,-300000,0,-300000
108388,2021-08-15,1718,Capital Call,-900000,-1200000,0,-1200000
108388,2021-09-30,1718,Value,1044000,-1200000,0,-1200000
108388,2021-12-31,1718,Value,1056000,-1200000,0,-1200000
108409,2020-12-31,120847,Capital Call,-2800008,-2800008,0,-2800008
108409,2020-12-31,120847,Value,2990300,-2800008,0,-2800008
108409,2021-02-14,120847,Capital Call,-1499992,-4300000,0,-4300000
108409,2021-03-31,120847,Value,3741000,-4300000,0,-4300000
108409,2021-06-30,120847,Value,7740000,-4300000,0,-4300000
108409,2021-08-15,120847,Capital Call,-1200000,-5500000,0,-5500000
108409,2021-09-30,120847,Value,9350000,-5500000,0,-5500000
108409,2021-11-15,120847,Capital Call,-1000000,-6500000,0,-6500000
108409,2021-12-31,120847,Value,12480000,-6500000,0,-6500000
108564,2020-08-31,200477,Capital Call,-900000,-900000,0,-900000
108564,2020-08-31,200477,Value,900000,-900000,0,-900000
108564,2020-10-16,200477,Capital Call,-600000,-1500000,0,-1500000
108564,2020-11-30,200477,Value,1295020,-1500000,0,-1500000
108564,2021-01-14,200477,Capital Call,-500000,-2000000,0,-2000000
108564,2021-02-28,200477,Value,1791090,-2000000,0,-2000000
108564,2021-04-15,200477,Capital Call,-1300000,-3300000,0,-3300000
108564,2021-05-31,200477,Value,3037670,-3300000,0,-3300000
108564,2021-08-31,200477,Capital Call,500000,-2800000,0,-2800000
108564,2021-11-30,200477,Value,2703070,-2800000,0,-2800000
108570,2020-06-30,93,Capital Call,-400000,-400000,0,-400000
108570,2020-06-30,93,Value,364700,-400000,0,-400000
108570,2020-08-15,93,Capital Call,-740000,-1140000,0,-1140000
108570,2020-09-30,93,Value,1049120,-1140000,0,-1140000
108570,2020-11-15,93,Capital Call,-1500000,-2640000,0,-2640000
108570,2020-12-31,93,Value,2633980,-2640000,0,-2640000
108570,2021-02-14,93,Capital Call,-1360000,-4000000,0,-4000000
108570,2021-03-31,93,Value,4160010,-4000000,0,-4000000
108570,2021-05-16,93,Capital Call,-375000,-4375000,0,-4375000
108570,2021-06-30,93,Value,4699590,-4375000,0,-4375000
108685,2020-11-30,664,Capital Call,-874896,-874896,0,-874896
108685,2020-11-30,664,Value,807220,-874896,0,-874896
108685,2021-01-14,664,Capital Call,-612427,-1487323,0,-1487323
108685,2021-02-28,664,Value,1354760,-1487323,0,-1487323
108685,2021-04-15,664,Capital Call,-437448,-1924771,0,-1924771
108685,2021-05-31,664,Value,1765700,-1924771,0,-1924771
108685,2021-07-16,664,Capital Call,-699917,-2624688,0,-2624688
108685,2021-08-31,664,Value,3048850,-2624688,0,-2624688
108685,2021-10-16,664,Capital Call,-1650312,-4275000,0,-4275000
108685,2021-11-30,664,Value,4640900,-4275000,0,-4275000
109150,2021-02-28,171187,Capital Call,-2530000,-2530000,0,-2530000
109150,2021-02-28,171187,Value,2323470,-2530000,0,-2530000
109150,2021-04-15,171187,Capital Call,-2170000,-4700000,0,-4700000
109150,2021-05-31,171187,Value,4954910,-4700000,0,-4700000
109150,2021-07-16,171187,Capital Call,-600000,-5300000,0,-5300000
109150,2021-08-31,171187,Value,6553740,-5300000,0,-5300000
109150,2021-10-16,171187,Capital Call,-570000,-5870000,0,-5870000
109150,2021-11-30,171187,Value,7072900,-5870000,0,-5870000
109179,2020-06-30,171187,Capital Call,-2700000,-2700000,0,-2700000
109179,2020-06-30,171187,Value,2684510,-2700000,0,-2700000
109179,2020-09-30,171187,Value,3685770,-2700000,0,-2700000
109179,2020-12-31,171187,Value,3676180,-2700000,0,-2700000
109179,2021-02-14,171187,Capital Call,-4015000,-6715000,0,-6715000
109179,2021-03-31,171187,Value,10080260,-6715000,0,-6715000
109179,2021-05-16,171187,Capital Call,-675000,-7390000,0,-7390000
109179,2021-06-30,171187,Value,12487680,-7390000,0,-7390000
109179,2021-09-30,171187,Value,15061920,-7390000,0,-7390000
109193,2021-05-16,14052,Capital Call,-272828,-272828,0,-272828
109193,2021-06-30,14052,Value,272820,-272828,0,-272828
109316,2020-06-30,22036,Capital Call,-191086,-191086,0,-191086
109316,2020-06-30,22036,Value,164400,-191086,0,-191086
109316,2020-08-15,22036,Capital Call,-495907,-686993,0,-686993
109316,2020-09-30,22036,Value,606470,-686993,0,-686993
109316,2020-12-31,22036,Value,574630,-686993,0,-686993
109316,2021-03-31,22036,Value,508200,-686993,0,-686993
109335,2020-09-30,118,Capital Call,-181403,-181403,0,-181403
109335,2020-09-30,118,Value,74780,-181403,0,-181403
109335,2020-12-31,118,Value,28620,-181403,0,-181403
109355,2020-06-30,353515,Capital Call,-107773,-107773,0,-107773
109355,2020-08-15,353515,Capital Call,-59706,-167479,0,-167479
109355,2020-11-15,353515,Capital Call,-866270,-1033749,0,-1033749
109355,2020-12-31,353515,Value,988790,-1033749,0,-1033749
109355,2021-02-14,353515,Capital Call,-700933,-1734682,0,-1734682
109355,2021-03-31,353515,Value,1693130,-1734682,0,-1734682
109363,2020-06-30,22036,Capital Call,-100000,-100000,0,-100000
109363,2020-06-30,22036,Value,100000,-100000,0,-100000
109365,2020-03-31,339421,Value,1970200,-2000000,0,-2000000
109365,2020-05-16,339421,Capital Call,-2000000,-4000000,0,-4000000
109365,2020-06-30,339421,Value,3897200,-4000000,0,-4000000
109365,2020-09-30,339421,Value,3864000,-4000000,0,-4000000
109365,2020-12-31,339421,Value,4001600,-4000000,0,-4000000
109365,2021-03-31,339421,Value,4070800,-4000000,0,-4000000
109365,2021-06-30,339421,Value,4106400,-4000000,0,-4000000
109365,2021-09-30,339421,Value,4253200,-4000000,0,-4000000
109365,2021-12-31,339421,Value,4359200,-4000000,0,-4000000
109449,2021-03-31,148770,Capital Call,-1800000,-1800000,0,-1800000
109449,2021-03-31,148770,Value,1560000,-1800000,0,-1800000
109468,2020-06-30,93,Capital Call,-100000,-100000,0,-100000
109468,2020-06-30,93,Value,91650,-100000,0,-100000
109468,2020-08-15,93,Capital Call,-616000,-716000,0,-716000
109468,2020-09-30,93,Value,698770,-716000,0,-716000
109468,2020-11-15,93,Capital Call,-2288000,-3004000,0,-3004000
109468,2020-12-31,93,Value,3185400,-3004000,0,-3004000
109468,2021-02-14,93,Capital Call,-1240000,-4244000,0,-4244000
109468,2021-03-31,93,Value,4425030,-4244000,0,-4244000
109468,2021-05-16,93,Capital Call,-790000,-5034000,0,-5034000
109468,2021-06-30,93,Value,5279700,-5034000,0,-5034000
109584,2020-02-15,54,Distribution,137032,-8322467,137032,-8185435
109584,2020-03-31,54,Value,8684930,-8322467,137032,-8185435
109584,2020-05-16,54,Capital Call,-17682,-8340149,137032,-8203117
109584,2020-06-30,54,Value,8295940,-8340149,137032,-8203117
109584,2020-08-15,54,Capital Call,-18787,-8358936,137032,-8221904
109584,2020-09-30,54,Value,8362240,-8358936,137032,-8221904
109584,2020-11-15,54,Capital Call,-19892,-8378828,137032,-8241796
109584,2020-12-31,54,Value,7887050,-8378828,137032,-8241796
109711,2020-09-30,189709,Capital Call,-125647,-125647,0,-125647
109711,2020-09-30,189709,Value,51480,-125647,0,-125647
109711,2020-11-15,189709,Capital Call,-1305277,-1430924,0,-1430924
109711,2020-12-31,189709,Value,1285470,-1430924,0,-1430924
109711,2021-02-14,189709,Capital Call,-70795,-1501719,0,-1501719
109711,2021-03-31,189709,Value,1347450,-1501719,0,-1501719
109791,2020-12-31,191840,Capital Call,-3470000,-3470000,0,-3470000
109791,2020-12-31,191840,Value,1204090,-3470000,0,-3470000
109821,2021-06-30,18,Capital Call,-500000,-500000,0,-500000
109821,2021-06-30,18,Value,1067090,-500000,0,-500000
109821,2021-08-15,18,Capital Call,-500000,-1000000,0,-1000000
109821,2021-09-30,18,Value,1741800,-1000000,0,-1000000
110033,2020-06-30,2165,Value,8722000,-8900000,0,-8900000
110033,2021-02-14,2165,Capital Call,-755000,-9655000,0,-9655000
110033,2021-02-14,2165,Distribution,978051,-9655000,978051,-8676949
110033,2021-09-30,2165,Value,11572480,-9655000,978051,-8676949
110033,2021-11-15,2165,Distribution,1071705,-9655000,2049756,-7605244
110033,2021-12-31,2165,Value,10137750,-9655000,2049756,-7605244
110104,2021-03-31,367,Capital Call,-238576,-238576,0,-238576
110104,2021-03-31,367,Value,9680,-238576,0,-238576
110121,2020-12-31,182138,Capital Call,-700000,-700000,0,-700000
110121,2020-12-31,182138,Value,625000,-700000,0,-700000
110153,2020-12-31,355675,Capital Call,-4250000,-4250000,0,-4250000
110153,2020-12-31,355675,Value,5185000,-4250000,0,-4250000
110153,2021-02-14,355675,Capital Call,-750000,-5000000,0,-5000000
110153,2021-03-31,355675,Value,5911000,-5000000,0,-5000000
110153,2021-07-01,355675,Capital Call,-2500000,-7500000,0,-7500000
110153,2021-09-30,355675,Value,8866500,-7500000,0,-7500000
110310,2020-06-30,558,Capital Call,-762812,-762812,0,-762812
110310,2020-06-30,558,Value,801070,-762812,0,-762812
110310,2020-08-15,558,Capital Call,-127188,-890000,0,-890000
110310,2020-09-30,558,Value,815560,-890000,0,-890000
110310,2020-11-15,558,Capital Call,-1450000,-2340000,0,-2340000
110310,2020-11-15,558,Distribution,9206,-2340000,9206,-2330794
110310,2020-12-31,558,Value,2517540,-2340000,9206,-2330794
110310,2021-03-31,558,Value,2483610,-2340000,9206,-2330794
110310,2021-05-16,558,Capital Call,-1156936,-3496936,9206,-3487730
110310,2021-05-16,558,Distribution,0,-3496936,9206,-3487730
110310,2021-06-30,558,Value,4562240,-3496936,9206,-3487730
110317,2020-03-31,361,Capital Call,-9768056,-9768056,0,-9768056
110317,2020-03-31,361,Value,8609800,-9768056,0,-9768056
110317,2020-06-30,361,Value,9578680,-9768056,0,-9768056
110317,2020-09-30,361,Value,10531410,-9768056,0,-9768056
110317,2020-12-31,361,Value,11335870,-9768056,0,-9768056
110317,2021-02-14,361,Distribution,907223,-9768056,907223,-8860833
110317,2021-03-31,361,Value,11140630,-9768056,907223,-8860833
110546,2020-06-30,9052,Capital Call,-1172000,-1172000,0,-1172000
110546,2020-06-30,9052,Value,1172000,-1172000,0,-1172000
110546,2020-09-30,9052,Value,1119000,-1172000,0,-1172000
110546,2020-11-15,9052,Capital Call,-1065000,-2237000,0,-2237000
110546,2020-11-15,9052,Distribution,3000,-2237000,3000,-2234000
110546,2020-12-31,9052,Value,2020000,-2237000,3000,-2234000
110747,2020-02-15,504,Capital Call,-446148,-1140011,0,-1140011
110747,2020-03-31,504,Value,1134260,-1140011,0,-1140011
110747,2020-05-16,504,Capital Call,-602303,-1742314,0,-1742314
110747,2020-05-16,504,Distribution,544045,-1742314,544045,-1198269
110747,2020-06-30,504,Value,1129180,-1742314,544045,-1198269
110747,2020-08-15,504,Capital Call,-1387671,-3129985,544045,-2585940
110747,2020-08-15,504,Distribution,38822,-3129985,582867,-2547118
110747,2020-09-30,504,Value,2617330,-3129985,582867,-2547118
110747,2020-11-15,504,Capital Call,-967981,-4097966,582867,-3515099
110747,2020-11-15,504,Distribution,16388,-4097966,599255,-3498711
110747,2020-12-31,504,Value,3697160,-4097966,599255,-3498711
110747,2021-02-14,504,Capital Call,-133489,-4231455,599255,-3632200
110747,2021-02-14,504,Distribution,960939,-4231455,1560194,-2671261
110747,2021-03-31,504,Value,4720290,-4231455,1560194,-2671261
110747,2021-05-16,504,Capital Call,-185973,-4417428,1560194,-2857234
110747,2021-05-16,504,Distribution,-900000,-4417428,660194,-3757234
110747,2021-06-30,504,Value,5546240,-4417428,660194,-3757234
111095,2021-12-31,459,Capital Call,-2300000,-2300000,0,-2300000
111095,2021-12-31,459,Value,3483580,-2300000,0,-2300000
111694,2020-09-30,10869,Capital Call,-500000,-500000,0,-500000
111694,2020-09-30,10869,Value,437080,-500000,0,-500000
111694,2020-11-15,10869,Capital Call,-700000,-1200000,0,-1200000
111694,2020-12-31,10869,Value,1082390,-1200000,0,-1200000
111694,2021-02-14,10869,Capital Call,-1000000,-2200000,0,-2200000
111694,2021-03-31,10869,Value,2113410,-2200000,0,-2200000
111694,2021-05-16,10869,Capital Call,-2200000,-4400000,0,-4400000
111694,2021-06-30,10869,Value,4680540,-4400000,0,-4400000
111696,2020-06-30,906,Capital Call,-2150000,-2150000,0,-2150000
111696,2020-06-30,906,Value,2134110,-2150000,0,-2150000
111696,2020-08-15,906,Capital Call,-600000,-2750000,0,-2750000
111696,2020-09-30,906,Value,2762620,-2750000,0,-2750000
111696,2020-11-15,906,Capital Call,-200000,-2950000,0,-2950000
111696,2020-12-31,906,Value,4625670,-2950000,0,-2950000
112067,2020-03-31,8980,Value,16922800,-10000000,0,-10000000
112067,2020-06-30,8980,Value,22000000,-10000000,0,-10000000
112067,2020-08-15,8980,Distribution,54534,-10000000,54534,-9945466
112067,2020-09-30,8980,Value,24505060,-10000000,54534,-9945466
112067,2020-12-31,8980,Value,23440460,-10000000,54534,-9945466
112067,2021-02-14,8980,Distribution,466,-10000000,55000,-9945000
112067,2021-03-31,8980,Value,23033000,-10000000,55000,-9945000
112067,2021-05-16,8980,Distribution,-466,-10000000,54534,-9945466
112067,2021-06-30,8980,Value,19765650,-10000000,54534,-9945466
112067,2021-08-15,8980,Distribution,152466,-10000000,207000,-9793000
112067,2021-09-30,8980,Value,18510000,-10000000,207000,-9793000
112238,2020-09-30,690,Capital Call,-600000,-600000,0,-600000
112238,2020-09-30,690,Value,579800,-600000,0,-600000
112238,2021-03-31,690,Value,507000,-600000,0,-600000
112238,2021-05-16,690,Capital Call,-900000,-1500000,0,-1500000
112238,2021-06-30,690,Value,1363400,-1500000,0,-1500000
112291,2020-02-15,211,Capital Call,-1027346,-5203940,15742,-5188198
112291,2020-02-15,211,Distribution,5074,-5203940,20816,-5183124
112291,2020-03-31,211,Value,5018500,-5203940,20816,-5183124
112291,2020-05-16,211,Capital Call,1483256,-3720684,20816,-3699868
112291,2020-05-16,211,Distribution,74994,-3720684,95810,-3624874
112291,2020-06-30,211,Value,4210290,-3720684,95810,-3624874
112291,2020-09-30,211,Capital Call,-1670517,-5391201,95810,-5295391
112291,2020-09-30,211,Distribution,19822,-5391201,115632,-5275569
112291,2020-12-31,211,Value,6966360,-5391201,115632,-5275569
112291,2021-02-14,211,Distribution,0,-5391201,115632,-5275569
112291,2021-03-31,211,Value,7572960,-5391201,115632,-5275569
112291,2021-05-16,211,Capital Call,-1513006,-6904207,115632,-6788575
112291,2021-05-16,211,Distribution,422109,-6904207,537741,-6366466
112291,2021-06-30,211,Value,9888590,-6904207,537741,-6366466
112390,2020-03-31,269861,Capital Call,-5300000,-5300000,0,-5300000
112390,2020-03-31,269861,Value,7102000,-5300000,0,-5300000
112390,2021-03-31,269861,Value,10229000,-5300000,0,-5300000
112422,2020-09-30,302,Capital Call,-600000,-600000,0,-600000
112422,2020-09-30,302,Value,578370,-600000,0,-600000
112422,2020-12-31,302,Value,531340,-600000,0,-600000
112422,2021-03-31,302,Value,519180,-600000,0,-600000
112422,2021-05-16,302,Capital Call,21622,-578378,0,-578378
112422,2021-06-30,302,Value,490650,-578378,0,-578378
112453,2020-12-31,225138,Capital Call,-5000000,-5000000,0,-5000000
112453,2020-12-31,225138,Value,6950000,-5000000,0,-5000000
112453,2021-04-01,225138,Capital Call,-300000,-5300000,0,-5300000
112453,2021-06-30,225138,Value,9350000,-5300000,0,-5300000
112453,2021-08-15,225138,Capital Call,-630000,-5930000,0,-5930000
112453,2021-09-30,225138,Value,12215800,-5930000,0,-5930000
112509,2020-03-31,5411,Value,3218130,-4110000,20550,-4089450
112509,2020-05-16,5411,Capital Call,-400000,-4510000,20550,-4489450
112509,2020-05-16,5411,Distribution,-2510,-4510000,18040,-4491960
112509,2020-06-30,5411,Value,3608000,-4510000,18040,-4491960
112509,2020-09-30,5411,Value,3914680,-4510000,18040,-4491960
112509,2020-11-15,5411,Capital Call,-1050000,-5560000,18040,-5541960
112509,2020-11-15,5411,Distribution,4200,-5560000,22240,-5537760
112509,2020-12-31,5411,Value,5031800,-5560000,22240,-5537760
112509,2021-02-14,5411,Capital Call,-730000,-6290000,22240,-6267760
112509,2021-02-14,5411,Distribution,-3370,-6290000,18870,-6271130
112509,2021-03-31,5411,Value,6132750,-6290000,18870,-6271130
112509,2021-05-16,5411,Capital Call,-1550000,-7840000,18870,-7821130
112509,2021-05-16,5411,Distribution,4650,-7840000,23520,-7816480
112509,2021-06-30,5411,Value,8263360,-7840000,23520,-7816480
112509,2021-09-30,5411,Value,7996800,-7840000,23520,-7816480
112510,2020-03-31,5296,Capital Call,-4000,-44000,0,-44000
112510,2020-06-30,5296,Value,22000,-44000,0,-44000
112510,2020-08-15,5296,Capital Call,-436000,-480000,0,-480000
112510,2020-09-30,5296,Value,384000,-480000,0,-480000
112510,2020-12-31,5296,Value,768000,-480000,0,-480000
112510,2021-02-14,5296,Capital Call,-560000,-1040000,0,-1040000
112510,2021-03-31,5296,Value,1248000,-1040000,0,-1040000
112510,2021-05-16,5296,Capital Call,-1050000,-2090000,0,-2090000
112510,2021-06-30,5296,Value,2926000,-2090000,0,-2090000
112510,2021-08-15,5296,Capital Call,-230000,-2320000,0,-2320000
112510,2021-09-30,5296,Value,3248000,-2320000,0,-2320000
112523,2020-06-30,63520,Value,1000000,-1000000,0,-1000000
112525,2020-03-31,63520,Capital Call,-67301,-10000000,0,-10000000
112525,2020-06-30,63520,Value,10000000,-10000000,0,-10000000
112527,2020-06-30,63520,Value,10000000,-10000000,0,-10000000
112541,2020-06-30,63520,Value,11500000,-11500000,0,-11500000
112542,2020-03-31,63520,Capital Call,-119,-10002119,0,-10002119
112542,2020-06-30,63520,Value,10002110,-10002119,0,-10002119
112543,2020-03-31,63520,Capital Call,-331,-8760331,0,-8760331
112543,2020-06-30,63520,Value,8760330,-8760331,0,-8760331
112578,2020-02-15,496,Capital Call,-898239,-2598239,0,-2598239
112578,2020-03-31,496,Value,2637750,-2598239,0,-2598239
112578,2020-06-30,496,Value,2675280,-2598239,0,-2598239
112578,2020-08-15,496,Capital Call,-600000,-3198239,0,-3198239
112578,2020-09-30,496,Value,3534690,-3198239,0,-3198239
112578,2020-11-15,496,Capital Call,-1357675,-4555914,0,-4555914
112578,2020-12-31,496,Value,5124050,-4555914,0,-4555914
112743,2021-05-31,66301,Capital Call,-1509621,-1509621,0,-1509621
112743,2021-05-31,66301,Distribution,95416,-1509621,95416,-1414205
112743,2021-05-31,66301,Value,1475480,-1509621,95416,-1414205
112743,2021-07-16,66301,Capital Call,-1583655,-3093276,95416,-2997860
112743,2021-07-16,66301,Distribution,691,-3093276,96107,-2997169
112743,2021-08-31,66301,Value,3546550,-3093276,96107,-2997169
112743,2021-10-16,66301,Capital Call,0,-3093276,96107,-2997169
112743,2021-10-16,66301,Distribution,0,-3093276,96107,-2997169
112743,2021-11-30,66301,Value,3387540,-3093276,96107,-2997169
113022,2020-03-31,8661,Capital Call,-1450000,-1450000,0,-1450000
113022,2020-03-31,8661,Value,1369380,-1450000,0,-1450000
113022,2020-06-30,8661,Value,1528730,-1450000,0,-1450000
113022,2020-08-15,8661,Capital Call,-1300000,-2750000,0,-2750000
113022,2020-09-30,8661,Value,2872920,-2750000,0,-2750000
113022,2020-11-15,8661,Capital Call,-275000,-3025000,0,-3025000
113022,2020-12-31,8661,Value,3556790,-3025000,0,-3025000
113022,2021-04-01,8661,Capital Call,-1674000,-4699000,0,-4699000
113022,2021-06-30,8661,Value,6250130,-4699000,0,-4699000
113022,2021-08-15,8661,Capital Call,-710520,-5409520,0,-5409520
113022,2021-09-30,8661,Value,7064830,-5409520,0,-5409520
113022,2021-11-15,8661,Capital Call,-727480,-6137000,0,-6137000
113022,2021-12-31,8661,Value,9120190,-6137000,0,-6137000
113077,2020-12-31,77,Capital Call,-466378,-466378,0,-466378
113077,2020-12-31,77,Value,468240,-466378,0,-466378
113077,2021-02-14,77,Capital Call,0,-466378,0,-466378
113077,2021-03-31,77,Value,467280,-466378,0,-466378
113077,2021-05-16,77,Capital Call,0,-466378,0,-466378
113077,2021-06-30,77,Value,632050,-466378,0,-466378
113077,2021-08-15,77,Capital Call,-1186527,-1652905,0,-1652905
113077,2021-09-30,77,Value,1936870,-1652905,0,-1652905
113080,2020-12-31,18,Capital Call,-200000,-200000,0,-200000
113080,2020-12-31,18,Value,531090,-200000,0,-200000
113080,2021-03-31,18,Value,781120,-200000,0,-200000
113080,2021-05-16,18,Capital Call,-342992,-542992,0,-542992
113080,2021-06-30,18,Value,1561140,-542992,0,-542992
113080,2021-08-15,18,Capital Call,-700008,-1243000,0,-1243000
113080,2021-08-15,18,Distribution,194157,-1243000,194157,-1048843
113080,2021-09-30,18,Value,2316700,-1243000,194157,-1048843
113081,2021-03-31,18,Capital Call,-200000,-200000,0,-200000
113081,2021-03-31,18,Value,783630,-200000,0,-200000
113081,2021-05-16,18,Capital Call,-300000,-500000,0,-500000
113081,2021-06-30,18,Value,1543920,-500000,0,-500000
113081,2021-08-15,18,Capital Call,-699997,-1199997,0,-1199997
113081,2021-08-15,18,Distribution,199999,-1199997,199999,-999998
113081,2021-09-30,18,Value,2360200,-1199997,199999,-999998
113082,2021-03-31,18,Capital Call,-200000,-200000,0,-200000
113082,2021-03-31,18,Value,732510,-200000,0,-200000
113082,2021-05-16,18,Capital Call,-149993,-349993,0,-349993
113082,2021-06-30,18,Value,1136520,-349993,0,-349993
113082,2021-08-15,18,Capital Call,-600007,-950000,0,-950000
113082,2021-08-15,18,Distribution,300010,-950000,300010,-649990
113082,2021-09-30,18,Value,1644070,-950000,300010,-649990
113083,2020-12-31,18,Capital Call,-200000,-200000,0,-200000
113083,2020-12-31,18,Value,544650,-200000,0,-200000
113084,2021-06-30,18,Capital Call,-1000000,-1000000,0,-1000000
113084,2021-06-30,18,Value,3617290,-1000000,0,-1000000
113084,2021-08-15,18,Capital Call,-2955000,-3955000,0,-3955000
113084,2021-09-30,18,Value,6979780,-3955000,0,-3955000
113203,2020-06-30,145015,Capital Call,-580000,-580000,0,-580000
113203,2020-06-30,145015,Value,580000,-580000,0,-580000
113203,2020-08-15,145015,Capital Call,-670000,-1250000,0,-1250000
113203,2020-09-30,145015,Value,1254000,-1250000,0,-1250000
113203,2020-11-15,145015,Capital Call,-380000,-1630000,0,-1630000
113203,2020-12-31,145015,Value,1628000,-1630000,0,-1630000
113398,2020-11-15,1314,Capital Call,-199000,-199000,0,-199000
113398,2020-12-31,1314,Value,525430,-199000,0,-199000
113398,2021-02-14,1314,Capital Call,-1020,-200020,0,-200020
113398,2021-03-31,1314,Value,917400,-200020,0,-200020
113398,2021-05-16,1314,Capital Call,23020,-177000,0,-177000
113398,2021-06-30,1314,Value,802460,-177000,0,-177000
113398,2021-08-15,1314,Capital Call,-610000,-787000,0,-787000
113398,2021-09-30,1314,Value,1804820,-787000,0,-787000
113451,2020-12-31,376907,Capital Call,-150000,-150000,0,-150000
113451,2020-12-31,376907,Value,150000,-150000,0,-150000
113451,2021-02-14,376907,Capital Call,-400000,-550000,0,-550000
113451,2021-03-31,376907,Value,550000,-550000,0,-550000
113451,2021-06-30,376907,Value,550000,-550000,0,-550000
113570,2021-03-31,1357,Capital Call,-1300000,-1300000,0,-1300000
113570,2021-03-31,1357,Value,1404790,-1300000,0,-1300000
113570,2021-05-16,1357,Capital Call,-500000,-1800000,0,-1800000
113570,2021-06-30,1357,Value,2322970,-1800000,0,-1800000
113659,2020-06-30,93335,Capital Call,-333333,-333333,0,-333333
113659,2020-06-30,93335,Value,328660,-333333,0,-333333
113659,2020-08-15,93335,Capital Call,-166667,-500000,0,-500000
113659,2020-09-30,93335,Value,435110,-500000,0,-500000
113659,2020-12-31,93335,Value,383330,-500000,0,-500000
113659,2021-02-14,93335,Capital Call,-300000,-800000,0,-800000
113659,2021-03-31,93335,Value,630220,-800000,0,-800000
113659,2021-05-16,93335,Capital Call,-450000,-1250000,0,-1250000
113659,2021-06-30,93335,Value,1029330,-1250000,0,-1250000
113741,2021-03-31,466,Capital Call,-1200000,-1200000,0,-1200000
113741,2021-03-31,466,Value,1200000,-1200000,0,-1200000
113750,2020-02-15,164017,Capital Call,-884701,-4286006,0,-4286006
113750,2020-03-31,164017,Value,4193210,-4286006,0,-4286006
113750,2020-05-16,164017,Capital Call,-1060534,-5346540,0,-5346540
113750,2020-06-30,164017,Value,5986000,-5346540,0,-5346540
113750,2020-08-15,164017,Capital Call,-1992224,-7338764,0,-7338764
113750,2020-09-30,164017,Value,10637760,-7338764,0,-7338764
113750,2020-11-15,164017,Capital Call,-1353488,-8692252,0,-8692252
113750,2020-12-31,164017,Value,16286210,-8692252,0,-8692252
113750,2021-02-14,164017,Capital Call,-816624,-9508876,0,-9508876
113750,2021-02-14,164017,Distribution,1729748,-9508876,1729748,-7779128
113750,2021-03-31,164017,Value,19009160,-9508876,1729748,-7779128
113750,2021-05-16,164017,Capital Call,-184580,-9693456,1729748,-7963708
113750,2021-06-30,164017,Value,23922700,-9693456,1729748,-7963708
113750,2021-08-15,164017,Capital Call,-537221,-10230677,1729748,-8500929
113750,2021-08-15,164017,Distribution,1594239,-10230677,3323987,-6906690
113750,2021-09-30,164017,Value,24678200,-10230677,3323987,-6906690
113750,2021-11-15,164017,Capital Call,-310127,-10540804,3323987,-7216817
113750,2021-11-15,164017,Distribution,1355187,-10540804,4679174,-5861630
113750,2021-12-31,164017,Value,22850560,-10540804,4679174,-5861630
113765,2020-06-30,906,Capital Call,-1332609,-1332609,0,-1332609
113765,2020-06-30,906,Value,1264120,-1332609,0,-1332609
113765,2020-08-15,906,Capital Call,-917391,-2250000,0,-2250000
113765,2020-09-30,906,Value,2089350,-2250000,0,-2250000
113765,2020-11-15,906,Capital Call,-2000000,-4250000,0,-4250000
113765,2020-12-31,906,Value,4108470,-4250000,0,-4250000
113765,2021-02-14,906,Capital Call,-1900000,-6150000,0,-6150000
113765,2021-03-31,906,Value,6676440,-6150000,0,-6150000
113766,2020-06-30,906,Capital Call,-510000,-510000,0,-510000
113766,2020-06-30,906,Value,454730,-510000,0,-510000
113766,2020-08-15,906,Capital Call,-1640000,-2150000,0,-2150000
113766,2020-09-30,906,Value,2091760,-2150000,0,-2150000
113766,2020-11-15,906,Capital Call,-2850000,-5000000,0,-5000000
113766,2020-12-31,906,Value,6839740,-5000000,0,-5000000
113766,2021-02-14,906,Capital Call,-2000000,-7000000,0,-7000000
113766,2021-03-31,906,Value,12947860,-7000000,0,-7000000
113821,2021-09-30,6734,Capital Call,-500000,-500000,0,-500000
113821,2021-09-30,6734,Value,438650,-500000,0,-500000
113821,2021-11-15,6734,Capital Call,-1960000,-2460000,0,-2460000
113821,2021-12-31,6734,Value,2167500,-2460000,0,-2460000
113840,2020-11-30,9022,Capital Call,-300000,-300000,0,-300000
113840,2020-11-30,9022,Value,222780,-300000,0,-300000
113840,2021-01-14,9022,Capital Call,-1500000,-1800000,0,-1800000
113840,2021-02-28,9022,Value,1722780,-1800000,0,-1800000
113840,2021-04-15,9022,Capital Call,-1600000,-3400000,0,-3400000
113840,2021-05-31,9022,Value,3506650,-3400000,0,-3400000
113840,2021-07-16,9022,Capital Call,-500000,-3900000,0,-3900000
113840,2021-08-31,9022,Value,3670670,-3900000,0,-3900000
113840,2021-11-30,9022,Value,3896120,-3900000,0,-3900000
113842,2020-08-31,9022,Capital Call,-800000,-800000,0,-800000
113842,2020-08-31,9022,Value,800000,-800000,0,-800000
113842,2020-10-16,9022,Capital Call,-1800000,-2600000,0,-2600000
113842,2020-11-30,9022,Value,2545870,-2600000,0,-2600000
113842,2021-01-14,9022,Capital Call,-1100000,-3700000,0,-3700000
113842,2021-02-28,9022,Value,3645870,-3700000,0,-3700000
113842,2021-04-15,9022,Capital Call,-1200000,-4900000,0,-4900000
113842,2021-05-31,9022,Value,4865720,-4900000,0,-4900000
113842,2021-07-16,9022,Capital Call,-1600000,-6500000,0,-6500000
113842,2021-08-31,9022,Value,6449830,-6500000,0,-6500000
113842,2021-10-16,9022,Capital Call,-1500000,-8000000,0,-8000000
113842,2021-11-30,9022,Value,7886200,-8000000,0,-8000000
113891,2020-12-31,9816,Capital Call,-127109,-127109,0,-127109
113891,2020-12-31,9816,Value,76280,-127109,0,-127109
113891,2021-03-31,9816,Value,72030,-127109,0,-127109
113891,2021-06-30,9816,Value,17220,-127109,0,-127109
113893,2020-09-30,24,Capital Call,-300000,-300000,0,-300000
113893,2020-09-30,24,Value,226980,-300000,0,-300000
113893,2020-11-15,24,Capital Call,-76000,-376000,0,-376000
113893,2020-12-31,24,Value,317110,-376000,0,-376000
113893,2021-02-14,24,Capital Call,-124000,-500000,0,-500000
113893,2021-03-31,24,Value,499850,-500000,0,-500000
113893,2021-05-16,24,Capital Call,-601000,-1101000,0,-1101000
113893,2021-06-30,24,Value,1129290,-1101000,0,-1101000
113893,2021-08-15,24,Capital Call,-1275000,-2376000,0,-2376000
113893,2021-09-30,24,Value,2656130,-2376000,0,-2376000
113940,2020-06-30,231010,Capital Call,-720000,-720000,0,-720000
113940,2020-06-30,231010,Value,653760,-720000,0,-720000
113940,2020-08-15,231010,Capital Call,-810000,-1530000,0,-1530000
113940,2020-09-30,231010,Value,1352520,-1530000,0,-1530000
113940,2020-11-15,231010,Capital Call,-760000,-2290000,0,-2290000
113940,2020-12-31,231010,Value,2012910,-2290000,0,-2290000
113940,2021-02-14,231010,Capital Call,-600000,-2890000,0,-2890000
113940,2021-03-31,231010,Value,2601000,-2890000,0,-2890000
113940,2021-05-16,231010,Capital Call,-1120000,-4010000,0,-4010000
113940,2021-06-30,231010,Value,4451100,-4010000,0,-4010000
113940,2021-08-15,231010,Capital Call,-790000,-4800000,0,-4800000
113940,2021-09-30,231010,Value,4416000,-4800000,0,-4800000
113941,2020-12-31,68285,Capital Call,-5226667,-5226667,0,-5226667
113941,2020-12-31,68285,Value,5193330,-5226667,0,-5226667
113941,2021-02-14,68285,Capital Call,-343333,-5570000,0,-5570000
113941,2021-02-14,68285,Distribution,6667,-5570000,6667,-5563333
113941,2021-03-31,68285,Value,4826660,-5570000,6667,-5563333
113941,2021-05-16,68285,Capital Call,860000,-4710000,6667,-4703333
113941,2021-05-16,68285,Distribution,30000,-4710000,36667,-4673333
113941,2021-06-30,68285,Value,4569990,-4710000,36667,-4673333
113941,2021-08-15,68285,Capital Call,-1839000,-6549000,36667,-6512333
113941,2021-08-15,68285,Distribution,4667,-6549000,41334,-6507666
113941,2021-09-30,68285,Value,6352660,-6549000,41334,-6507666
113943,2021-03-31,99212,Capital Call,-680000,-680000,0,-680000
113943,2021-03-31,99212,Value,280000,-680000,0,-680000
114112,2020-03-31,70821,Capital Call,-2500000,-2500000,0,-2500000
114112,2020-08-16,70821,Capital Call,-2500000,-5000000,0,-5000000
114112,2020-12-31,70821,Value,4975000,-5000000,0,-5000000
114184,2021-03-31,458,Capital Call,-418000,-418000,0,-418000
114184,2021-03-31,458,Value,418000,-418000,0,-418000
114184,2021-05-16,458,Capital Call,-1210000,-1628000,0,-1628000
114184,2021-06-30,458,Value,1627830,-1628000,0,-1628000
114262,2020-02-15,116062,Capital Call,-1047740,-4888316,0,-4888316
114262,2020-03-31,116062,Value,5156310,-4888316,0,-4888316
114262,2020-05-16,116062,Capital Call,-890380,-5778696,0,-5778696
114262,2020-06-30,116062,Value,6122910,-5778696,0,-5778696
114262,2020-08-15,116062,Capital Call,-304,-5779000,0,-5779000
114262,2020-09-30,116062,Value,6801880,-5779000,0,-5779000
114262,2020-11-15,116062,Capital Call,-1055000,-6834000,0,-6834000
114262,2020-11-15,116062,Distribution,375870,-6834000,375870,-6458130
114262,2020-12-31,116062,Value,8200800,-6834000,375870,-6458130
114262,2021-02-14,116062,Capital Call,-716000,-7550000,375870,-7174130
114262,2021-02-14,116062,Distribution,1630,-7550000,377500,-7172500
114262,2021-03-31,116062,Value,10872000,-7550000,377500,-7172500
114262,2021-05-16,116062,Capital Call,-300000,-7850000,377500,-7472500
114262,2021-05-16,116062,Distribution,15000,-7850000,392500,-7457500
114262,2021-06-30,116062,Value,13031000,-7850000,392500,-7457500
114262,2021-08-15,116062,Capital Call,-210250,-8060250,392500,-7667750
114262,2021-08-15,116062,Distribution,413525,-8060250,806025,-7254225
114262,2021-09-30,116062,Value,13863620,-8060250,806025,-7254225
114262,2021-11-15,116062,Capital Call,-139750,-8200000,806025,-7393975
114262,2021-11-15,116062,Distribution,13975,-8200000,820000,-7380000
114262,2021-12-31,116062,Value,15809600,-8200000,820000,-7380000
114357,2020-09-30,664,Capital Call,-1150000,-1150000,0,-1150000
114357,2020-09-30,664,Value,1300870,-1150000,0,-1150000
114357,2020-11-15,664,Capital Call,-1500000,-2650000,0,-2650000
114357,2020-12-31,664,Value,3350330,-2650000,0,-2650000
114357,2021-02-14,664,Capital Call,-2350000,-5000000,0,-5000000
114357,2021-03-31,664,Value,5517750,-5000000,0,-5000000
114357,2021-05-16,664,Capital Call,-1650000,-6650000,0,-6650000
114357,2021-05-16,664,Distribution,58124,-6650000,58124,-6591876
114357,2021-06-30,664,Value,7584910,-6650000,58124,-6591876
114357,2021-08-15,664,Capital Call,592000,-6058000,58124,-5999876
114357,2021-08-15,664,Distribution,-10872,-6058000,47252,-6010748
114357,2021-09-30,664,Value,6764960,-6058000,47252,-6010748
114358,2020-12-31,664,Capital Call,-1500000,-1500000,0,-1500000
114358,2020-12-31,664,Value,1442250,-1500000,0,-1500000
114358,2021-02-14,664,Capital Call,-1200000,-2700000,0,-2700000
114358,2021-03-31,664,Value,2577580,-2700000,0,-2700000
114358,2021-05-16,664,Capital Call,-800000,-3500000,0,-3500000
114358,2021-06-30,664,Value,3782670,-3500000,0,-3500000
114358,2021-08-15,664,Capital Call,-1969761,-5469761,0,-5469761
114358,2021-09-30,664,Value,5676430,-5469761,0,-5469761
114364,2020-12-31,664,Capital Call,-1050000,-1050000,0,-1050000
114364,2020-12-31,664,Value,1015790,-1050000,0,-1050000
114364,2021-02-14,664,Capital Call,-750000,-1800000,0,-1800000
114364,2021-03-31,664,Value,1698760,-1800000,0,-1800000
114364,2021-05-16,664,Capital Call,-1450000,-3250000,0,-3250000
114364,2021-06-30,664,Value,3551700,-3250000,0,-3250000
114364,2021-08-15,664,Capital Call,59000,-3191000,0,-3191000
114364,2021-09-30,664,Value,3813880,-3191000,0,-3191000
114427,2020-12-31,1597,Capital Call,-1000000,-1000000,0,-1000000
114427,2020-12-31,1597,Value,1130000,-1000000,0,-1000000
114427,2021-02-14,1597,Capital Call,-900000,-1900000,0,-1900000
114427,2021-03-31,1597,Value,2751960,-1900000,0,-1900000
114427,2021-05-16,1597,Capital Call,-2400000,-4300000,0,-4300000
114427,2021-06-30,1597,Value,6056980,-4300000,0,-4300000
114427,2021-08-15,1597,Capital Call,-1250000,-5550000,0,-5550000
114427,2021-09-30,1597,Value,8624140,-5550000,0,-5550000
114429,2020-06-30,11708,Capital Call,-1100000,-1100000,0,-1100000
114429,2020-06-30,11708,Value,1023000,-1100000,0,-1100000
114512,2020-12-31,109604,Capital Call,-1050000,-1050000,0,-1050000
114512,2020-12-31,109604,Value,934500,-1050000,0,-1050000
114512,2021-05-17,109604,Capital Call,-2550000,-3600000,0,-3600000
114512,2021-09-30,109604,Value,3630960,-3600000,0,-3600000
114515,2021-03-31,241635,Capital Call,-1310150,-1310150,0,-1310150
114515,2021-03-31,241635,Value,1121400,-1310150,0,-1310150
114515,2021-05-16,241635,Capital Call,-2146898,-3457048,0,-3457048
114515,2021-06-30,241635,Value,3727890,-3457048,0,-3457048
114610,2021-03-31,96512,Capital Call,-4932000,-4932000,0,-4932000
114610,2021-03-31,96512,Value,5872000,-4932000,0,-4932000
114618,2020-12-31,152313,Capital Call,-1258402,-1258402,0,-1258402
114618,2020-12-31,152313,Value,1258400,-1258402,0,-1258402
114618,2021-02-14,152313,Capital Call,-2501450,-3759852,0,-3759852
114618,2021-03-31,152313,Value,3639080,-3759852,0,-3759852
114651,2020-09-30,47870,Capital Call,-230000,-230000,0,-230000
114651,2020-09-30,47870,Value,226320,-230000,0,-230000
114651,2020-11-15,47870,Capital Call,-190000,-420000,0,-420000
114651,2020-12-31,47870,Value,429660,-420000,0,-420000
114651,2021-02-14,47870,Capital Call,-40000,-460000,0,-460000
114651,2021-03-31,47870,Value,471960,-460000,0,-460000
114651,2021-06-30,47870,Value,623300,-460000,0,-460000
114651,2021-09-30,47870,Value,678960,-460000,0,-460000
114651,2021-11-15,47870,Capital Call,-220000,-680000,0,-680000
114651,2021-12-31,47870,Value,909840,-680000,0,-680000
114652,2020-11-15,14055,Capital Call,-820838,-820838,0,-820838
114652,2020-12-31,14055,Value,795540,-820838,0,-820838
114652,2021-02-14,14055,Capital Call,-348481,-1169319,0,-1169319
114652,2021-02-14,14055,Distribution,230,-1169319,230,-1169089
114652,2021-03-31,14055,Value,1161420,-1169319,230,-1169089
114652,2021-05-16,14055,Capital Call,-770552,-1939871,230,-1939641
114652,2021-05-16,14055,Distribution,613,-1939871,843,-1939028
114652,2021-06-30,14055,Value,1978420,-1939871,843,-1939028
114714,2020-03-31,1557,Capital Call,-712800,-712800,0,-712800
114714,2020-03-31,1557,Value,714590,-712800,0,-712800
114714,2020-06-30,1557,Value,714590,-712800,0,-712800
114714,2020-09-30,1557,Capital Call,-2479848,-3192648,0,-3192648
114714,2020-09-30,1557,Distribution,340502,-3192648,340502,-2852146
114714,2020-12-31,1557,Value,3963480,-3192648,340502,-2852146
114714,2021-04-01,1557,Capital Call,-980894,-4173542,340502,-3833040
114714,2021-04-01,1557,Distribution,821019,-4173542,1161521,-3012021
114714,2021-06-30,1557,Value,3649060,-4173542,1161521,-3012021
114853,2020-12-31,11706,Capital Call,-300000,-300000,0,-300000
114853,2020-12-31,11706,Value,240000,-300000,0,-300000
114853,2021-02-14,11706,Capital Call,-1300000,-1600000,0,-1600000
114853,2021-03-31,11706,Value,1472000,-1600000,0,-1600000
114853,2021-06-30,11706,Value,1392000,-1600000,0,-1600000
114853,2021-08-15,11706,Capital Call,-200000,-1800000,0,-1800000
114853,2021-09-30,11706,Value,1530000,-1800000,0,-1800000
114911,2020-06-30,12208,Capital Call,-1000000,-1000000,0,-1000000
114911,2020-06-30,12208,Value,1000000,-1000000,0,-1000000
114911,2020-09-30,12208,Value,800000,-1000000,0,-1000000
114911,2020-11-15,12208,Capital Call,-1000000,-2000000,0,-2000000
114911,2020-12-31,12208,Value,1700000,-2000000,0,-2000000
114911,2021-09-30,12208,Value,1580000,-2000000,0,-2000000
114939,2021-03-31,145991,Capital Call,-1799000,-1799000,0,-1799000
114939,2021-03-31,145991,Value,2465340,-1799000,0,-1799000
114939,2021-06-30,145991,Value,2964210,-1799000,0,-1799000
114939,2021-08-15,145991,Capital Call,-500000,-2299000,0,-2299000
114939,2021-09-30,145991,Value,3701160,-2299000,0,-2299000
114997,2020-12-31,367,Capital Call,-511467,-511467,0,-511467
114997,2020-12-31,367,Value,436260,-511467,0,-511467
114997,2021-03-31,367,Value,481600,-511467,0,-511467
114997,2021-06-30,367,Value,496000,-511467,0,-511467
115002,2020-09-30,504,Capital Call,-317401,-317401,0,-317401
115002,2020-09-30,504,Value,307140,-317401,0,-317401
115002,2020-11-15,504,Capital Call,-372723,-690124,0,-690124
115002,2020-12-31,504,Value,670250,-690124,0,-690124
115157,2020-12-31,15143,Capital Call,-308373,-308373,0,-308373
115157,2020-12-31,15143,Value,154180,-308373,0,-308373
115157,2021-03-31,15143,Value,92510,-308373,0,-308373
115157,2021-05-16,15143,Capital Call,-2341627,-2650000,0,-2650000
115157,2021-06-30,15143,Value,2385000,-2650000,0,-2650000
115157,2021-09-30,15143,Value,3710000,-2650000,0,-2650000
115157,2021-11-15,15143,Capital Call,-1480000,-4130000,0,-4130000
115157,2021-12-31,15143,Value,9499000,-4130000,0,-4130000
115375,2020-11-15,496,Capital Call,-1000000,-1000000,0,-1000000
115375,2020-12-31,496,Value,1000000,-1000000,0,-1000000
115375,2021-02-14,496,Capital Call,-1000000,-2000000,0,-2000000
115375,2021-03-31,496,Value,2000000,-2000000,0,-2000000
115510,2020-12-31,14411,Capital Call,-1500000,-1500000,0,-1500000
115510,2020-12-31,14411,Value,2190200,-1500000,0,-1500000
115510,2021-03-31,14411,Value,2188220,-1500000,0,-1500000
115556,2020-12-31,302243,Capital Call,-2616000,-2616000,0,-2616000
115556,2020-12-31,302243,Value,2395990,-2616000,0,-2616000
115556,2021-02-14,302243,Capital Call,-2009000,-4625000,0,-4625000
115556,2021-03-31,302243,Value,4346570,-4625000,0,-4625000
115556,2021-05-16,302243,Capital Call,-1844439,-6469439,0,-6469439
115556,2021-06-30,302243,Value,6193900,-6469439,0,-6469439
115556,2021-08-15,302243,Capital Call,421439,-6048000,0,-6048000
115556,2021-09-30,302243,Value,5778250,-6048000,0,-6048000
115556,2021-11-15,302243,Capital Call,-363336,-6411336,0,-6411336
115556,2021-12-31,302243,Value,6164790,-6411336,0,-6411336
115607,2020-09-30,9052,Capital Call,-569020,-569020,0,-569020
115607,2020-09-30,9052,Value,513220,-569020,0,-569020
115613,2020-09-30,15662,Capital Call,-7518562,-7518562,0,-7518562
115613,2020-09-30,15662,Value,8421390,-7518562,0,-7518562
115613,2020-11-15,15662,Capital Call,-3228,-7521790,0,-7521790
115613,2020-12-31,15662,Value,8706550,-7521790,0,-7521790
115613,2021-03-31,15662,Value,11865920,-7521790,0,-7521790
115637,2020-02-15,17601,Capital Call,100000,-2400000,0,-2400000
115637,2020-03-31,17601,Value,1651800,-2400000,0,-2400000
115637,2020-06-30,17601,Value,1612150,-2400000,0,-2400000
115637,2020-09-30,17601,Capital Call,-250000,-2650000,0,-2650000
115637,2020-12-31,17601,Value,7446500,-2650000,0,-2650000
115637,2021-03-31,17601,Value,7131730,-2650000,0,-2650000
115637,2021-06-30,17601,Value,6681030,-2650000,0,-2650000
115637,2021-09-30,17601,Value,7290800,-2650000,0,-2650000
115712,2020-12-31,132306,Capital Call,-1694201,-1694201,0,-1694201
115712,2020-12-31,132306,Value,2134690,-1694201,0,-1694201
115712,2021-02-14,132306,Capital Call,-1002610,-2696811,0,-2696811
115712,2021-03-31,132306,Value,3424940,-2696811,0,-2696811
115712,2021-06-30,132306,Value,3883400,-2696811,0,-2696811
115776,2020-09-30,832,Capital Call,-410000,-410000,0,-410000
115776,2020-09-30,832,Value,352230,-410000,0,-410000
115776,2020-11-15,832,Capital Call,-685000,-1095000,0,-1095000
115776,2020-12-31,832,Value,976630,-1095000,0,-1095000
115776,2021-02-14,832,Capital Call,-380000,-1475000,0,-1475000
115776,2021-03-31,832,Value,1316140,-1475000,0,-1475000
115776,2021-05-16,832,Capital Call,-1715000,-3190000,0,-3190000
115776,2021-06-30,832,Value,3015820,-3190000,0,-3190000
115776,2021-08-15,832,Capital Call,-89000,-3279000,0,-3279000
115776,2021-09-30,832,Value,3097010,-3279000,0,-3279000
115776,2021-11-15,832,Capital Call,-16000,-3295000,0,-3295000
115776,2021-11-15,832,Distribution,6590,-3295000,6590,-3288410
115776,2021-12-31,832,Value,3057760,-3295000,6590,-3288410
115831,2020-06-30,20278,Capital Call,-10000000,-10000000,0,-10000000
115831,2020-09-30,20278,Value,9784000,-10000000,0,-10000000
115831,2020-12-31,20278,Value,9760000,-10000000,0,-10000000
115831,2021-03-31,20278,Value,9600000,-10000000,0,-10000000
115831,2021-06-30,20278,Value,9500000,-10000000,0,-10000000
115979,2021-06-30,6785,Capital Call,-2250000,-2250000,0,-2250000
115979,2021-06-30,6785,Value,2250000,-2250000,0,-2250000
115979,2021-08-15,6785,Capital Call,-1000000,-3250000,0,-3250000
115979,2021-09-30,6785,Value,3250000,-3250000,0,-3250000
115998,2020-09-30,18367,Capital Call,-10100000,-10100000,0,-10100000
115998,2020-09-30,18367,Value,10091410,-10100000,0,-10100000
115998,2020-12-31,18367,Value,10090130,-10100000,0,-10100000
115998,2021-03-31,18367,Value,14812380,-10100000,0,-10100000
116320,2020-12-31,190539,Capital Call,-10466000,-10466000,0,-10466000
116320,2020-12-31,190539,Value,12977840,-10466000,0,-10466000
116326,2020-12-31,6963,Capital Call,-400000,-400000,0,-400000
116326,2020-12-31,6963,Value,352000,-400000,0,-400000
116326,2021-02-14,6963,Capital Call,-1300000,-1700000,0,-1700000
116326,2021-03-31,6963,Value,1530000,-1700000,0,-1700000
116326,2021-06-30,6963,Value,1479000,-1700000,0,-1700000
116326,2021-09-30,6963,Value,1428000,-1700000,0,-1700000
116494,2020-09-30,9110,Capital Call,-271467,-271467,0,-271467
116494,2020-09-30,9110,Value,250310,-271467,0,-271467
116494,2020-11-15,9110,Capital Call,-292282,-563749,0,-563749
116494,2020-12-31,9110,Value,506910,-563749,0,-563749
116494,2021-02-14,9110,Capital Call,-800780,-1364529,0,-1364529
116494,2021-03-31,9110,Value,1280730,-1364529,0,-1364529
116494,2021-06-30,9110,Value,1262150,-1364529,0,-1364529
116494,2021-09-30,9110,Value,1447930,-1364529,0,-1364529
116507,2020-12-31,428403,Capital Call,-550000,-550000,0,-550000
116507,2020-12-31,428403,Value,550000,-550000,0,-550000
116507,2021-02-14,428403,Distribution,2105,-550000,2105,-547895
116507,2021-03-31,428403,Value,550000,-550000,2105,-547895
116507,2021-05-16,428403,Distribution,996,-550000,3101,-546899
116507,2021-06-30,428403,Value,661530,-550000,3101,-546899
116507,2021-08-15,428403,Capital Call,-1200000,-1750000,3101,-1746899
116507,2021-08-15,428403,Distribution,3698,-1750000,6799,-1743201
116507,2021-09-30,428403,Value,3474520,-1750000,6799,-1743201
116597,2020-12-31,1220,Capital Call,-8000000,-8000000,0,-8000000
116597,2020-12-31,1220,Value,9224000,-8000000,0,-8000000
116597,2021-04-01,1220,Capital Call,-37000,-8037000,0,-8037000
116597,2021-04-01,1220,Distribution,246736,-8037000,246736,-7790264
116597,2021-06-30,1220,Value,9834870,-8037000,246736,-7790264
116597,2021-08-15,1220,Capital Call,-388000,-8425000,246736,-8178264
116597,2021-08-15,1220,Distribution,117,-8425000,246853,-8178147
116597,2021-09-30,1220,Value,10326520,-8425000,246853,-8178147
116611,2020-02-15,19543,Capital Call,-281901,-2854957,0,-2854957
116611,2020-02-15,19543,Distribution,211426,-2854957,211426,-2643531
116611,2020-03-31,19543,Value,2726490,-2854957,211426,-2643531
116660,2020-12-31,118460,Capital Call,-2450000,-2450000,0,-2450000
116660,2020-12-31,118460,Value,4336500,-2450000,0,-2450000
116660,2021-02-14,118460,Capital Call,-770000,-3220000,0,-3220000
116660,2021-03-31,118460,Value,4991000,-3220000,0,-3220000
116660,2021-06-30,118460,Value,5377400,-3220000,0,-3220000
116660,2021-09-30,118460,Value,4991000,-3220000,0,-3220000
116723,2020-09-30,537,Capital Call,-10000000,-10000000,0,-10000000
116723,2020-09-30,537,Value,10000000,-10000000,0,-10000000
116723,2020-12-31,537,Value,10000000,-10000000,0,-10000000
116723,2021-03-31,537,Value,16984120,-10000000,0,-10000000
116829,2020-12-31,16101,Capital Call,-1146667,-1146667,0,-1146667
116829,2020-12-31,16101,Value,986660,-1146667,0,-1146667
116829,2021-04-01,16101,Capital Call,-550333,-1697000,0,-1697000
116829,2021-06-30,16101,Value,1739930,-1697000,0,-1697000
116829,2021-08-15,16101,Capital Call,-1306000,-3003000,0,-3003000
116829,2021-09-30,16101,Value,3152540,-3003000,0,-3003000
116933,2020-03-31,170996,Capital Call,-3175627,-3175627,0,-3175627
116933,2020-03-31,170996,Value,3063330,-3175627,0,-3175627
116933,2020-05-16,170996,Capital Call,-274776,-3450403,0,-3450403
116933,2020-06-30,170996,Value,3466480,-3450403,0,-3450403
116933,2020-08-15,170996,Capital Call,-743391,-4193794,0,-4193794
116933,2020-09-30,170996,Value,4007250,-4193794,0,-4193794
116933,2020-12-31,170996,Value,4073530,-4193794,0,-4193794
116933,2021-02-14,170996,Capital Call,-257472,-4451266,0,-4451266
116933,2021-03-31,170996,Value,4356000,-4451266,0,-4451266
116933,2021-05-16,170996,Capital Call,-1143678,-5594944,0,-5594944
116933,2021-06-30,170996,Value,6715910,-5594944,0,-5594944
117003,2020-12-31,1759,Capital Call,-7915,-7915,0,-7915
117003,2021-02-14,1759,Capital Call,-261188,-269103,0,-269103
117003,2021-03-31,1759,Value,240160,-269103,0,-269103
117003,2021-06-30,1759,Value,240160,-269103,0,-269103
117078,2021-06-30,9110,Capital Call,-861000,-861000,0,-861000
117078,2021-06-30,9110,Value,570750,-861000,0,-861000
117078,2021-08-15,9110,Capital Call,61000,-800000,0,-800000
117078,2021-09-30,9110,Value,610240,-800000,0,-800000
117098,2021-03-31,355,Capital Call,-1000000,-1000000,0,-1000000
117098,2021-03-31,355,Value,1264040,-1000000,0,-1000000
117098,2021-05-16,355,Capital Call,-650000,-1650000,0,-1650000
117098,2021-05-16,355,Distribution,101040,-1650000,101040,-1548960
117098,2021-06-30,355,Value,2261420,-1650000,101040,-1548960
117194,2021-09-30,1374,Capital Call,-2000000,-2000000,0,-2000000
117194,2021-09-30,1374,Value,2024200,-2000000,0,-2000000
117194,2021-11-15,1374,Capital Call,-1400000,-3400000,0,-3400000
117194,2021-12-31,1374,Value,3602630,-3400000,0,-3400000
117304,2020-03-31,190539,Value,10392720,-10600000,0,-10600000
117304,2020-06-30,190539,Value,10289310,-10600000,0,-10600000
117305,2020-01-17,190539,Capital Call,-1000000,-11500000,0,-11500000
117305,2020-03-31,190539,Value,16313490,-11500000,0,-11500000
117305,2020-06-30,190539,Value,16222520,-11500000,0,-11500000
117479,2021-03-31,392236,Capital Call,-2200000,-2200000,0,-2200000
117479,2021-03-31,392236,Value,1964880,-2200000,0,-2200000
117479,2021-05-16,392236,Capital Call,-750000,-2950000,0,-2950000
117479,2021-05-16,392236,Distribution,35400,-2950000,35400,-2914600
117479,2021-06-30,392236,Value,2612520,-2950000,35400,-2914600
117829,2021-03-31,314196,Capital Call,-2000000,-2000000,0,-2000000
117829,2021-03-31,314196,Value,4000000,-2000000,0,-2000000
117829,2021-06-30,314196,Value,4400000,-2000000,0,-2000000
117945,2021-03-31,178752,Capital Call,-3564596,-3564596,0,-3564596
117945,2021-03-31,178752,Distribution,869009,-3564596,869009,-2695587
117945,2021-03-31,178752,Value,3707610,-3564596,869009,-2695587
117945,2021-05-16,178752,Capital Call,-2089699,-5654295,869009,-4785286
117945,2021-05-16,178752,Distribution,260295,-5654295,1129304,-4524991
117945,2021-06-30,178752,Value,5306490,-5654295,1129304,-4524991
117945,2021-08-15,178752,Capital Call,-934440,-6588735,1129304,-5459431
117945,2021-08-15,178752,Distribution,1135450,-6588735,2264754,-4323981
117945,2021-09-30,178752,Value,5537300,-6588735,2264754,-4323981
117999,2021-05-31,2238,Capital Call,-1400000,-1400000,0,-1400000
117999,2021-05-31,2238,Value,1400000,-1400000,0,-1400000
117999,2021-07-16,2238,Capital Call,-800000,-2200000,0,-2200000
117999,2021-08-31,2238,Value,2127820,-2200000,0,-2200000
117999,2021-10-16,2238,Capital Call,-950000,-3150000,0,-3150000
117999,2021-11-30,2238,Value,3572270,-3150000,0,-3150000
118004,2021-08-31,2238,Capital Call,-1100000,-1100000,0,-1100000
118004,2021-08-31,2238,Value,1100000,-1100000,0,-1100000
118004,2021-10-16,2238,Capital Call,-1650000,-2750000,0,-2750000
118004,2021-11-30,2238,Value,2749640,-2750000,0,-2750000
118007,2021-06-30,2238,Capital Call,-1666667,-1666667,0,-1666667
118007,2021-06-30,2238,Value,1633330,-1666667,0,-1666667
118007,2021-08-15,2238,Capital Call,-833333,-2500000,0,-2500000
118007,2021-09-30,2238,Value,3166660,-2500000,0,-2500000
118043,2021-09-30,7951,Capital Call,-5000000,-5000000,0,-5000000
118043,2021-09-30,7951,Value,6300000,-5000000,0,-5000000
118062,2020-12-31,83265,Capital Call,-502222,-502222,0,-502222
118062,2020-12-31,83265,Value,488880,-502222,0,-502222
118234,2021-03-31,2225,Capital Call,-950000,-950000,0,-950000
118234,2021-03-31,2225,Value,950000,-950000,0,-950000
118360,2020-06-30,274318,Capital Call,-7150000,-7150000,0,-7150000
118360,2020-06-30,274318,Value,7250000,-7150000,0,-7150000
118360,2020-09-30,274318,Value,8800000,-7150000,0,-7150000
118360,2020-11-15,274318,Capital Call,-890000,-8040000,0,-8040000
118360,2020-11-15,274318,Distribution,80000,-8040000,80000,-7960000
118360,2020-12-31,274318,Value,9909990,-8040000,80000,-7960000
118816,2021-03-31,9004,Capital Call,-230000,-230000,0,-230000
118816,2021-03-31,9004,Value,178730,-230000,0,-230000
118816,2021-05-16,9004,Capital Call,-830000,-1060000,0,-1060000
118816,2021-06-30,9004,Value,1091050,-1060000,0,-1060000
118839,2021-03-31,24,Capital Call,-375000,-375000,0,-375000
118839,2021-03-31,24,Value,429780,-375000,0,-375000
118839,2021-05-16,24,Capital Call,-491000,-866000,0,-866000
118839,2021-06-30,24,Value,1406640,-866000,0,-866000
118839,2021-08-15,24,Capital Call,-397000,-1263000,0,-1263000
118839,2021-09-30,24,Value,1718560,-1263000,0,-1263000
118842,2021-03-31,18,Capital Call,-300028,-300028,0,-300028
118842,2021-03-31,18,Value,458350,-300028,0,-300028
118842,2021-05-16,18,Capital Call,-564972,-865000,0,-865000
118842,2021-06-30,18,Value,1006460,-865000,0,-865000
118842,2021-08-15,18,Capital Call,-603000,-1468000,0,-1468000
118842,2021-09-30,18,Value,1626100,-1468000,0,-1468000
118936,2021-03-31,2165,Capital Call,-500000,-500000,0,-500000
118936,2021-03-31,2165,Value,560000,-500000,0,-500000
118936,2021-05-16,2165,Capital Call,-1478000,-1978000,0,-1978000
118936,2021-06-30,2165,Value,2133070,-1978000,0,-1978000
118936,2021-08-15,2165,Capital Call,-858000,-2836000,0,-2836000
118936,2021-09-30,2165,Value,3229060,-2836000,0,-2836000
118936,2021-11-15,2165,Capital Call,-700000,-3536000,0,-3536000
118936,2021-12-31,2165,Value,4420000,-3536000,0,-3536000
118947,2021-09-30,10780,Capital Call,-4250000,-4250000,0,-4250000
118947,2021-09-30,10780,Value,8032500,-4250000,0,-4250000
118947,2021-11-15,10780,Capital Call,-1250000,-5500000,0,-5500000
118947,2021-12-31,10780,Value,10010000,-5500000,0,-5500000
119033,2021-03-31,104164,Capital Call,-3669031,-3669031,0,-3669031
119033,2021-03-31,104164,Value,3632930,-3669031,0,-3669031
119139,2021-03-31,9004,Capital Call,-210000,-210000,0,-210000
119139,2021-03-31,9004,Value,154660,-210000,0,-210000
119139,2021-05-16,9004,Capital Call,-720000,-930000,0,-930000
119139,2021-06-30,9004,Value,803000,-930000,0,-930000
119368,2021-02-28,179668,Capital Call,-1500000,-1500000,0,-1500000
119368,2021-02-28,179668,Value,1465390,-1500000,0,-1500000
119368,2021-04-15,179668,Capital Call,-250000,-1750000,0,-1750000
119368,2021-05-31,179668,Value,1647120,-1750000,0,-1750000
119368,2021-07-16,179668,Capital Call,-1150000,-2900000,0,-2900000
119368,2021-08-31,179668,Value,3723570,-2900000,0,-2900000
119368,2021-10-16,179668,Capital Call,-875000,-3775000,0,-3775000
119368,2021-11-30,179668,Value,4538690,-3775000,0,-3775000
119861,2021-06-30,4936,Capital Call,-548000,-548000,0,-548000
119861,2021-06-30,4936,Value,392690,-548000,0,-548000
119861,2021-08-15,4936,Capital Call,-353000,-901000,0,-901000
119861,2021-09-30,4936,Value,1286260,-901000,0,-901000
120128,2020-06-30,395897,Capital Call,-1100000,-1100000,0,-1100000
120128,2020-06-30,395897,Value,1738000,-1100000,0,-1100000
120128,2020-08-15,395897,Capital Call,-700000,-1800000,0,-1800000
120128,2020-09-30,395897,Value,3189780,-1800000,0,-1800000
120128,2020-12-30,395897,Capital Call,-1390000,-3190000,0,-3190000
120128,2021-03-31,395897,Value,7273200,-3190000,0,-3190000
120128,2021-05-16,395897,Capital Call,-2130000,-5320000,0,-5320000
120128,2021-06-30,395897,Value,9756880,-5320000,0,-5320000
120128,2021-08-15,395897,Capital Call,-375000,-5695000,0,-5695000
120128,2021-08-15,395897,Distribution,1128180,-5695000,1128180,-4566820
120128,2021-09-30,395897,Value,10045980,-5695000,1128180,-4566820
120153,2020-12-31,399146,Capital Call,-32667,-32667,0,-32667
120153,2020-12-31,399146,Value,12150,-32667,0,-32667
120153,2021-02-14,399146,Capital Call,-17440,-50107,0,-50107
120153,2021-03-31,399146,Value,7320,-50107,0,-50107
120153,2021-05-16,399146,Capital Call,-1164299,-1214406,0,-1214406
120153,2021-06-30,399146,Value,1170250,-1214406,0,-1214406
120213,2020-09-30,20891,Capital Call,-1000000,-1000000,0,-1000000
120213,2020-09-30,20891,Value,900000,-1000000,0,-1000000
120240,2020-10-02,81754,Capital Call,0,0,0,0
120240,2020-11-19,81754,Capital Call,-875,-875,0,-875
120240,2020-12-10,81754,Capital Call,0,-875,0,-875
120240,2020-12-31,81754,Value,733850,-875,0,-875
120240,2021-02-09,81754,Capital Call,-15,-890,0,-890
120240,2021-03-02,81754,Capital Call,-6,-896,0,-896
120240,2021-03-09,81754,Capital Call,-21,-917,0,-917
120240,2021-03-18,81754,Capital Call,-6,-923,0,-923
120240,2021-03-22,81754,Capital Call,-6,-929,0,-929
120240,2021-03-30,81754,Capital Call,-2,-931,0,-931
120240,2021-03-31,81754,Capital Call,0,-931,0,-931
120240,2021-03-31,81754,Value,730,-931,0,-931
120533,2021-02-28,52,Capital Call,-905072,-905072,0,-905072
120533,2021-02-28,52,Value,905070,-905072,0,-905072
120533,2021-04-15,52,Capital Call,-700000,-1605072,0,-1605072
120533,2021-05-31,52,Value,1595170,-1605072,0,-1605072
120533,2021-07-16,52,Capital Call,-750000,-2355072,0,-2355072
120533,2021-07-16,52,Distribution,150,-2355072,150,-2354922
120533,2021-08-31,52,Value,3208650,-2355072,150,-2354922
120533,2021-10-16,52,Capital Call,-600000,-2955072,150,-2954922
120533,2021-11-30,52,Value,3758370,-2955072,150,-2954922
122236,2020-12-31,660,Capital Call,-1140000,-1140000,0,-1140000
122236,2020-12-31,660,Value,1113780,-1140000,0,-1140000
122236,2021-02-14,660,Capital Call,-40000,-1180000,0,-1180000
122236,2021-03-31,660,Value,1097400,-1180000,0,-1180000
122236,2021-06-30,660,Value,1052560,-1180000,0,-1180000
122236,2021-09-30,660,Value,992380,-1180000,0,-1180000
122272,2021-03-31,11706,Capital Call,-500000,-500000,0,-500000
122272,2021-03-31,11706,Value,480000,-500000,0,-500000
122272,2021-05-16,11706,Capital Call,-100000,-600000,0,-600000
122272,2021-06-30,11706,Value,498000,-600000,0,-600000
122272,2021-08-15,11706,Capital Call,-400000,-1000000,0,-1000000
122272,2021-09-30,11706,Value,920000,-1000000,0,-1000000
122632,2021-03-31,6198,Capital Call,-500000,-500000,0,-500000
122632,2021-03-31,6198,Value,423800,-500000,0,-500000
122632,2021-06-30,6198,Value,369100,-500000,0,-500000
122632,2021-09-30,6198,Value,326550,-500000,0,-500000
122691,2020-06-30,15662,Capital Call,-7705508,-7705508,0,-7705508
122691,2020-06-30,15662,Distribution,6356,-7705508,6356,-7699152
122691,2020-06-30,15662,Value,9394060,-7705508,6356,-7699152
122691,2020-09-30,15662,Value,13086860,-7705508,6356,-7699152
122691,2020-12-31,15662,Value,15550840,-7705508,6356,-7699152
122691,2021-02-14,15662,Capital Call,-2119,-7707627,6356,-7701271
122691,2021-02-14,15662,Distribution,3608051,-7707627,3614407,-4093220
122691,2021-03-31,15662,Value,22292370,-7707627,3614407,-4093220
122691,2021-05-16,15662,Distribution,20309322,-7707627,23923729,16216102
122691,2021-06-30,15662,Value,2688550,-7707627,23923729,16216102
123037,2020-09-30,4963,Capital Call,-3250000,-3250000,0,-3250000
123037,2020-09-30,4963,Value,3370250,-3250000,0,-3250000
123037,2020-12-30,4963,Capital Call,-1700000,-4950000,0,-4950000
123037,2020-12-30,4963,Distribution,158400,-4950000,158400,-4791600
123037,2021-03-31,4963,Value,5717250,-4950000,158400,-4791600
123305,2020-12-31,67055,Capital Call,-2090000,-2090000,0,-2090000
123305,2020-12-31,67055,Value,4809090,-2090000,0,-2090000
123375,2021-06-30,408572,Capital Call,-300000,-300000,0,-300000
123375,2021-06-30,408572,Value,1620000,-300000,0,-300000
123440,2021-09-30,6098,Capital Call,-2200000,-2200000,0,-2200000
123440,2021-09-30,6098,Value,484000,-2200000,0,-2200000
123674,2020-03-31,656,Value,1830100,-1742772,0,-1742772
123674,2020-05-16,656,Capital Call,-387376,-2130148,0,-2130148
123674,2020-06-30,656,Value,2265010,-2130148,0,-2130148
123674,2020-08-15,656,Capital Call,-842574,-2972722,0,-2972722
123674,2020-09-30,656,Value,3211630,-2972722,0,-2972722
123674,2020-11-15,656,Capital Call,-282475,-3255197,0,-3255197
123674,2020-12-31,656,Value,3940150,-3255197,0,-3255197
123910,2020-12-31,343422,Capital Call,-5000000,-5000000,0,-5000000
123910,2020-12-31,343422,Value,6000000,-5000000,0,-5000000
123918,2020-12-31,343422,Capital Call,-10000000,-10000000,0,-10000000
123918,2020-12-31,343422,Value,10000000,-10000000,0,-10000000
123931,2020-12-31,343422,Capital Call,-3000000,-3000000,0,-3000000
123931,2020-12-31,343422,Value,3000000,-3000000,0,-3000000
123950,2020-09-30,61652,Capital Call,-750000,-750000,0,-750000
123950,2020-09-30,61652,Value,697500,-750000,0,-750000
123950,2020-11-15,61652,Capital Call,-750000,-1500000,0,-1500000
123950,2020-12-31,61652,Value,1335000,-1500000,0,-1500000
123950,2021-03-31,61652,Value,1335000,-1500000,0,-1500000
123959,2020-12-31,458,Capital Call,-683100,-683100,0,-683100
123959,2020-12-31,458,Value,668910,-683100,0,-683100
123959,2021-02-14,458,Capital Call,-344530,-1027630,0,-1027630
123959,2021-02-14,458,Distribution,171280,-1027630,171280,-856350
123959,2021-03-31,458,Value,892600,-1027630,171280,-856350
124185,2020-12-31,50903,Capital Call,-1955000,-1955000,0,-1955000
124185,2020-12-31,50903,Value,1847000,-1955000,0,-1955000
124324,2021-06-30,454,Capital Call,-9204421,-9204421,0,-9204421
124324,2021-06-30,454,Value,8687160,-9204421,0,-9204421
124324,2021-09-30,454,Value,9296970,-9204421,0,-9204421
124460,2020-09-30,451,Capital Call,-3400000,-3400000,0,-3400000
124460,2020-09-30,451,Value,2681850,-3400000,0,-3400000
124460,2020-11-15,451,Capital Call,-900000,-4300000,0,-4300000
124460,2020-12-31,451,Value,4555070,-4300000,0,-4300000
124460,2021-03-31,451,Value,4662770,-4300000,0,-4300000
124460,2021-06-30,451,Value,4093760,-4300000,0,-4300000
124460,2021-09-30,451,Value,5654990,-4300000,0,-4300000
124460,2021-11-15,451,Capital Call,-800000,-5100000,0,-5100000
124460,2021-12-31,451,Value,6558490,-5100000,0,-5100000
124483,2021-06-30,398714,Capital Call,-1500000,-1500000,0,-1500000
124483,2021-06-30,398714,Value,1785000,-1500000,0,-1500000
124483,2021-08-15,398714,Capital Call,-500000,-2000000,0,-2000000
124483,2021-09-30,398714,Value,2620000,-2000000,0,-2000000
124483,2021-12-31,398714,Value,3100000,-2000000,0,-2000000
124972,2020-09-30,8729,Capital Call,-2707308,-2707308,0,-2707308
124972,2020-09-30,8729,Distribution,7610,-2707308,7610,-2699698
124972,2020-09-30,8729,Value,2717140,-2707308,7610,-2699698
125050,2021-06-30,24,Capital Call,-908349,-908349,0,-908349
125050,2021-06-30,24,Value,933850,-908349,0,-908349
125050,2021-08-15,24,Capital Call,59349,-849000,0,-849000
125050,2021-09-30,24,Value,887540,-849000,0,-849000
125114,2021-06-30,1314,Capital Call,-1100065,-1100065,0,-1100065
125114,2021-06-30,1314,Value,1878550,-1100065,0,-1100065
125114,2021-08-15,1314,Capital Call,-833935,-1934000,0,-1934000
125114,2021-09-30,1314,Value,2765420,-1934000,0,-1934000
125127,2021-06-30,2562,Capital Call,-1000000,-1000000,0,-1000000
125127,2021-06-30,2562,Value,970000,-1000000,0,-1000000
125127,2021-09-30,2562,Capital Call,-2500000,-3500000,0,-3500000
125127,2021-12-31,2562,Value,4095000,-3500000,0,-3500000
125134,2021-03-31,217209,Capital Call,-257143,-257143,0,-257143
125134,2021-03-31,217209,Value,74280,-257143,0,-257143
125134,2021-05-16,217209,Capital Call,-42857,-300000,0,-300000
125134,2021-06-30,217209,Value,40320,-300000,0,-300000
125143,2021-07-16,1480,Capital Call,-2500000,-2500000,0,-2500000
125143,2021-07-16,1480,Distribution,2341,-2500000,2341,-2497659
125143,2021-08-31,1480,Value,2475650,-2500000,2341,-2497659
125143,2021-10-16,1480,Capital Call,-1000000,-3500000,2341,-3497659
125143,2021-10-16,1480,Distribution,0,-3500000,2341,-3497659
125143,2021-11-30,1480,Value,3442840,-3500000,2341,-3497659
125166,2021-03-31,93,Capital Call,-2950000,-2950000,0,-2950000
125166,2021-03-31,93,Value,2913000,-2950000,0,-2950000
125228,2021-05-31,40,Capital Call,-545454,-545454,0,-545454
125228,2021-05-31,40,Value,545450,-545454,0,-545454
125228,2021-07-16,40,Capital Call,-418181,-963635,0,-963635
125228,2021-08-31,40,Value,946670,-963635,0,-963635
125228,2021-11-30,40,Value,880570,-963635,0,-963635
125367,2021-03-31,219123,Capital Call,-916049,-916049,0,-916049
125367,2021-03-31,219123,Value,916040,-916049,0,-916049
125404,2020-12-31,191840,Capital Call,-3443513,-3443513,0,-3443513
125404,2020-12-31,191840,Value,1185770,-3443513,0,-3443513
125446,2021-05-31,664,Capital Call,-250000,-250000,0,-250000
125446,2021-05-31,664,Value,229930,-250000,0,-250000
125446,2021-07-16,664,Capital Call,-550000,-800000,0,-800000
125446,2021-08-31,664,Value,677050,-800000,0,-800000
125446,2021-10-16,664,Capital Call,-400000,-1200000,0,-1200000
125446,2021-11-30,664,Value,1017920,-1200000,0,-1200000
125493,2021-03-31,9953,Capital Call,-636000,-636000,0,-636000
125493,2021-03-31,9953,Value,629320,-636000,0,-636000
125493,2021-05-16,9953,Capital Call,-2381000,-3017000,0,-3017000
125493,2021-06-30,9953,Value,3229390,-3017000,0,-3017000
125493,2021-08-15,9953,Capital Call,-183000,-3200000,0,-3200000
125493,2021-09-30,9953,Value,3547840,-3200000,0,-3200000
125494,2020-09-30,9953,Capital Call,-500000,-500000,0,-500000
125494,2020-09-30,9953,Value,482650,-500000,0,-500000
125494,2020-11-15,9953,Capital Call,-850000,-1350000,0,-1350000
125494,2020-12-31,9953,Value,1655910,-1350000,0,-1350000
125494,2021-02-14,9953,Capital Call,-108000,-1458000,0,-1458000
125494,2021-03-31,9953,Value,1718830,-1458000,0,-1458000
125494,2021-05-16,9953,Capital Call,-342000,-1800000,0,-1800000
125494,2021-06-30,9953,Value,2387520,-1800000,0,-1800000
125494,2021-08-15,9953,Capital Call,-800000,-2600000,0,-2600000
125494,2021-09-30,9953,Value,3406260,-2600000,0,-2600000
125675,2021-03-31,479,Capital Call,-10000000,-10000000,0,-10000000
125675,2021-03-31,479,Value,10004440,-10000000,0,-10000000
125731,2020-12-31,286279,Capital Call,-9000000,-9000000,0,-9000000
125731,2020-12-31,286279,Distribution,8100,-9000000,8100,-8991900
125731,2020-12-31,286279,Value,13500000,-9000000,8100,-8991900
125731,2021-03-31,286279,Value,11511900,-9000000,8100,-8991900
125731,2021-05-16,286279,Distribution,-2700,-9000000,5400,-8994600
125731,2021-06-30,286279,Value,12324600,-9000000,5400,-8994600
125731,2021-09-30,286279,Value,10710000,-9000000,5400,-8994600
125732,2020-12-31,286279,Capital Call,-9000000,-9000000,0,-9000000
125732,2020-12-31,286279,Value,13500000,-9000000,0,-9000000
125732,2021-03-31,286279,Value,11520000,-9000000,0,-9000000
125732,2021-06-30,286279,Value,12330000,-9000000,0,-9000000
125732,2021-09-30,286279,Value,10710000,-9000000,0,-9000000
125908,2021-06-30,2250,Capital Call,-10000000,-10000000,0,-10000000
125908,2021-06-30,2250,Value,11330000,-10000000,0,-10000000
125908,2021-09-30,2250,Value,11330000,-10000000,0,-10000000
126098,2021-03-31,7459,Capital Call,-880000,-880000,0,-880000
126098,2021-03-31,7459,Value,1100000,-880000,0,-880000
126098,2021-05-16,7459,Capital Call,-103,-880103,0,-880103
126098,2021-06-30,7459,Value,1219470,-880103,0,-880103
126098,2021-08-15,7459,Capital Call,-1249897,-2130000,0,-2130000
126098,2021-09-30,7459,Value,2568990,-2130000,0,-2130000
126113,2020-09-30,13472,Capital Call,-1300000,-1300000,0,-1300000
126113,2020-09-30,13472,Value,780000,-1300000,0,-1300000
126113,2020-11-15,13472,Capital Call,17000,-1283000,0,-1283000
126113,2020-12-31,13472,Value,2854670,-1283000,0,-1283000
126113,2021-02-14,13472,Capital Call,123000,-1160000,0,-1160000
126113,2021-03-31,13472,Value,3712000,-1160000,0,-1160000
126113,2021-05-16,13472,Capital Call,-190000,-1350000,0,-1350000
126113,2021-06-30,13472,Value,5008500,-1350000,0,-1350000
126113,2021-08-15,13472,Capital Call,-1650000,-3000000,0,-3000000
126113,2021-09-30,13472,Value,6882000,-3000000,0,-3000000
126126,2020-09-30,5327,Capital Call,-50153,-50153,0,-50153
126126,2020-09-30,5327,Value,17710,-50153,0,-50153
126126,2020-12-31,5327,Value,15490,-50153,0,-50153
126126,2021-02-14,5327,Capital Call,-3137165,-3187318,0,-3187318
126126,2021-03-31,5327,Value,3754610,-3187318,0,-3187318
126419,2020-12-31,1355,Capital Call,-620000,-620000,0,-620000
126419,2020-12-31,1355,Value,801150,-620000,0,-620000
126419,2021-03-31,1355,Value,800530,-620000,0,-620000
126419,2021-05-16,1355,Capital Call,-355644,-975644,0,-975644
126419,2021-06-30,1355,Value,1246830,-975644,0,-975644
126422,2021-06-30,162842,Capital Call,-1000000,-1000000,0,-1000000
126422,2021-06-30,162842,Value,997390,-1000000,0,-1000000
126426,2021-03-31,162842,Capital Call,-1200000,-1200000,0,-1200000
126426,2021-03-31,162842,Value,1200000,-1200000,0,-1200000
126426,2021-06-30,162842,Value,1198230,-1200000,0,-1200000
126767,2020-12-31,416,Capital Call,-6694537,-6694537,0,-6694537
126767,2020-12-31,416,Value,6666660,-6694537,0,-6694537
126767,2021-03-31,416,Value,6664920,-6694537,0,-6694537
127101,2021-05-31,200477,Capital Call,-5100000,-5100000,0,-5100000
127101,2021-05-31,200477,Value,5549330,-5100000,0,-5100000
127101,2021-07-16,200477,Capital Call,-900000,-6000000,0,-6000000
127101,2021-08-31,200477,Value,6683800,-6000000,0,-6000000
127101,2021-11-30,200477,Value,6871490,-6000000,0,-6000000
127168,2021-06-30,4936,Capital Call,-7340000,-7340000,0,-7340000
127168,2021-06-30,4936,Value,7263660,-7340000,0,-7340000
127168,2021-08-15,4936,Capital Call,-19000,-7359000,0,-7359000
127168,2021-09-30,4936,Value,8669630,-7359000,0,-7359000
127242,2021-03-31,54,Capital Call,-10000000,-10000000,0,-10000000
127242,2021-03-31,54,Value,10000000,-10000000,0,-10000000
127746,2021-06-30,7459,Capital Call,-500000,-500000,0,-500000
127746,2021-06-30,7459,Value,482450,-500000,0,-500000
127746,2021-09-30,7459,Value,1071000,-500000,0,-500000
127834,2021-06-30,725,Capital Call,-4378000,-4378000,0,-4378000
127834,2021-06-30,725,Value,4371240,-4378000,0,-4378000
127878,2021-03-31,147,Capital Call,-10000000,-10000000,0,-10000000
127878,2021-03-31,147,Distribution,28296129,-10000000,28296129,18296129
127878,2021-03-31,147,Value,150380,-10000000,28296129,18296129
128074,2021-06-30,504,Capital Call,-472097,-472097,0,-472097
128074,2021-06-30,504,Value,472090,-472097,0,-472097
129353,2021-03-31,176053,Capital Call,-1000000,-1000000,0,-1000000
129353,2021-03-31,176053,Value,963000,-1000000,0,-1000000
129353,2021-07-01,176053,Capital Call,-300000,-1300000,0,-1300000
129353,2021-09-30,176053,Value,1235000,-1300000,0,-1300000
129353,2021-12-31,176053,Value,1235000,-1300000,0,-1300000
129613,2020-12-31,122505,Capital Call,-300000,-300000,0,-300000
129613,2020-12-31,122505,Value,300000,-300000,0,-300000
129613,2021-04-01,122505,Capital Call,-600000,-900000,0,-900000
129613,2021-06-30,122505,Value,1242000,-900000,0,-900000
129613,2021-08-15,122505,Capital Call,-700000,-1600000,0,-1600000
129613,2021-08-15,122505,Distribution,64000,-1600000,64000,-1536000
129613,2021-09-30,122505,Value,1664000,-1600000,64000,-1536000
129674,2020-12-31,234327,Capital Call,-10000000,-10000000,0,-10000000
129674,2020-12-31,234327,Value,14910000,-10000000,0,-10000000
129674,2021-04-01,234327,Distribution,500000,-10000000,500000,-9500000
129674,2021-06-30,234327,Value,21627000,-10000000,500000,-9500000
129726,2021-02-28,137606,Capital Call,-9997232,-9997232,0,-9997232
129726,2021-02-28,137606,Distribution,1967061,-9997232,1967061,-8030171
129726,2021-02-28,137606,Value,5386510,-9997232,1967061,-8030171
129726,2021-05-31,137606,Value,5573980,-9997232,1967061,-8030171
129726,2021-08-31,137606,Value,5709730,-9997232,1967061,-8030171
129726,2021-10-16,137606,Capital Call,0,-9997232,1967061,-8030171
129726,2021-10-16,137606,Distribution,0,-9997232,1967061,-8030171
129726,2021-11-30,137606,Value,5716570,-9997232,1967061,-8030171
130186,2021-06-30,741,Capital Call,-1577819,-1577819,0,-1577819
130186,2021-06-30,741,Value,1545530,-1577819,0,-1577819
130186,2021-08-15,741,Capital Call,-2012181,-3590000,0,-3590000
130186,2021-09-30,741,Value,3758730,-3590000,0,-3590000
130207,2021-06-30,10699,Capital Call,-8617860,-8617860,0,-8617860
130207,2021-06-30,10699,Value,8734380,-8617860,0,-8617860
130347,2020-09-30,361,Capital Call,-10000000,-10000000,0,-10000000
130347,2020-09-30,361,Value,10000000,-10000000,0,-10000000
130347,2020-12-31,361,Value,10017180,-10000000,0,-10000000
130460,2021-06-30,297291,Capital Call,-2213333,-2213333,0,-2213333
130460,2021-06-30,297291,Value,2173330,-2213333,0,-2213333
130460,2021-08-15,297291,Capital Call,-1360000,-3573333,0,-3573333
130460,2021-09-30,297291,Value,3613330,-3573333,0,-3573333
130730,2021-08-31,1480,Capital Call,-2500000,-2500000,0,-2500000
130730,2021-08-31,1480,Value,2485900,-2500000,0,-2500000
130730,2021-10-16,1480,Capital Call,-1250000,-3750000,0,-3750000
130730,2021-11-30,1480,Value,3714000,-3750000,0,-3750000
131528,2021-03-31,930,Capital Call,-7640000,-7640000,0,-7640000
131528,2021-03-31,930,Value,10978680,-7640000,0,-7640000
131528,2021-05-16,930,Capital Call,-870000,-8510000,0,-8510000
131528,2021-06-30,930,Value,11411910,-8510000,0,-8510000
132199,2021-09-30,3795,Capital Call,-800000,-800000,0,-800000
132199,2021-09-30,3795,Value,689520,-800000,0,-800000
132199,2021-12-31,3795,Value,637440,-800000,0,-800000
132208,2021-02-28,664,Capital Call,-1866956,-1866956,0,-1866956
132208,2021-02-28,664,Value,1991270,-1866956,0,-1866956
132208,2021-04-15,664,Capital Call,-1649868,-3516824,0,-3516824
132208,2021-05-31,664,Value,3844460,-3516824,0,-3516824
132208,2021-08-31,664,Value,3988580,-3516824,0,-3516824
132208,2021-10-16,664,Capital Call,-1910374,-5427198,0,-5427198
132208,2021-11-30,664,Value,5913630,-5427198,0,-5427198
132416,2021-08-31,16570,Capital Call,-1949340,-1949340,0,-1949340
132416,2021-08-31,16570,Value,1940410,-1949340,0,-1949340
132416,2021-10-16,16570,Capital Call,-3078000,-5027340,0,-5027340
132416,2021-11-30,16570,Value,5008450,-5027340,0,-5027340
133005,2021-06-30,741,Capital Call,-1500588,-1500588,0,-1500588
133005,2021-06-30,741,Value,1489980,-1500588,0,-1500588
133005,2021-08-15,741,Capital Call,-1509412,-3010000,0,-3010000
133005,2021-09-30,741,Value,3307990,-3010000,0,-3010000
133748,2021-06-30,15143,Capital Call,-1002000,-1002000,0,-1002000
133748,2021-08-15,15143,Capital Call,-3468000,-4470000,0,-4470000
133748,2021-09-30,15143,Value,4470000,-4470000,0,-4470000
133748,2021-11-15,15143,Capital Call,-5400000,-9870000,0,-9870000
133748,2021-12-31,15143,Value,10067400,-9870000,0,-9870000
134156,2020-09-30,332726,Capital Call,-1927483,-1927483,0,-1927483
134156,2020-09-30,332726,Value,2097500,-1927483,0,-1927483
135720,2021-09-30,222118,Capital Call,-10000000,-10000000,0,-10000000
135720,2021-09-30,222118,Value,67300000,-10000000,0,-10000000
135720,2021-12-31,222118,Value,70000000,-10000000,0,-10000000
136529,2021-06-30,21861,Capital Call,-746000,-746000,0,-746000
136529,2021-06-30,21861,Value,695040,-746000,0,-746000
136529,2021-08-15,21861,Capital Call,-1558000,-2304000,0,-2304000
136529,2021-09-30,21861,Value,2202850,-2304000,0,-2304000
136529,2021-12-31,21861,Value,2153770,-2304000,0,-2304000
136748,2021-06-30,7459,Capital Call,-1100000,-1100000,0,-1100000
136748,2021-06-30,7459,Value,1070300,-1100000,0,-1100000
136748,2021-08-15,7459,Capital Call,-400000,-1500000,0,-1500000
136748,2021-09-30,7459,Value,1425000,-1500000,0,-1500000
137628,2021-09-30,446106,Capital Call,-620000,-620000,0,-620000
137628,2021-09-30,446106,Value,564200,-620000,0,-620000
138150,2021-06-30,7622,Capital Call,-10000000,-10000000,0,-10000000
138150,2021-06-30,7622,Value,9964760,-10000000,0,-10000000
138267,2021-09-30,9953,Capital Call,-600000,-600000,0,-600000
138267,2021-09-30,9953,Value,572220,-600000,0,-600000
